,BBL,Borough,Address,LandUse,BldgClass,OwnerName,NumBldgs,bldg_footprints_count,difference
0,4163500300,QN,202-30 ROCKAWAY POINT BLVD,01,A8,BREEZY POINT COOPERA,795,518,277
1,4142600001,QN,154-68 BROOKVILLE BOULEVARD,07,T1,PORT AUTHORITY OF NY AND NJ,422,246,176
2,4163500400,QN,217-02 BREEZY POINT BLVD,01,A8,"BREEZY POINT COOPERATIVE, INC",1867,1720,147
3,4163400050,QN,1 ROCKAWAY POINT BLVD,01,A8,BREEZY POINT CO-OP,518,404,114
4,5054607501,SI,4219A AMBOY ROAD,02,R3,AVON AT GREAT KILLS CONDOMINIUM,63,9,54
5,5057420023,SI,406 ASPEN KNOLLS WAY,09,Q2,ASPEN KNOLLS HOMEOWNERS ASSOC,43,1,42
6,5024507502,SI,341 WINDHAM LOOP,02,R3,"COTTON, ELLEN",76,38,38
7,4071150002,QN,64-05 186 LANE,02,C9,"QUEENS FRESH MEADOWS, LLC",179,148,31
8,3061530001,BK,9275 FT HAMILTON PARKWAY,08,Y4,THE UNITED STATES OF  AMERICA,142,112,30
9,5031280001,SI, BAY STREET,08,Y4,US ARMY FT HAMILTON,169,146,23
10,4065070001,QN,63-25 MAIN STREET,08,W1,NYC DEPARTMENT OF EDUCATION,33,12,21
11,5024507514,SI,469 WINDHAM LOOP,02,R3,NAME NOT ON FILE,90,70,20
12,5055907501,SI,10 VILLAGE LANE,02,R3,REDGATE PRPERTY MGT INC,43,23,20
13,5006200001,SI,631 HOWARD AVENUE,08,W6,WAGNER LUTHERAN COLLE,37,19,18
14,5067400033,SI,16 BAYVIEW LANE,01,B2,BELINDA GAGLIARDOTTO,19,1,18
15,1011110001,MN,1000 5 AVENUE,09,Q1,NYC DEPARTMENT OF PARKS AND RECREATION,76,60,16
16,2035620061,BX,625 BOLTON AVENUE,08,W3,TA NEW YORK CITY BA LLC,17,1,16
17,2055060001,BX, SILVER BEACH,01,A8,SILVER BEACH GARDENS CORP,230,215,15
18,2056490001,BX,2131 HART STREET,08,Y3,NYC DEPARTMENT OF GENERAL SERVICES,33,19,14
19,3011830001,BK,1000 FLATBUSH AVENUE,09,Q1,NYC DEPARTMENT OF PARKS AND RECREATION,29,15,14
20,5020877501,SI,390 HAWTHORNE AVENUE,02,R3,BAYBERRY WOODS CONDOMINIUM,56,43,13
21,4033840041,QN,576 GRANDVIEW AVENUE,10,G1,RHD REALTY CORP,17,4,13
22,1000010010,MN,1 GOVERNORS ISLAND,08,Y4,GOVERNORS ISLAND CORPORATION,147,134,13
23,3024460056,BK,215 BROADWAY,07,T9,NYS DEPARTMENT OF TRANSPORTATION,13,1,12
24,5066940001,SI,91 TRENTON COURT,09,Q1,NYC DEPARTMENT OF PARKS AND RECREATION,24,12,12
25,2055070001,BX, SILVER BEACH,01,A8,SILVER BEACH GARDENS CORPORATION,57,45,12
26,1018190203,MN, RANDALLS ISLAND,09,Q1,NYC DEPARTMENT OF PARKS AND RECREATION,46,34,12
27,2043360001,BX,2855 BRONX PARK EAST,09,Q1,NYC DEPARTMENT OF PARKS AND RECREATION,33,21,12
28,5065960001,SI, IRVINGTON STREET,09,Q9,NYC DEPARTMENT OF PARKS AND RECREATION,17,5,12
29,3085910075,BK,5031 FLATBUSH AVENUE,08,Y4,NATIONAL PARK SERVICE,57,46,11
30,5059000500,SI,1323 WEST SERVICE ROAD,07,Y6,NYC DEPARTMENT OF SANITATION,71,60,11
31,5017060001,SI,1860 FOREST AVENUE,08,W1,NYC DEPARTMENT OF EDUCATION,12,1,11
32,3026120075,BK,315 NORMAN AVENUE,06,F8,KM PHOENIX HOLDINGS LLC,17,6,11
33,3001450022,BK,100 WILLOUGHBY STREET,04,D7,"AVALON WILLOUGHBY WEST, LLC",12,1,11
34,4020180001,QN,56-01 GRAND CENTRAL PKWY,09,Q1,NYC DEPARTMENT OF PARKS AND RECREATION,92,82,10
35,5005340001,SI,75 VANDERBILT AVENUE,08,I1,BAYLEY SETON HOSPITAL,15,5,10
36,4141820096,QN,102-11 159 DRIVE,01,A9,PENSCO TRUST COMPANY LLC,11,1,10
37,3022770001,BK,26 NORTH 12 STREET,09,Q0,NYC DEPARTMENT OF PARKS AND RECREATION,15,5,10
38,3085900800,BK, FLATBUSH AVENUE,09,Q1,NATIONAL PARK SERVICE,32,23,9
39,4085200002,QN,270-05 76 AVENUE,08,I1,LONG ISLAND JEWISH HOSPITAL,35,26,9
40,3088130071,BK, SHORE BOULEVARD,11,V0,NYC DEPARTMENT OF SMALL BUSINESS SERVICES,10,1,9
41,2026050040,BX,10-01 HAZEN STREET,08,Y3,NYC DEPARTMENT OF CORRECTIONS,208,199,9
42,2034327502,BX,101 NEPTUNE LANE,02,R3,UNAVAILABLE OWNER,72,63,9
43,3002580017,BK,10 COLUMBIA PLACE,04,C7,JORALEMON REALTY NY LLC,17,8,9
44,3061530200,BK,800 POLY PLACE,08,Y4,THE U.S.ARMY CORPS OF ENGINEERS,17,8,9
45,1006077503,MN,133 WEST 11 STREET,04,RM,THE GREENWICH LANE CONDOMINIUM,10,1,9
46,4163300060,QN,326 ROCKAWAY POINT BOULE,,Z9,NATIONAL PARKS SERVICE,53,44,9
47,3056330034,BK,4822 NEW UTRECHT AVENUE,05,O5,UTRECHT 48 LLC,10,1,9
48,5009240001,SI,1131 MANOR ROAD,09,Q2,NYS DEPARTMENT OF ENVIRONMENTAL CONSERVATION,32,23,9
49,2033080059,BX,270 EAST 203RD STREET,11,V0,BOLIVAR VENTURES II LLC,9,1,8
50,3025170014,BK,498 KINGSLAND AVENUE,06,F8,UNITED METRO ENERGY CORP,13,5,8
51,3070870076,BK,143 LAKE STREET,08,W2,MAGEN DAVID YESHIVAH,9,1,8
52,3082100037,BK,10202 FLATLANDS AVENUE,05,K1,FLATLANDS LLC,9,1,8
53,3072390001,BK,2661 OCEAN PARKWAY,08,I1,NYC HEALTH AND HOSPITALS CORPORATION,16,8,8
54,4079140002,QN,221-22 MANOR ROAD,02,C6,UNITED VET MUTL HSNG CO,222,214,8
55,5018010100,SI,625 CHELSEA ROAD,06,E7,CHELSEA SOUTH ASSOCIATES LLC,17,9,8
56,1018190040,MN,8 RANDALLS ISLAND,08,Y1,FIRE DEPARTMENT OF NEW YORK,25,17,8
57,2055140002,BX,14D EDGEWATER PARK,01,A8,EDGEWATER PARK OWNER CO,65,57,8
58,5079980130,SI,225 ELLIS STREET,09,Q8,"225 ELLIS STREET MARINA, LLC",14,7,7
59,4001280007,QN,39-25 51 STREET,03,D4,51ST 52ND ST TENNANTS ASSOC INC,17,10,7
60,4161100044,QN,1 BEACH 84 STREET,02,C9,"84TH STREET PIER REALTY, INC.",25,18,7
61,3020230001,BK,652 KENT AVENUE,07,T2,NYC DEPARTMENT OF SMALL BUSINESS SERVICES,102,95,7
62,3001340001,BK,309 GOLD STREET,04,D6,BROOKLYN PRINCESS LLC,8,1,7
63,3026120001,BK,400 KINGSLAND AVENUE,06,F8,MOBIL FOUNDATION INC,11,4,7
64,3030070003,BK,1201 FLUSHING AVENUE,06,F5,BROTHER REAL ESTATE INC.,9,2,7
65,4058570050,QN,15-40 BELL BOULEVARD,02,C6,"BAY TERRACE COOPERATIVE SECTION II, INC.",90,83,7
66,2027800002,BX, RYAWA AVENUE,07,U8,NYC DEPARTMENT OF ENVIRONMENTAL PROTECTION,30,23,7
67,5046070046,SI,71 KENNINGTON STREET,01,A5,"GRILLO, JOSEPH",8,1,7
68,4070210001,QN,8150A UTOPIA PARKWAY,08,W6,ST JOHN S UNIVERSITY,38,31,7
69,4156700125,QN, MOTT AVENUE,07,U2,LIPA,15,8,7
70,3057390001,BK,6301 12 AVENUE,08,M4,12 AVE REAL PROPERTY LLC,10,3,7
71,4071170002,QN,189-15 73 AVENUE,02,C9,"QUEENS FRESH MEADOWS, LLC",115,109,6
72,5071060155,SI,758 BLOOMINGDALE ROAD,01,A5,MICHAEL PATANE,7,1,6
73,4033210113,QN,117-01 84 AVENUE,08,I7,"KEW GARDENS SENIOR DEVELOPMENT,",7,1,6
74,5064310026,SI,98A DISCALA LANE,02,C1,"SANGUINEDO, DOROTHY",13,7,6
75,4009260001,QN,83-00 23 AVENUE,07,T1,NYC DEPARTMENT OF SMALL BUSINESS SERVICES,51,45,6
76,4156500024,QN,14-79 BEACH CHANNEL DRIVE,05,K1,1464-1499 BEACH CHANNEL DRIVE LLC,7,1,6
77,2029290008,BX,3872 3 AVENUE,08,W9,"FRIENDS OF BRONX PREPARATORY CHARTER SCH OOL, INC.",7,1,6
78,3085900700,BK, FLATBUSH AVENUE,09,Q0,NATIONAL PARK SERVICE,19,13,6
79,4160020001,QN,56-10 BEACH CHANNEL DRIVE,03,D3,NYC HOUSING AUTHORITY,20,14,6
80,3086980001,BK,610 SURF AVENUE,09,P6,NYC DEPARTMENT OF PARKS AND RECREATION,21,15,6
81,4065170001,QN,63-30 KISSENA BOULEVARD,08,W5,DORMITORY AUTHORITY OF THE STATE OF NEW YORK,39,33,6
82,4067130041,QN,150-75 GOETHALS AVENUE,08,M1,VILLAGE MALL AT HI   REST INC,8,2,6
83,4160010002,QN,51-32 BEACH CHANNEL DRIVE,03,D3,NYC HOUSING AUTHORITY,16,10,6
84,3029480085,BK,1301 METROPOLITAN AVENUE,06,E9,PEABODY WEBSTER HOLD,7,1,6
85,1021890001,MN,10 AVENUE,07,U7,NYC TRANSIT AUTHORITY,34,28,6
86,3017170006,BK,39 WALWORTH STREET,06,E1,LFFT TIC LLC,10,4,6
87,5001690001,SI,60 NORTH BURGHER AVENUE,02,C1,MARKHAM GARDENS L.P.,32,26,6
88,5003910128,SI,90 NORTH AVENUE,09,Q1,NYC DEPARTMENT OF PARKS AND RECREATION,14,8,6
89,3064640001,BK,247 BAY 19 STREET,02,C6,BAY-SHORE OWNERS INC,41,35,6
90,1014380010,MN,327 EAST 63 STREET,07,U2,"CONSOLIDATED EDISON CO.OF N.Y.,INC.",7,1,6
91,3036890012,BK,2700 ATLANTIC AVENUE,05,K1,2700 ATLANTIC LLC,10,4,6
92,5020857501,SI,3A DARCEY AVENUE,02,R3,NAME NOT ON FILE,62,56,6
93,3025250001,BK,327 GREENPOINT AVENUE,07,U9,NYC DEPARTMENT OF ENVIRONMENTAL PROTECTION,31,26,5
94,3060080041,BK,8206 5 AVENUE,05,K7,SCHACHTER HEDDA,6,1,5
95,5019550001,SI,411 ROCKLAND AVENUE,08,P5,NYC DEPARTMENT OF PARKS AND RECREATION,7,2,5
96,3006370019,BK,198 19 STREET,03,D3,ESHOKOL DEVELOPMENT CORP.,6,1,5
97,3028370001,BK, PORTER AVENUE,07,U2,BROOKLYN UNION GAS COMPANY,42,37,5
98,5044410001,SI,395 CENTER STREET,08,P7,NYC DEPARTMENT OF PARKS AND RECREATION,20,15,5
99,3084010020,BK,5810 AVENUE T,02,C6,"FILLMORE GARDENS CO-OPERATIVE, INC.",41,36,5
100,1009900001,MN,276 AVENUE C,07,U2,POWER AUTHORITY OF THE STATE OF NEW YORK,19,14,5
101,3072080040,BK, AVENUE X,07,U7,NYC TRANSIT AUTHORITY,45,40,5
102,3025800001,BK,278 GREENPOINT AVENUE,07,G4,GREENPOINT INDUSTRIAL SERVICES CORP,6,1,5
103,4073420028,QN,46-11 215 PLACE,02,C6,JEFFREY GARDENS APARTMENT CORP,13,8,5
104,1018190015,MN, WARDS ISLAND,07,U9,FIRE DEPARTMENT OF NEW YORK,53,48,5
105,3028050025,BK,858 MEEKER AVENUE,06,E9,"E AND J CAPUTO, LLC",7,2,5
106,3020230125,BK,61 LITTLE STREET,07,U9,NYC DEPARTMENT OF ENVIRONMENTAL PROTECTION,16,11,5
107,3000060001,BK,1 HUDSON AVENUE,07,U2,"CONSOLIDATED EDISON CO.OF N.Y.,INC.",15,10,5
108,5017250075,SI, SOUTH AVENUE,11,V9,NYC DEPT OF HIGHWAYS,6,1,5
109,4067930126,QN,154-02 71 AVENUE,02,C9,RIVER DRIVE CONSTRUCTION CORP,97,92,5
110,2056220001,BX,450 HUTCHINSON RVR PKWY,09,Q5,NYC DEPARTMENT OF PARKS AND RECREATION,15,10,5
111,4119000002,QN, NASSAU BOULEVARD,07,U9,NYC DEPARTMENT OF ENVIRONMENTAL PROTECTION,41,36,5
112,2055170127,BX,1 ALDEN PARK,01,A8,EDGEWATER PARK OWNRSETC,18,13,5
113,2056280008,BX,30 CAROLL STREET,02,C6,CARROLL COURTS INC,21,16,5
114,2038440016,BX,2400 HALSEY STREET,05,O1,NYC DEPARTMENT OF CITYWIDE ADMINISTRATIVE SERVICES,6,1,5
115,4090730026,QN,97-06 99 AVENUE,10,G0,MARIE MOLANO,6,1,5
116,4039250001,QN,127-11 POWELLS COVE BLVD,07,U9,CITY OF NEW YORK,33,28,5
117,3035870001,BK,167 RIVERDALE AVENUE,02,C1,"HP MARCUS GARVEY PRESERVATION HOUSING CO MPANY, INC",18,13,5
118,3020230150,BK,22 FLUSHING AVENUE,08,Y4,BROOKLYN NAVY YARD DEV,28,23,5
119,1009120026,MN,247 EAST 31 STREET,04,C7,MARCHI RLTY CORP,8,3,5
120,5005970065,SI,636 HOWARD AVENUE,08,W6,WAGNER LUTHERAN COLLE,8,3,5
121,1009440045,MN,312 EAST 39 STREET,03,D8,"ASN SONOMA, LLC",6,1,5
122,4016130017,QN,96-18 43 AVENUE,08,W1,NEW YORK CITY SCHOOL CONSTRUCTION AUTHOR ITY,6,1,5
123,3052290017,BK,1345 ROGERS AVENUE,04,D6,ROGERS AVENUE HOUSING DEVELOPMENT FUND C ORP.,6,1,5
124,4153500001,QN, CROSS BAY BOULEVARD,09,Q3,NYC DEPARTMENT OF PARKS AND RECREATION,6,1,5
125,4077540003,QN,217-02 75 AVENUE,02,C6,WOTC TENANTS CORP,160,155,5
126,4163250001,QN,402 GARAGE BEACH 169 STREET,09,Q1,NATIONAL PARK SERVICE,21,16,5
127,5011550085,SI,40 LA SALLE STREET,06,E9,GRANITE  AVENUE  PROPERTY  OWNERS ASSN,9,4,5
128,5010030043,SI,55 CHURCH STREET,06,E1,"SHAARAWY, IBRAHIM",8,3,5
129,2054550060,BX,83 SILVER BEACH,01,A8,SOUTH BEACH GARDENS CORP,91,86,5
130,3009747502,BK,306 2 STREET,02,R2,CITY VIEW GARDENS CONDOMINIUM,5,1,4
131,5002150127,SI,781 POST AVENUE,01,B2,YNSI PROPERTIES II LLC,6,2,4
132,5012080015,SI,3165 RICHMOND TERRACE,06,E9,MCALLISTER MARITIME HOLDING LLC,5,1,4
133,4066780001,QN,71-27 147 STREET,02,C6,UNAVAILABLE OWNER,54,50,4
134,3069430030,BK,344 BAY 41 STREET,07,Y6,NYC DEPARTMENT OF SANITATION,15,11,4
135,3075600057,BK,1620 NEW YORK AVENUE,11,V0,1622 NEW YORK LLC,8,4,4
136,3084280001,BK,6807 AVENUE V,10,G7,"BARDO, LLC.",5,1,4
137,2059580001,BX,6301 RIVERDALE AVENUE,08,W6,"SISTER JANE IANNUCELLI, S.C, TRUSTEE",20,16,4
138,5036860013,SI,308 HUNTER AVENUE,01,A5,MIGLIACCIO FRANCESCO,5,1,4
139,1003990020,MN,220 EAST 4 STREET,08,W2,ROMAN CATHOLIC CHURCH OF MOST HOLY,5,1,4
140,3061330057,BK,9952 3RD AVENUE,02,C0,"THE NARROWS, LLC",5,1,4
141,4090450115,QN,95-15 98 STREET,06,F4,NLTSCE LLC,5,1,4
142,4093810044,QN,94-06 104 STREET,08,W1,NYC DEPARTMENT OF EDUCATION,5,1,4
143,5002010038,SI,1828 RICHMOND TERRACE,06,E2,RUSI REALTY LLC,5,1,4
144,4008140027,QN, STEINWAY STREET,11,V9,DEPT OF PUBLIC WORKS,20,16,4
145,3072660001,BK, NEPTUNE AVENUE,07,U8,NYC TRANSIT AUTHORITY,6,2,4
146,5008530084,SI,1295 RICHMOND ROAD,02,C3,ROTONDI 4 TRUST,6,2,4
147,5027050350,SI,4431 VICTORY BOULEVARD,07,U0,UNAVAILABLE OWNER,16,12,4
148,5003540008,SI,483 JEWETT AVENUE,04,S1,"DACI, FISNIK",5,1,4
149,3011170001,BK,95 PROSPECT PARK WEST,09,Q1,NYC DEPARTMENT OF PARKS AND RECREATION,38,34,4
150,4125280109,QN,128-06 MERRICK BOULEVARD,05,K1,"PARKSET 7TH AVE., LLC",5,1,4
151,1021840001,MN,3755 9 AVENUE,07,U2,CONS EDISON CO,6,2,4
152,1015080004,MN,109 EAST 79TH STREET,03,D1,79TH OWNER LLC,5,1,4
153,2024270047,BX,1235 WEBSTER AVENUE,05,K2,1227 WEBSTER AVENUE,5,1,4
154,2032470001,BX,2900 GOULDEN AVENUE,08,W5,DORMITORY AUTHORITY,16,12,4
155,4086680118,QN,251-63 JERICHO TURNPIKE,06,E7,"251 JAMAICA AVE, LLC",5,1,4
156,3057670028,BK,1270 67 STREET,08,N9,NORW CHRISTIAN HOME A,6,2,4
157,1018190010,MN,1 WARDS ISLAND,09,Q1,NYC DEPARTMENT OF PARKS AND RECREATION,54,50,4
158,4158170063,QN,191A BEACH 25 STREET,01,B2,191 BEACH 25TH ST LLC,5,1,4
159,1021060001,MN,506 EDGECOMBE AVENUE,09,Q3,NYC DEPARTMENT OF PARKS AND RECREATION,12,8,4
160,1016730001,MN,1968 2 AVENUE,05,K2,1968 2ND AVE REALTY LLC,5,1,4
161,5038510050,SI, FR CAPODANNO BLVD,09,Q4,NYC DEPARTMENT OF PARKS AND RECREATION,8,4,4
162,4099997501,QN,147-36 94 AVENUE,04,RM,UNAVAILABLE OWNER,5,1,4
163,4130970028,QN,219-14 MERRICK BOULEVARD,05,K1,FORTE CAPITAL MANAGEMENT LLC,5,1,4
164,3013680074,BK,1494 PROSPECT PLACE,03,D3,PARK AND PROSPECT LLC,5,1,4
165,1009000055,MN,204 EAST 20 STREET,11,V1,200 EAST 20TH LLC,5,1,4
166,2055160161,BX,64B EDGEWATER PARK,01,A8,EDGEWATER PK OWNERS COOPERATIV,67,63,4
167,4096250001,QN,87-05 VAN WYCK EXPWY SR E,05,H4,"SIDHDHY VINAYAK,",5,1,4
168,4109050001,QN,109-35 202 STREET,01,B2,"DACRES, PATRICIA",5,1,4
169,3018730001,BK,235 PARK AVENUE,06,E7,YYY BROOKLYN CLINTON LLC,5,1,4
170,4103280025,QN,182-12 93 AVENUE,06,E9,S&S DEVELOPERS LLC,9,5,4
171,2058141401,BX,231 WEST 246 STREET,08,W3,HORACE MANN BAINARD SCHL,12,8,4
172,4095250040,QN,102-05 ROCKAWAY BOULEVARD,08,M9,CALVARY ASSEMBLT OFGOD,5,1,4
173,3048290001,BK,451 CLARKSON AVENUE,08,I1,NYC HEALTH AND HOSPITALS CORPORATION,15,11,4
174,4035690009,QN,58-04 ST FELIX AVENUE,10,G1,ANYC SQUIRE REALTY LLC,6,2,4
175,2027620316,BX,850 EDGEWATER ROAD,,Z9,HUGO NEU SCHNITZER EAST,7,3,4
176,5015527501,SI,10 PARKVIEW LOOP,02,R3,NAME NOT ON FILE,160,156,4
177,3025820004,BK,856 HUMBOLDT STREET,10,G7,860 HUMBOLDT STREET REALTY LLC,5,1,4
178,4066770001,QN,71-01 150 STREET,02,C6,UNAVAILABLE OWNER,54,50,4
179,5024507510,SI,72 RUMSON ROAD,02,R3,OAKS AT LA TOURETTE I,112,108,4
180,1010967501,MN,660 JOE DIMAGGIO HIGHWAY,06,RW,UNAVAILABLE OWNER,5,1,4
181,4015040139,QN,40-67G HAMPTON STREET,10,G1,"85-37 BRITTON, LLC",5,1,4
182,3010350071,BK,273 14 STREET,03,D1,269-273 14TH ST NY CORP,5,1,4
183,3086720033,BK,273 BRIGHTON BEACH AVENUE,05,K2,BRIGHTON TEMA LLC,5,1,4
184,3073700010,BK,3094 AVENUE U,07,G4,BOLLA CITY HOLDINGS CORP.,5,1,4
185,1014860005,MN,503 EAST 74 STREET,07,U2,"CONSOLIDATED EDISON CO.OF N.Y.,INC.",6,2,4
186,4041320001,QN,126-19 126 STREET,07,G2,127TH ST REALTY CORP,7,3,4
187,3007250001,BK,5102 1 AVENUE,07,T9,NYC DEPARTMENT OF SMALL BUSINESS SERVICES,20,16,4
188,5027900001,SI,798 TRAVIS AVENUE,07,Y6,NYC DEPARTMENT OF GENERAL SERVICES,11,7,4
189,1014880017,MN,76-01 FDR DRIVE,09,Q1,NYC DEPARTMENT OF PARKS AND RECREATION,5,1,4
190,1007600001,MN,468 9 AVENUE,04,K4,36TH HY LLC,6,2,4
191,4090550038,QN,84-09 101 AVENUE,01,B1,"PEREZ, HECTOR",5,1,4
192,3001660025,BK,308 LIVINGSTON STREET,11,V1,"LIVINGSTON OWNER, LLC,",5,1,4
193,5011070024,SI,2537 RICHMOND TERRACE,07,G9,STATEN ISLAND HOLDINGS LLC,5,1,4
194,4097240067,QN,85-70 148 STREET,08,N3,ST CHRISTOPHER-OTTILIE,14,10,4
195,3018620001,BK,11 NEW YORK AVENUE,05,K6,RDC COMM CENTER INC,6,2,4
196,5035250200,SI,640 FATHER CAPODANNO BL,09,Q4,NYC DEPARTMENT OF PARKS AND RECREATION,14,10,4
197,3053507501,BK,1463 36 STREET,02,R3,UNAVAILABLE OWNER,6,2,4
198,4059170001,QN,423 ABBOTT ROAD,08,Y1,FIRE DEPARTMENT OF NEW YORK,110,106,4
199,5037310041,SI,507 BEDFORD AVENUE,01,A6,"MOLINO DEVELOPMENT ,LLC",4,1,3
200,3017780031,BK,13 SPENCER COURT,03,D1,PERSAM WHITE LLC,4,1,3
201,2046660052,BX,710 EAST 219 STREET,02,C0,"LAFLAMME, JENA",4,1,3
202,3079200096,BK,8424 DITMAS AVENUE,07,U2,BKLYN UNION GAS,12,9,3
203,4133100051,QN,145-88 GUY R BREWER BLVD,08,W9,14588 GUY BREWER CORP,4,1,3
204,4021187501,QN,99-32 66 ROAD,04,RM,UNAVAILABLE OWNER,6,3,3
205,4001150056,QN,47-17 27 STREET,06,F5,CHAVES DEVELOPMENT LLC,5,2,3
206,3052890083,BK,1021 38TH STREET,08,P5,1021-1023 38TH STREET DEVELOPMENT LLC,4,1,3
207,4006780003,QN,40-13 BROADWAY,04,C7,40-13-15 BROADWAY LLC,4,1,3
208,4040190120,QN,114-08 TAIPEI COURT,11,V2,114-08 TAIPEI INC.,4,1,3
209,5011040027,SI,6 LAFORGE PLACE,01,B3,"WOOLF, JASON",5,2,3
210,1020520001,MN,319 WEST 145 STREET,09,Q1,NYC DEPARTMENT OF PARKS AND RECREATION,7,4,3
211,4003570001,QN,37-20 37 AVENUE,07,U2,"UNIT 40 SUBLESSOR, LLC",43,40,3
212,5002150208,SI,827 POST AVENUE,01,B2,THOMAS PILUSO,6,3,3
213,4000980009,QN,47-07 PEARSON PLACE,06,E1,NYC POLICE DEPARTMENT,4,1,3
214,2026230213,BX,605 JACKSON AVENUE,04,D7,HP JACKSON AVENUE HOUSING DEVELOPMENT FU ND CO INC,4,1,3
215,4161730028,QN,100-03 ROCKAWAY BEACH BLVD,02,C9,"B101, LLC",11,8,3
216,4062770050,QN,42-06 212 STREET,02,C9,WPH APT INC,9,6,3
217,1015450014,MN,333 EAST 82 STREET,11,V1,333 EAST 82ND STREET DEVELOPMENT LLC,4,1,3
218,3050840049,BK,186 LENOX ROAD,03,D3,186 LENOX LLC,4,1,3
219,3039810010,BK,586 LIBERTY AVENUE,02,C0,YEDID LLC,4,1,3
220,5044410200,SI,74 CEDARVIEW AVENUE,08,P9,NYC DEPARTMENT OF PARKS AND RECREATION,7,4,3
221,1013820065,MN,6 EAST 68 STREET,03,D4,EAST 68 ST TENANTS CORP,5,2,3
222,5053070006,SI,4106 HYLAN BOULEVARD,05,K7,4102 HYLAN REALTY LLC,4,1,3
223,2043550001,BX,999 PELHAM PARKWAY NORTH,08,W3,NY INSTIT FOR ED OF B,19,16,3
224,3022990021,BK,215 NORTH 10 STREET,11,V0,215 N 10 PARTNERS LLC,7,4,3
225,4025460024,QN,46-36 54 ROAD,06,E9,SKANSKA NE REALTY INC.,9,6,3
226,3005290001,BK,163 IMLAY STREET,08,W2,YESHIVATH KEHILATH YAKOV INC.,4,1,3
227,4003230001,QN,34-64 9 STREET,04,S1,"SAYANONON, JANECHAI",4,1,3
228,4018550074,QN,90-03 54 AVENUE,02,C0,"CHENG, KWAI YING",4,1,3
229,2032730390,BX,501 EAST FORDHAM ROAD,08,W7,"MCFARLAND, MICHAEL C REV.",5,2,3
230,3009210001,BK,4200 7 AVENUE,09,Q1,NYC DEPARTMENT OF PARKS AND RECREATION,7,4,3
231,3070650100,BK,WEST 37 STREET,09,Q4,NYC DEPARTMENT OF PARKS AND RECREATION,8,5,3
232,4067900001,QN,65-30 160 STREET,03,D4,THIRD HOUSING CO INC,32,29,3
233,1010560001,MN,465 WEST 46 STREET,02,C6,CLINTON 510 OWNERS HDF CORP,11,8,3
234,1016710039,MN,314 EAST 100 STREET,04,C7,N Y C H A,4,1,3
235,5055700001,SI,831 ARTHUR KILL ROAD,05,K5,NYC DEPARTMENT OF PARKS AND RECREATION,8,5,3
236,3052707501,BK,143 MCDONALD AVENUE,02,R3,UNAVAILABLE OWNER,4,1,3
237,4079290002,QN,224-01 HILLSIDE AVENUE,02,C6,UNAVAILABLE OWNER,135,132,3
238,3050500051,BK,697 PARKSIDE AVENUE,08,W1,NYC DEPARTMENT OF EDUCATION,4,1,3
239,3019090015,BK,131 EMERSON PLACE,08,H8,PRATT INSTITUTE,4,1,3
240,5044670043,SI, CLARKE AVENUE,11,V0,PAT PAPPALARDO,6,3,3
241,3052970036,BK,4002 14 AVENUE,04,S4,MOTION REALTY LLC,4,1,3
242,5005340025,SI,15 VANDERBILT AVENUE,11,V0,THE SALVATION ARMY,7,4,3
243,4087620001,QN,268-18 82 AVENUE,02,C6,UNAVAILABLE OWNER,61,58,3
244,3085900600,BK,3000 FLATBUSH AVENUE,09,Q1,NYC DEPARTMENT OF PARKS AND RECREATION,13,10,3
245,3071040475,BK,2090 EAST 2 STREET,01,A7,"SHEHEBAR, GABRIEL",4,1,3
246,4073090027,QN,210-20 NORTHERN BOULEVARD,05,K1,BARONE PROPERTIES INC,4,1,3
247,5012770272,SI,108 MACORMAC PLACE,01,A9,DONALD M BLEVINS,4,1,3
248,2040820001,BX,1615 EASTCHESTER ROAD,08,I5,FRAN ANG REALTY CORP,4,1,3
249,3036690022,BK,50 PENNSYLVANIA AVENUE,11,V1,"2618 FULTON STREET REALTY, LLC",4,1,3
250,2058030801,BX,4481 MANHATTAN COLLEGE PY,08,W6,MANHATTAN COLLEGE,15,12,3
251,4087430102,QN,81-15 268 STREET,02,C6,UNAVAILABLE OWNER,78,75,3
252,3003950030,BK,58 SAINT MARKS PLACE,04,D7,4TH AVENUE DEVELOPMENT OWNER LLC,4,1,3
253,4005700033,QN,23-20 30 DRIVE,02,C1,LILLO LLC,4,1,3
254,2026900081,BX,881 EAST 162 STREET,03,D1,SENIOR LIVING OPTIONS INC,4,1,3
255,2027790001,BX, RYAWA AVENUE,07,Y6,NYC DEPARTMENT OF SANITATION,4,1,3
256,4066800001,QN,147-08 72 ROAD,02,C9,"KEW GARDENS HILLS, LLC",11,8,3
257,4014790006,QN,91-14 37 AVENUE,08,I9,C2 DEVELOPMENT CORP.,5,2,3
258,1014910021,MN,1045 MADISON AVENUE,11,V1,1039-1045 MADISON AVE OWNER LLC,4,1,3
259,4016190017,QN,43-22 102 STREET,07,G9,"VILLEGAS, JANETT",4,1,3
260,4010500002,QN,25-06 75 STREET,08,W3,LEXINGTON SCH FOR DEA,4,1,3
261,2056480192,BX,678 KING AVENUE,01,A1,"MCGUIRE, FRANCIS C",5,2,3
262,3017030036,BK,14 BUFFALO AVENUE,02,C0,451 MARION LLC,4,1,3
263,4163500500,QN,422 ROCKAWAY POINT BOULE,09,Q9,UNITED STATES OF AMERICA,71,68,3
264,4005020007,QN,31-43 VERNON BOULEVARD,04,D7,VERNON TOWER LLC,4,1,3
265,4062810001,QN,210-02 43 AVENUE,02,C9,ABK APARTMENTS INC,5,2,3
266,3055607501,BK,1768 66 STREET,02,R3,UNAVAILABLE OWNER,4,1,3
267,1011970039,MN,10 WEST 84 STREET,08,W2,CONGREGATION REDEPH SHOLOM/DAY,4,1,3
268,4014210001,QN,32-45 91 STREET,03,D4,NORTHRIDGE COOPERATIVE SECTION,5,2,3
269,4040767501,QN,15-08 COLLEGE POINT BLVD,05,RC,BAIK HAP HUIA CO,5,2,3
270,4008980001,QN,24-02 19 STREET,09,Q1,NYC DEPARTMENT OF PARKS AND RECREATION,9,6,3
271,4042240044,QN,120-15 25 AVENUE,01,B1,"CHEN, JIAN SHENG",4,1,3
272,5071060176,SI,752 BLOOMINGDALE ROAD,01,A5,KENNETH OTTEN,4,1,3
273,4014200001,QN,32-45 90 STREET,03,D4,NORTHRIDGE CO-OP SECTION II INC,6,3,3
274,3045950015,BK,60 EAST 94 STREET,08,W1,CITY OF NEW YORK,4,1,3
275,4002940270,QN,30-23 GREENPOINT AVENUE,06,E9,3023 GPT LLC,5,2,3
276,2027660254,BX,669 DRAKE STREET,,Z9,"669 DRAKE STREET REALTY, LLC",4,1,3
277,2054890007,BX,585 WILCOX AVENUE,01,A2,GAIL ANDREWS MAITA,4,1,3
278,5005150072,SI,37 JACKSON STREET,01,A5,JACKSON VENTURES LLC,6,3,3
279,4014090045,QN,31-49 97 STREET,01,B1,"AREVALO , MILTON",4,1,3
280,2055210170,BX,140 REYNOLDS AVENUE,09,Q8,NYC DEPARTMENT OF PARKS AND RECREATION,4,1,3
281,5054600037,SI,4255 AMBOY ROAD,05,K6,SUNNY MEADE LEASING LLC,4,1,3
282,4073490001,QN,47-15 216 STREET,02,C6,JEFFREY GARDENS APARTMENT CORP,9,6,3
283,5002150100,SI,5 DUBOIS AVENUE,07,Y9,NYC DEPARTMENT OF ENVIRONMENTAL PROTECTION,8,5,3
284,2047530029,BX,3333 BRUNER AVENUE,03,D1,BEECHWOOD BRUNER MGMT CORP,4,1,3
285,4109060001,QN,203-02 203 STREET,08,W1,NYC DEPARTMENT OF EDUCATION,5,2,3
286,1008960001,MN,125 3 AVENUE,08,H8,CORAL CRYSTAL LLC,4,1,3
287,4003530004,QN,36-25 10 STREET,06,F4,"36-25 10TH STREET, LLC",4,1,3
288,3014290156,BK,805 EAST NEW YORK AVENUE,03,D9,UNAVAILABLE OWNER,4,1,3
289,2026050020,BX, NORTH BROTHER ISLAND,08,I9,NYC DEPARTMENT OF PARKS AND RECREATION,13,10,3
290,5006470028,SI,315 HILLSIDE AVENUE,01,A1,"CHEN, XUEMOU",4,1,3
291,5006830001,SI,715 OCEAN TERRACE,08,W1,NYC DEPARTMENT OF EDUCATION,8,5,3
292,1006760001,MN,WEST 30 STREET,11,V1,WRY TENANT LLC,7,4,3
293,3076590023,BK,1353 EAST 23 STREET,01,A1,"AVERY EISENREICH, TRUSTEE",4,1,3
294,5025200001,SI,2171 RICHMOND AVENUE,07,Y6,NYC DEPARTMENT OF PARKS AND RECREATION,8,5,3
295,5004870112,SI,14 VICTORY BOULEVARD,07,U6,MTA - STATEN ISLAND RAILWAY,10,7,3
296,4066790006,QN,147-07 72 ROAD,02,C9,"KEW GARDENS HILLS, LLC",9,6,3
297,3071310062,BK,2197 EAST 4 STREET,01,A3,"TAWIL, JOSEPH",4,1,3
298,5012560092,SI,82 DAVIDSON STREET,06,E1,60 DAVIDSON LLC,5,2,3
299,5005930500,SI,300 HOWARD AVENUE,08,W6,ST JOHNS UNIVERSITY,13,10,3
300,4011360006,QN,31-15 60 STREET,08,M1,R C CH CORPUS CHRISTI,4,1,3
301,3086650503,BK,7 BRIGHTON 5 PLACE,11,V0,NUVO TOWER LLC,4,1,3
302,2030670042,BX,2500 HOFFMAN STREET,02,C0,"2500-04 HOFFMAN STREET, LLC",4,1,3
303,4159800002,QN,54-02 ALMEDA AVENUE,09,Q1,NYC DEPARTMENT OF PARKS AND RECREATION,7,4,3
304,4035610001,QN,17-15 WEIRFIELD STREET,08,W1,NYC DEPARTMENT OF EDUCATION,4,1,3
305,3029420101,BK,200 MORGAN AVENUE,06,E1,GREENPOINT BUSHWICK LLC,5,2,3
306,4003580012,QN,37-11 VERNON BOULEVARD,06,F4,"VERNON ASSOCIATES, LLC",4,1,3
307,1007800026,MN,209 WEST 30 STREET,08,M1,CH ST JOHN BAPTIST,5,2,3
308,3025080001,BK,1 KINGSLAND AVENUE,07,Y6,NYC DEPARTMENT OF SANITATION,12,9,3
309,3041050032,BK,800 JAMAICA AVENUE,04,K4,800 JAMAICA AVENUE,4,1,3
310,2032730001,BX,441 EAST FORDHAM ROAD,08,W6,FORDHAM UNIVERSITY,39,36,3
311,1005490001,MN,3 WASHINGTON SQUARE N,09,Q1,NYC DEPARTMENT OF PARKS AND RECREATION,5,2,3
312,1004020045,MN,539 EAST 6 STREET,03,D1,SIX AB LLC,5,2,3
313,4008500001,QN,,07,U2,CON EDISON,94,91,3
314,2033270001,BX,111 EAST 210 STREET,08,I1,MONTEFIORE MEDICAL CENTER,9,6,3
315,2033090023,BX,3055 VALENTINE AVENUE,04,D7,3055 VALENTINE AVE LLC,6,3,3
316,5000760001,SI,1000 SNUG HARBOR ROAD,08,P7,NYC DEPARTMENT OF PARKS AND RECREATION,28,25,3
317,2042260030,BX,1500 WATERS PLACE,08,I1,NYC DEPARTMENT OF DESIGN AND CONSTRUCTION,31,28,3
318,4004760001,QN,8-33 40 AVENUE,06,E7,"VERNON BOULEVARD REALTY, LLC",10,7,3
319,2032370090,BX,2658 KINGSBRIDGE TERRACE,01,B1,2660 KINGSBRIDGE RESIDENCE PLACE LLC,4,1,3
320,1010230002,MN,852 8 AVENUE,04,C7,854 EIGHTH PARTNERS,6,3,3
321,1015197501,MN,181 EAST 90 STREET,04,RM,UNAVAILABLE OWNER,4,1,3
322,4005760012,QN,25-10 30 AVENUE,08,I1,MOUNT SINAI HOSPITAL,6,3,3
323,3067740001,BK,1941 CONEY ISLAND AVENUE,04,K4,1941 CONEY ISLAND AVE LLC,4,1,3
324,4097627501,QN,88-20 PARSONS BOULEVARD,04,RM,UNAVAILABLE OWNER,4,1,3
325,3018750014,BK,55 WASHINGTON AVENUE,06,E1,HALL STREET REAL ESTATE LLC,4,1,3
326,5039830013,SI,2712 HYLAN BOULEVARD,05,K6,PARK TYSEN ASSOCIATES LLC,9,6,3
327,3005800024,BK,832 HICKS STREET,02,C1,838 HICKS ST LLC,4,1,3
328,3023760006,BK,49 RIVER STREET,07,U0,PEOPLE OF THE STATE OF NY-NYPA,15,12,3
329,5006100420,SI,186 HIGHLAND AVENUE,01,A5,"BESHIRI, JAMES",4,1,3
330,5077920228,SI,438 PAGE AVENUE,01,A1,7792 PARTNERS LLC,4,1,3
331,3014700035,BK,1766 STERLING PLACE,02,C0,NYC HOUSING AUTHORITY,4,1,3
332,3071120009,BK,2316 CONEY ISLAND AVENUE,11,V1,2320 CONEY LLC,4,1,3
333,4024230001,QN,67-25 51 ROAD,08,W1,NYC DEPARTMENT OF EDUCATION,4,1,3
334,2056470017,BX,532 MINNIEFORD AVENUE,01,B9,"CASTAGNOZZI, MARY ANN",5,2,3
335,3037010001,BK,317 GLENMORE AVENUE,06,F2,SBM REALTY LLC,6,3,3
336,5064310001,SI,54 DISCALA LANE,11,V0,"SAVO, OTTAVIO",6,3,3
337,2037480002,BX,1688 WESTCHESTER AVENUE,05,K1,1688 ROJAV REALTY LLC,4,1,3
338,3013270001,BK,57 LINCOLN ROAD,04,D7,M & B LINCOLN REALTYCP,5,3,2
339,4122690029,QN,127-04 BAISLEY BOULEVARD,05,K1,MADISON QUEENS-GUY BREWER,3,1,2
340,2046550043,BX,3837 WHITE PLAINS ROAD,08,M1,"MIRACLE PROVIDER CHURCH, INC",4,2,2
341,2033570018,BX,3128 WEBSTER AVENUE,06,E9,MAURICE SARKISSIAN,4,2,2
342,5001850400,SI,1801 RICHMOND TERRACE,07,U9,NYC DEPARTMENT OF ENVIRONMENTAL PROTECTION,5,3,2
343,2031560052,BX,2072 ANTHONY AVENUE,02,C3,2072 ANTHONY LLC,3,1,2
344,5031250003,SI, FATHER CAPODANNO BL,09,Q1,NYC DEPARTMENT OF PARKS AND RECREATION,8,6,2
345,5026290075,SI,53 MILDRED AVENUE,01,A2,"GARLAND, JOHN",3,1,2
346,1007677501,MN,158 8 AVENUE,04,RM,NATIONWIDE ASSOCIATES INC,3,1,2
347,1006150015,MN,264 WEST 12 STREET,01,A9,"ERICSSON, ALICE",3,1,2
348,2034560002,BX,1927 GILDERSLEEVE AVENUE,11,V1,1927 GILDERSLEEVE REALTY CORP.,3,1,2
349,5066900001,SI,590 SEGUINE AVENUE,09,Q9,NYC DEPARTMENT OF PARKS AND RECREATION,3,1,2
350,5065170077,SI,165 ARBUTUS AVENUE,01,B2,"SAVIN, ROBIN",3,1,2
351,5027840110,SI,1322 TRAVIS AVENUE,09,Q2,MID-ISLAND LITTLE LEA,6,4,2
352,5017250095,SI,1000 SOUTH AVENUE,05,O2,"CELL TOWER LEASE ACQUISITION, LLC",3,1,2
353,5012780460,SI,244 ARLINGTON AVENUE,06,E1,244 ARLINGTON AVE. ASSOCIATES LLC,4,2,2
354,2028650088,BX,1495 INWOOD AVENUE,07,G9,CASSAR AUTO SVCE INC,4,2,2
355,2027970039,BX,1771 MONROE AVENUE,03,D3,SOBRO MONROE COURT HOUSING DEVELOPMENT F UND CORP.,3,1,2
356,4003130001,QN,33-26 VERNON BOULEVARD,05,K8,MBA VERNON BOULEVARD,3,1,2
357,5004410011,SI,178 LATHROP AVENUE,01,A1,"DARROW, MARK",4,2,2
358,1010580016,MN,425 WEST 48 STREET,02,C4,"CLINTON HOUSING PRESERVATION, L.P.",3,1,2
359,5020400001,SI,2800 VICTORY BOULEVARD,08,W5,DASNY,37,35,2
360,4126960037,QN,131-15 MERRICK BOULEVARD,06,E1,A G E ACQUISITIONS,8,6,2
361,5012660056,SI,190 SOUTH AVENUE,01,B2,PAUL CULOTTA,3,1,2
362,5011720130,SI,236A GRANITE AVENUE,01,A5,TPZ CORPORATION C/O S,3,1,2
363,4099740029,QN,138-07 90 AVENUE,01,B3,RADHA MAHARAJ,3,1,2
364,4000170001,QN,2-33 50 AVENUE,06,E9,FORTRESS NEW YORK HOLDING INC,3,1,2
365,4108190001,QN,92-41 190 STREET,03,D1,RDH CRYSTAL GARDENS LLC,5,3,2
366,4099380078,QN,86-45 87 DRIVE,08,M1,PASSIONIST MONASTERY OF THE IMMACULATE C ONCEPTION,3,1,2
367,5067500036,SI,65 FINLAY AVENUE,11,V0,54 FINLAY AVE LLC,3,1,2
368,4040610011,QN,110-30 15 AVENUE,06,E2,"110-20 15TH AVENUE REALTY, LLC",4,2,2
369,2026060030,BX,1110 OAK POINT AVENUE,06,F9,1381 MYRTLE REALTY CORP.,4,2,2
370,5069090032,SI,391 ASHLAND AVENUE,01,A1,"CHAY, RON",3,1,2
371,2025270050,BX,240 WEST 167 STREET,04,D7,"HIGHBRIDGE OVERLOOK PARTNERSHIP HDFC, IN C.",3,1,2
372,4004890023,QN,4-99 44 DRIVE,05,K2,NYC DEPARTMENT OF SMALL BUSINESS SERVICES,3,1,2
373,4037720033,QN,67-74 75 STREET,02,C0,"MOURADIAN, ONNIK",3,1,2
374,1012970031,MN,155 EAST 42 STREET,05,K2,R&S TRYLONS LLC,3,1,2
375,3055370029,BK,1554 63 STREET,06,E1,1570 REALTY LLC,4,2,2
376,1012500045,MN,312 WEST 89 STREET,02,C5,"TWO TEN NET TEN, L.L.C",4,2,2
377,3081450021,BK,945 EAST 95 STREET,01,A9,945 EAST 95TH STREET CORPORATION,4,2,2
378,5075840077,SI,4850 ARTHUR KILL ROAD,05,K1,PPR REALTY INC.,5,3,2
379,3041010036,BK,40 LOGAN STREET,01,B9,ALEJANDRA A. CHECO,3,1,2
380,4120450001,QN,120-45 SUTPHIN BOULEVARD,03,D1,BAISLEY L.P.,3,1,2
381,1000160003,MN,401 SOUTH END AVENUE,,Z9,NYC DEPARTMENT OF TRANSPORTATION,9,7,2
382,3006530003,BK,26 STREET,07,U8,RAGFY HOLDINGS LLC,14,12,2
383,4129560001,QN,216-03 MERRICK BOULEVARD,05,K5,ONJ HOLDING CORP,3,1,2
384,5008680009,SI,147 BENEDICT ROAD,01,A3,NICHOLAS PETROSINO,3,1,2
385,3004480054,BK,515 CARROLL STREET,01,B1,513 ASSOCIATES LLC,3,1,2
386,5010120111,SI,23 NEW STREET,01,B3,"CANEDO, GONZALO",3,1,2
387,3076090067,BK,1054 EAST 28 STREET,01,A9,"1054 E. 28TH STREET, LLC",4,2,2
388,1006130059,MN,61 GREENWICH AVENUE,07,U0,NYC TRANSIT AUTHORITY,3,1,2
389,3072730025,BK,2928 WEST 5 STREET,03,D4,TRUMP VILLAGE SECTION 4 INC,3,1,2
390,3045440001,BK,612 WORTMAN AVENUE,10,G1,"612 WORTMAN AVENUE, LLC",3,1,2
391,2054030001,BX,1523 JARVIS AVENUE,02,C2,KROSCHE JEFFREY C,4,2,2
392,4107830042,QN,218-65 98 AVENUE,02,C9,"QUEENS GARDEN APARTMENTS, LLC",10,8,2
393,4093050005,QN,115-12 JAMAICA AVENUE,04,K4,FSJ REALTY GROUP LLC,3,1,2
394,2048650042,BX,911 EAST 229 STREET,02,C0,"GAUVIN, LESLIE SR",3,1,2
395,2033150019,BX,2738 CRESTON AVENUE,02,C1,2732 CRESTON DEVELOPMENT LLC,3,1,2
396,1007330070,MN,452 10 AVENUE,10,G6,"SHERWOOD 36 ASSOCIATES, L.P.",3,1,2
397,2029060093,BX,463 EAST 173 STREET,06,E9,TASMA REALTY CORP,3,1,2
398,2028760217,BX,1661 NELSON AVENUE,02,C0,FERNANDEZ ADALGISA,3,1,2
399,2027610092,BX,919 BRYANT AVENUE,02,C0,"MOQUETE, MANUEL T",3,1,2
400,3064910011,BK,1608 SHORE PARKWAY,05,K6,CBB VENTURE LLC,8,6,2
401,5034120047,SI,82 MC LAUGHLIN STREET,01,A2,"OMELYANCHENKO, ANDRIY",4,2,2
402,5026610200,SI,2 CRABBS LANE,01,A9,OKRASZEWSKI JOHN,4,2,2
403,3058990001,BK,7109 6 AVENUE,08,W1,NYC DEPARTMENT OF EDUCATION,3,1,2
404,1000580001,MN,185 GREENWICH STREET,05,O4,PORT AUTHORITY OF NY AND NJ,10,8,2
405,5051570052,SI,77 TARLEE PLACE,01,B2,"KOLODIY, IGOR",3,1,2
406,2048630027,BX,939 EAST 227 STREET,02,C0,"MORGAN, NATALEE",3,1,2
407,5005260052,SI,160 CANAL STREET,01,A1,"NG, KAR  Y",3,1,2
408,4161190097,QN,3-45 BEACH 87 STREET,02,C9,JACQUELINE M. SMITH,6,4,2
409,3027890026,BK,203 MAUJER STREET,02,C4,"SUBASIC, NASER",3,1,2
410,4069590001,QN,71-52 172 STREET,08,M1,"FRESH MEADOWS BUKHARIAN SYNAGOGUE, INC.",3,1,2
411,4045020032,QN,10-14 150 STREET,01,B3,10-14 150TH STREET LLC,3,1,2
412,4041710017,QN,20-09 126 STREET,01,A1,RJL 2015 REALTY LLC,3,1,2
413,4032340051,QN,68-09 BURNS STREET,03,D1,"BURNS MANAGEMENT CO.,",10,8,2
414,4030950078,QN,64-18 BOOTH STREET,11,V0,BOOTH HOLDINGS LLC,5,3,2
415,4093310030,QN,87-46 123 STREET,06,F1,ALPHAPOINTE,12,10,2
416,4019840057,QN,104-47 41 AVENUE,01,B2,CHUNG ELIZABETH,3,1,2
417,4028450009,QN,75-08 CALDWELL AVENUE,01,B2,"ZHENG, DAI RONG",3,1,2
418,4087450001,QN,81-69 LANGDALE STREET,02,C6,LANGDALE OWNERS CORP,22,20,2
419,4061750020,QN,214-43 36 AVENUE,01,A1,"WONG, KIM CHIU SIMON",3,1,2
420,3041040012,BK,43 CHESTNUT STREET,01,B2,"GIL, JOSE M",4,2,2
421,4084900002,QN,245-24 76 AVENUE,02,C6,GLEN OAKS VILLAGE OWNERS INC,90,88,2
422,3067070043,BK,1423 AVENUE J,04,S9,SAYA36 LLC,3,1,2
423,3061187502,BK,447 95 STREET,02,R3,UNAVAILABLE OWNER,3,1,2
424,3019120003,BK,913 KENT AVENUE,11,V0,NYC DEPARTMENT OF ENVIRONMENTAL PROTECTION,3,1,2
425,3052730043,BK,411 GREENWOOD AVENUE,01,B2,"BARUFALDI, DANIEL R",3,1,2
426,2051410101,BX,2001 BARTOW AVENUE,05,K1,BAYCHESTER RETAIL III LLC,3,1,2
427,5066800025,SI,46 PATRICIA COURT,01,A1,"SALADINO, ANTHONY M",3,1,2
428,3050170017,BK,807 EAST 42 STREET,06,E1,LUCKY MCMXCVI LLC,3,1,2
429,5068170021,SI,33 WEST TERRACE,01,A2,"TERRACE ESTATES, LLC",3,1,2
430,3052710001,BK,3 EAST 2 STREET,01,A1,"PITSILLOS, ANDRONIKOS",3,1,2
431,3010987509,BK,438 12 STREET,03,R4,UNAVAILABLE OWNER,5,3,2
432,3006210001,BK,688 COURT STREET,06,F5,688 COURT STREET LLC,5,3,2
433,2056340126,BX,435 CITY ISLAND AVENUE,04,K4,D & D BOWNE ST. REALTY CORP.,3,1,2
434,3041540028,BK,281 LOGAN STREET,07,G9,NYC PARTNERSHIP HOUSING DEVELOPMENT FUND,3,1,2
435,3027750021,BK,204 AINSLIE STREET,01,B2,"LIVORNESE, VITO",3,1,2
436,3039230025,BK,18 ASHFORD STREET,01,B9,PARSUERAM INDARJIT,3,1,2
437,2055297502,BX,1 PENNYFIELD AVENUE,02,R2,UNAVAILABLE OWNER,17,15,2
438,1020310003,MN,2738 FREDRICK DOUGLASS BL,04,C7,HARLEM SHANGRI-LA HOUSING DEVELOPMENT FU ND,5,3,2
439,1017370011,MN,580 LENOX AVENUE,05,K1,580 LENOX ASSOCIATES LLC,3,1,2
440,1000740001,MN,89 SOUTH STREET,05,K9,NYC DEPARTMENT OF PARKS AND RECREATION,19,17,2
441,5038610101,SI,669 HUNTER AVENUE,01,A2,"NARANJO, CESAR E",3,1,2
442,2023870010,BX,3362 PARK AVENUE,06,E7,"JSF PARK AVENUE CMPI, LLC",3,1,2
443,5018010025,SI,436 SPENCER STREET,06,E1,"DENAREN PROPERTIES, LLC",3,1,2
444,1006300012,MN,272 WEST 10TH STREET,08,W3,VILLAGE COMMUNITY SCHOOL,4,2,2
445,1022330020,MN,630 ACADEMY STREET,08,W1,NYC DEPARTMENT OF EDUCATION,3,1,2
446,4051830055,QN,143-17 FRANKLIN AVENUE,08,M1,KOREAN PRESBYTERIAN CHURCH OF QUEENS INC,4,2,2
447,1013730030,MN,510 MAIN STREET,04,D6,ROOSEVELT ISLAND OPERATING CORPORATION,6,4,2
448,3009080177,BK,8 AVENUE,07,U0,UNAVAILABLE OWNER,5,3,2
449,4033760001,QN,19-06 FLUSHING AVENUE,11,V1,1906 FLUSHING LLC,4,2,2
450,5001150059,SI,10 CEBRA AVENUE,04,S9,J I Q REALTY INC,4,2,2
451,4136240001,QN,139-49 HOOK CREEK BOULEVARD,01,A2,"BIGAUD, ELIZABETH",3,1,2
452,1020260009,MN,233 WEST 140 STREET,03,D1,MAXWELL DEVELOPMENTL.P.,3,1,2
453,2023710052,BX,3401 3RD AVENUE,06,E9,COMUNILIFE THIRD AVENUE HOUSING DEV. FUN D CORP.,3,1,2
454,4134360043,QN,147-15 223 STREET,01,B3,"JACKSON, CARLOS Y",3,1,2
455,2039377501,BX,1409 METROPOLITAN OVAL,04,RM,PARKCHESTER SOUTH CONDOMINIUM ASSOC,31,29,2
456,4121780004,QN,112-17 159 STREET,06,F5,"CEDAR MANOR HERITAGE, LLC",17,15,2
457,1010810050,MN,548 WEST 53 STREET,04,D6,CLINTON HOUSING DEVELOPMENT,3,1,2
458,3023057501,BK,172 NORTH 10 STREET,03,R4,UNAVAILABLE OWNER,3,1,2
459,5071870001,SI,2911 ARTHUR KILL ROAD,05,J9,STATEN ISLAND STAGES LLC,27,25,2
460,4033260010,QN,111 AUDLEY STREET,01,A3,AUDLEY ESTATES LLC,4,2,2
461,4104470007,QN,191-02 90 AVENUE,08,W1,NYC DEPARTMENT OF EDUCATION,3,1,2
462,2055160215,BX,16B EDGEWATER PARK,01,A8,EDGEWATER PARK OWNRSETC,58,56,2
463,3059750118,BK,8068 NARROWS AVENUE,01,A3,"PALMESE, VANESSA",3,1,2
464,3019510029,BK,48 CLIFTON PLACE,02,C0,"LYNDA, SHAUN L",3,1,2
465,2035250013,BX,510 LELAND AVENUE,01,B3,LUZ RESPLANDECIENTE PENTECOASTAL CHURCH  INC,4,2,2
466,2044310041,BX,2475 BOSTON ROAD,07,G3,2475 REALTY LLC,3,1,2
467,3058770001,BK,6917 8 AVENUE,04,C7,801 70TH STREET LLC,3,1,2
468,5027760076,SI,30 MEREDITH AVENUE,01,A1,"ANN M. GOLD,AS TRUSTEE OF THE GOZAN IRRE V. TRUST",3,1,2
469,4019840001,QN,104-14 ROOSEVELT AVENUE,05,K2,ESHOKOL DEVELOPMENT CORP,3,1,2
470,4033210001,QN,116-02 METROPOLITAN AVENUE,05,K1,DAVID J. MCKENZIE LIVING TRUST,3,1,2
471,3007060024,BK,3915 1 AVENUE,06,E9,19-20 BUSH TERMINAL OWNER LP,4,2,2
472,2039720059,BX,1561 ZEREGA AVENUE,02,C0,"MORILLO, PEDRO H",3,1,2
473,2048890002,BX,3641 BOSTON ROAD,05,GU,"MARY PROVINO, AS TRUSTEE",3,1,2
474,2040660025,BX,1545 HAIGHT AVENUE,01,B1,"OLIVER, MARK",3,1,2
475,4098340033,QN,175-52 HILLSIDE AVENUE,05,K7,"175 HILLSIDE ASSOCIATES,",3,1,2
476,4012230001,QN,68-21 ROOSEVELT AVENUE,08,M1,"THE UNIVERSAL CHURCH, INC.",4,2,2
477,5064290084,SI,24 BLUE HERON COURT,01,B2,"FISCHETTI, BARBRA",3,1,2
478,1000907503,MN,5 BEEKMAN STREET,04,RM,UNAVAILABLE OWNER,4,2,2
479,1021380159,MN,4023 BROADWAY,04,K4,"ROYAL CHARTER PROPERTIES, INC.",4,2,2
480,4005520022,QN,21-16 31 AVENUE,04,D6,THIRTY-FIRST AVENUE LLC,3,1,2
481,3012000027,BK,1260 ATLANTIC AVENUE,06,F9,1260 ATLANTIC AVENUE LLC,3,1,2
482,2048650052,BX,4114 BRONXWOOD AVENUE,02,C0,"FELICIANO, JOSE W",3,1,2
483,2056550420,BX,917 PEACE STREET,06,E9,CAPASSO HOLDING COMPANY,3,1,2
484,3048860001,BK,3202 CHURCH AVENUE,04,K4,3202 CHURCH LLC.,3,1,2
485,3085900031,BK,2570 FLATBUSH AVENUE,05,K8,"BROOKLYN FLATBUSH AVENUE, LLC",3,1,2
486,5011580022,SI,67 WRIGHT AVENUE,01,A2,LEAMON C HALL,3,1,2
487,4000320018,QN,5-21 50 AVENUE,02,C3,PATRICIA BRANCALE,4,2,2
488,3071920001,BK,248 AVENUE X,05,K2,248 X ROAD LLC,3,1,2
489,1015030044,MN,62 EAST 92 STREET,08,M3,CORP BRICK PRESBY CH,3,1,2
490,4037940047,QN,69-36 76 STREET,10,G1,69-34 MANAGEMENT,3,1,2
491,4127130017,QN,123-19 NELLIS STREET,01,B3,"DALEY, KETURAH",3,1,2
492,5008730027,SI,5 FOUR CORNERS ROAD,08,W3,S I ACADEMY,15,13,2
493,3070620025,BK,1601 SURF AVENUE,10,G6,CONEY ISLAND ASSOCIATES PHASE 2 LLC,3,1,2
494,5004870060,SI,253 BAY STREET,07,G3,ANGIULI MAZDA,3,1,2
495,5012700147,SI,412 SOUTH AVENUE,01,A1,SALVATORE COLUCCIO,3,1,2
496,5010680072,SI,2101 RICHMOND TERRACE,11,V1,AMERCO REAL ESTATE COMPANY,9,7,2
497,4024410007,QN,50-25 71 STREET,10,G1,"NVD REALTY,",4,2,2
498,4019907501,QN,104-22 46 AVENUE,02,R3,NAME NOT ON FILE,4,2,2
499,5006530013,SI,1322 CLOVE ROAD,01,A1,"ANAND, SUNIL",3,1,2
500,2056250249,BX,89 HORTON STREET,01,B2,DANIEL S. CONNOLLY,5,3,2
501,5057060017,SI,150 SHELDON AVENUE,01,B2,"ANNA MARIA CARROLL, TRUSTEE",3,1,2
502,3004617501,BK,406 BOND STREET,02,R2,UNAVAILABLE OWNER,8,6,2
503,3038660038,BK,636 HINSDALE STREET,01,B2,"BROOKS, DELIA",4,2,2
504,4019870055,QN,104-35 44 AVENUE,08,Y1,FIRE DEPARTMENT OF NEW YORK,3,1,2
505,3036670028,BK,40 GEORGIA AVENUE,08,P5,COMMUNITY CARES LOCAL DEVELOPMENT CORPOR ATION,3,1,2
506,5037970005,SI,29 MAPLETON AVENUE,01,B2,29-31 MAPLETON AVENUE LLC,3,1,2
507,5000270023,SI,40 SHERMAN AVENUE,01,B9,KYMIA ALISHAHI,3,1,2
508,3015140067,BK,249 MARION STREET,01,B3,1710 GREENWICH LLC,3,1,2
509,4133120078,QN,145-15 GUY R BREWER BLVD,02,C0,"SINGH, GHANSHAM",3,1,2
510,3029950012,BK,582 JOHNSON AVENUE,06,F5,582 JOHNSON LLC,5,3,2
511,5010890036,SI,304 PORT RICHMOND AVENUE,08,I9,MEALS ON WHEELS OF STATEN ISLAND INC,3,1,2
512,2027290012,BX,726 SOUTHERN BOULEVARD,10,G1,729 BRUCKNER LLC,4,2,2
513,4154530024,QN,9 EAST 8 ROAD,01,A1,SWISTUN ELIZABETH,3,1,2
514,3010530038,BK,220 16 STREET,07,G9,"GREKAM REALTY MANAGEMENT, INC.",5,3,2
515,4157180021,QN,11-40 BAY 24 STREET,01,A1,"BURGER, DAVID",3,1,2
516,4101430061,QN,154-01 109 AVENUE,01,B1,"BROOKS, VERSENA",3,1,2
517,2053360011,BX,2937 BAISLEY AVENUE,02,C0,"CICCONE, PIETRO GIORGIO",3,1,2
518,4159650099,QN,437 BEACH 43 STREET,11,V0,NYC HOUSING PRESERVATION AND DEVELOPMENT,3,1,2
519,4098450045,QN,87-31 KINGSTON PLACE,01,B1,NIRMAL SINGH,3,1,2
520,2058363127,BX,5260 FIELDSTON ROAD,08,W3,RIVERDALE COUNTRY SCH,15,13,2
521,2040920027,BX,1627 BOGART AVENUE,02,C0,GIUSEPPE FERRARI,3,1,2
522,3015540001,BK,2360 FULTON STREET,06,E1,FULTON PARK REALTY LLC,3,1,2
523,4012820040,QN,37-35 69 STREET,01,B1,3735 LLC,3,1,2
524,2056330119,BX,373 CITY ISLAND AVENUE,02,C0,PAUL PIRRAGLIA,4,2,2
525,4133040033,QN,176-16 145 DRIVE,01,B1,"MERCEDES, ENCELIO",3,1,2
526,4157170132,QN,3 BEATRICE COURT,01,B2,"SMARTT, MALCOLM O",3,1,2
527,4076440002,QN,61-53 SPRINGFIELD BLVD,02,C9,MID QUEENS LTD,50,48,2
528,2026040252,BX,977 EAST 149 STREET,06,E1,LIBERTY 977  EAST 149TH STREET LLC,4,2,2
529,5000010245,SI,36 BAY STREET LANDING,10,G7,BAY LANDING HOME OWNERS ASSOC INC.,4,2,2
530,2023490112,BX,60 EAST 149 STREET,,Z9,RIVER EDGE REALTY CORP,4,2,2
531,4104640044,QN,196-11 JAMAICA AVENUE,02,C9,KRCM 1 REALTY CORP.,8,6,2
532,4100020001,QN,95-25 149 STREET,06,F1,ABBOTT WIRE PRODUCTS INC SUCC BY MERGER,8,6,2
533,3018320046,BK,460 NOSTRAND AVENUE,04,C7,TPT BROOKLYN ASSOCIATES,5,3,2
534,4120510020,QN,125-30 SUTPHIN BOULEVARD,03,D1,BAISLEY L.P.,6,4,2
535,2033600130,BX,3900 WEBSTER AVENUE,05,O9,3900 WEBSTER AVENUE LLC,4,2,2
536,4007190003,QN,28-57 45TH STREET,02,C0,WLYU LLC,4,2,2
537,5002030038,SI,122 DONGAN STREET,02,C2,GRINBERG MANAGEMENT AND DEVELOPMENT LLC,4,2,2
538,4071170008,QN,67-00 192 STREET,02,C9,"QUEENS FRESH MEADOWS, LLC",53,51,2
539,5075900064,SI,4465 ARTHUR KILL ROAD,05,K1,4465 ARTHUR KILL ROAD LLC,5,3,2
540,5010500016,SI,28 CORNELL STREET,01,A1,"FLOR, FLORIAN G",4,2,2
541,5079140005,SI,7516 AMBOY ROAD,08,M1,CHURCH OF ST STEPHEN,3,1,2
542,3067980005,BK,1508 KINGS HIGHWAY,07,U7,NYC TRANSIT AUTHORITY,6,4,2
543,4051650001,QN,56-45 MAIN STREET,08,I1,BOOTH MEMORIAL MEDICAL CENTER,3,1,2
544,5078600218,SI,367 LORETTO STREET,01,A1,BORIS SHNAYDMAN,3,1,2
545,4112140014,QN,217-20 112 ROAD,01,B3,RILEY-ALLEN EDWINA,3,1,2
546,5074870222,SI,3026 VETERANS ROAD WEST,06,E7,METRO SI STORAGE LLC,5,3,2
547,4103710017,QN,104-16 186 STREET,08,I5,SALVATION ARMY,3,1,2
548,4093520028,QN,120-23 ATLANTIC AVENUE,05,K1,121 ATLANTIC AVENUE LLC,4,2,2
549,3018980011,BK,845 KENT AVENUE,04,S9,845 KENT AVENUE REALTY LLC,3,1,2
550,5010260053,SI,158 JEWETT AVENUE,01,B2,154 JEWETT AVENUE CORP,3,1,2
551,2054730048,BX,828 VINCENT AVENUE,01,B1,"FINAZZO, ANNA",3,1,2
552,4088920050,QN,86-22 98 STREET,02,C1,WOODHAVEN 98 RLTY CORP,4,2,2
553,4071280002,QN,61-00 FRANCIS LEWIS BLVD,08,W2,ST. FRANCIS PREPARATORY SCHOOL,3,1,2
554,3082010006,BK,9301 AVENUE J,01,B1,"SOMERSALL-OSHO, MARYANN",3,1,2
555,4035670016,QN,1714 SUMMERFIELD STREET,02,C1,RIDGEWOOD GROUP 1714 LLC,3,1,2
556,4017740131,QN,107-22 37 DRIVE,04,D7,GUAN FAMILY LLC,3,1,2
557,4014590001,QN,35-11 86 STREET,03,D4,AFP THIRTY FIVE CORP,5,3,2
558,5008970048,SI,2051 RICHMOND ROAD,04,S1,SCHWEIZER CONRAD J,3,1,2
559,4008720074,QN,25-44 CRESCENT STREET,04,D7,25 CRESCENT LLC,3,1,2
560,4019570001,QN,59-05 XENIA STREET,02,C2,OTIS AVE REALTY LLC,3,1,2
561,4006400024,QN,36-12 35 AVENUE,08,W3,NYC ECONOMIC DEVELOPMENT CORPORATION,4,2,2
562,5010430117,SI,84 LEXINGTON AVENUE,01,B2,"GRILLO, CASEY  RYAN",3,1,2
563,3070200001,BK,1714 NEPTUNE AVENUE,07,G3,1700 NEPTUNE AVE L P,3,1,2
564,4046450001,QN,148-02 14 AVENUE,05,K7,BRB WHITESTONE PROPERTIES LLC,3,1,2
565,4003620031,QN,37-26 13 STREET,10,G1,"GONZALEZ, BIENVENIDOR",3,1,2
566,3066820078,BK,1841 OCEAN PARKWAY,02,C0,BH 1841 OCEAN PARKWAY HOLDING LLC,4,2,2
567,4027470001,QN,62-05 60 LANE,05,K1,FORGIONE,3,1,2
568,3065700013,BK,1316 EAST 8 STREET,01,A3,"STEIN, MARTIN",3,1,2
569,4058437501,QN,206-17 EMILY ROAD,02,R3,BAYBRIDGE CONDO I,80,78,2
570,4022090010,QN, GRAND CENTRAL PKWY,09,Q1,NYC DEPARTMENT OF PARKS AND RECREATION,10,8,2
571,4047580010,QN,18-09 160 STREET,02,C6,17TH AVE. AND WILLETS POINT BLVD. L,74,72,2
572,3056950047,BK,5724 11 AVENUE,02,C0,HERSHEY REALTY LLC,3,1,2
573,3047480032,BK,117 EAST 88 STREET,01,B2,"CRUMP, ORPHIA",3,1,2
574,4010160310,QN,72-02 ASTORIA BOULEVARD S,09,Z8,ST MICHAELS CREMETORY,6,4,2
575,3052610006,BK,623 20 STREET,01,B2,"BIANCHI, FRANK",3,1,2
576,3076820060,BK,1430 EAST 29 STREET,01,A3,"KLEINMAN, JOSEPH",3,1,2
577,4041710039,QN,126-19 22 AVENUE,02,C3,M.S.Z. THIRD AVENUE FAMILY LIMITED PARTN ERSHIP,6,4,2
578,3038750044,BK,762 WILLIAMS AVENUE,02,C3,BLACKMAN BENICIA,3,1,2
579,3031010022,BK,43 BOGART STREET,05,K1,"BOGART EQUITIES AND PROPERTIES, LLC",4,2,2
580,3029780001,BK,568 MESEROLE STREET,11,V1,MESEROLE STREET ASSOCIATES LLC,4,2,2
581,3014700037,BK,1770 STERLING PLACE,02,C0,NYC HOUSING AUTHORITY,3,1,2
582,3014140028,BK,1654 CARROLL STREET,02,C3,NOEL SWIFT,3,1,2
583,3026640009,BK,38 VARICK STREET,05,O2,EXXONMOBIL OIL CORPORATION,3,1,2
584,3011407505,BK,814 DEAN STREET,02,R6,UNAVAILABLE OWNER,3,1,2
585,3078460053,BK,1550 EAST 49 STREET,01,A1,"DORCEMUS, KESTIANE",3,1,2
586,3007360001,BK,4401 2 AVENUE,06,F2,4401 AEGVV LLC,3,1,2
587,3036000036,BK,436 BRISTOL STREET,01,B1,RAYMOND ALCIDE,3,1,2
588,4103360012,QN,107 AVENUE,07,U9,NYC DEPARTMENT OF ENVIRONMENTAL PROTECTION,3,1,2
589,5033950044,SI,283 QUINTARD STREET,01,B2,XIANG LAN LIN,3,1,2
590,3027850005,BK,506 GRAND STREET,02,C4,6864 LLC,6,4,2
591,2055430030,BX,3618 EAST TREMONT AVENUE,05,O7,"SIEMENS REALTY SERVICES, LTD.",3,1,2
592,3029420049,BK,1100 GRAND STREET,06,F8,GRAND STREET PROPERTIES,5,3,2
593,2042590014,BX,1936 HUNT AVENUE,02,C0,"VERGARA, JOAQUIN",3,1,2
594,1021740061,MN,116A DYCKMAN STREET,05,K2,114-118 DYCKMAN REALTY LLC,3,1,2
595,3017050050,BK,34 TROY AVENUE,01,B3,"CRICK, MERLENE",3,1,2
596,3014280061,BK,729 EAST NEW YORK AVENUE,02,C3,WILHELM LEVI,4,2,2
597,3071050069,BK,2082 EAST 3 STREET,01,A7,"CHERA, ISAAC",4,2,2
598,3003290018,BK,90 DEGRAW STREET,10,G7,RED ROCK PRODUCTIONS LLC,4,2,2
599,5028250016,SI, BAY STREET,07,U4,NEW YORK TELEPHONE CO,3,1,2
600,2024990108,BX,20 EAST 161 STREET,10,G1,NYC DEPARTMENT OF PARKS AND RECREATION,3,1,2
601,5053060045,SI,188 WIMAN AVENUE,01,B2,STREZ PETER K,3,1,2
602,1022440001,MN,501 WEST 218 STREET,09,Q6,COLUMBIA UNIV TR CITY NY,9,7,2
603,1015440001,MN,301 EAST 81 STREET,04,D6,1562/1564 SECOND REALTY LLC,3,1,2
604,5053070089,SI,89B GLOVER STREET,01,A5,"AKSENOV, YURY",3,1,2
605,5031760026,SI,91 NORTH RAILROAD AVE,01,A1,FABIO SPAGNUOLO,3,1,2
606,1007380054,MN,324 WEST 15TH STREET,08,W8,CORLEARS SCHOOL,4,2,2
607,3059400036,BK,370 BAY RIDGE PARKWAY,05,O7,370 BAY RIDGE PARKWAY LLC,3,1,2
608,1004060034,MN,206 AVENUE B,04,C7,206-208 LLC,8,6,2
609,1003480048,MN,78 CLINTON STREET,04,C7,"ASIAN AMERICAN HDFC, INC.",3,1,2
610,2055030050,BX,1 MAPLE AVENUE,01,A8,SILVER BEACH GARDENS CORPORATION,58,56,2
611,5074060015,SI,13 MANLEY STREET,01,B2,GEORGE J BRENNER,4,2,2
612,4095920061,QN,105-45 132 STREET,10,G0,"MUTHUSAMMY, HARRINARINE",3,1,2
613,3039980006,BK,315 JEROME STREET,02,C0,CYPRESS HOMES HOUSING DEVELOPMENT FUND C ORPORATION,3,1,2
614,5076640310,SI,40 BEDELL STREET,01,B2,"FURMAN, ALEKSANDER",3,1,2
615,5029880021,SI,57 REYNOLDS STREET,01,B2,REINHARD SPEER,3,1,2
616,3025990024,BK,173 MCGUINESS BLVD,01,B9,ARTLIFE 173-175 MCGUINNESS LLC,3,1,2
617,4017380032,QN,97-13 37 AVENUE,04,S9,S & E 37 ENTERPRISES LLC,3,1,2
618,5003660043,SI,28 CONSTANT AVENUE,01,A1,NICOLE WEINSTEIN,3,1,2
619,5080140004,SI,13 MAIDEN LANE,01,A5,"SILLS , MEAGAN  A",3,1,2
620,5001750007,SI,698 HENDERSON AVENUE,01,B3,"ILLARDO, CIRO",3,1,2
621,3044520150,BK, VAN SICLEN AVENUE,07,U9,NYC DEPARTMENT OF ENVIRONMENTAL PROTECTION,10,8,2
622,5018350150,SI,500 BLOOMFIELD ROAD,11,V1,"SUTHERLAND MARINE DEVELOPMENT, LLC",10,8,2
623,4110830016,QN,98-11 212 STREET,05,GW,"RESS 212 ENTERPRISES,",3,1,2
624,3014870074,BK,813 HANCOCK STREET,08,W9,BEFORD STUYVESANT EARLY CHILDHOOD,3,1,2
625,4006910042,QN,43-18 BROADWAY,04,S9,"43-20 BROADWAY, LLC",3,1,2
626,4142130002,QN,93-02 165 AVENUE,09,Q1,NATIONAL PARK SERVICE,3,1,2
627,4110930013,QN,217-28 HEMPSTEAD AVENUE,01,A1,"ROBLES, CARLOS V",3,1,2
628,4102120039,QN,92-54 172 STREET,02,C0,"BEGUM, SHEULI",3,1,2
629,4101420050,QN,108-28 154 STREET,01,A0,"TAJESHWAR, RAVINDRA",3,1,2
630,4044060030,QN, DOWNING STREET,07,U2,ERMUN REALTY CORP,6,4,2
631,4027730058,QN,62-28 MOUNT OLIVET CRESCENT,05,K1,"BRAUT, TRUSTEE, JOHN G",3,1,2
632,5057020025,SI,490 DRUMGOOLE ROAD EAST,01,A1,"BAUER, CHRISTOPHER",3,1,2
633,1018970001,MN,345A RIVERSIDE DRIVE,09,Q1,NYC DEPARTMENT OF PARKS AND RECREATION,7,5,2
634,4027530220,QN,58-29 64 STREET,06,F4,DONZ KALUK REALTY CORP,8,6,2
635,4025230019,QN,43-24 54 ROAD,06,E9,43-24 MASPETH CORP,3,1,2
636,3012640040,BK,781 EASTERN PARKWAY,04,C7,"781 EP HOLDINGS, LLC",3,1,2
637,4088680046,QN,86-33 89 STREET,02,C0,88-18 TROPICAL RESTAURANTE CORP.,4,2,2
638,3075860071,BK,964 EAST 23 STREET,01,B2,"956-964, LLC",4,2,2
639,3069030045,BK,2354 STILLWELL AVENUE,02,C0,"ALI, NARASAB",4,2,2
640,3048420009,BK,508 CLARKSON AVENUE,04,K4,"508-510 CLARKSON OWNERS, L.L.C.",4,2,2
641,3031630100,BK,60 CENTRAL AVENUE,,Z9,DOWNTOWN REAL PROPERTIES LLC,3,1,2
642,3083437501,BK,1107 EAST 73 STREET,02,R3,NAME NOT ON FILE,20,18,2
643,3012630041,BK,699 EASTERN PARKWAY,08,W9,EDUCATIONAL INSTITUTE OHOLEI TORAH OF BR OOKLYN INC,5,3,2
644,3011750069,BK,609 ST JOHNS PLACE,02,C1,ST. JOHNS PROPERTIES LLC,3,1,2
645,2059447501,BX,4961 HENRY HUDSON PKWY W,02,R2,NAME NOT ON FILE,12,10,2
646,5080200173,SI,113 BARNARD AVENUE,01,B3,"SALVATO, PATRICK",3,1,2
647,2056240006,BX,1 ROCHELLE STREET,01,B2,DECESARE DOMINICK,6,4,2
648,2044720052,BX,2425 MORGAN AVENUE,01,A5,"BURRELL, MARIO",3,1,2
649,2042050001,BX,1400 PELHAM PARKWAY SOUTH,08,I1,NYC HEALTH AND HOSPITALS CORPORATION,14,12,2
650,4065790091,QN,137-19 72 ROAD,01,A7,"HORN GLASER, SHANDI",3,1,2
651,1013190122,MN,843 2 AVENUE,04,S9,"EAST 45TH DEVELOPMENT,",3,1,2
652,3078750027,BK,2101 UTICA AVENUE,07,G2,KINGS UTICA AVENUE LLC,3,1,2
653,4035940020,QN,64-61 74 AVENUE,10,G1,JURAN  ROY,3,1,2
654,3017740051,BK,685 DEKALB AVENUE,08,M1,LAFAYETTE UNIT OF JEHOVAH'S WITNESS,4,2,2
655,1005480004,MN,5 UNIVERSITY PLACE,08,H8,NEW YORK UNIVERSITY,3,1,2
656,5028920034,SI,321 HANOVER AVENUE,01,A1,"MILLER, PHYLLIS E",3,1,2
657,4019640038,QN,105-04 WESTSIDE AVENUE,01,B1,LI GUANG HONG,3,1,2
658,1013780010,MN,13 EAST 63 STREET,08,M1,CONGREGATION BEIT YAAKOV,3,1,2
659,2024000001,BX,357 EAST 153 STREET,02,C0,"PANORA, SEGUNDO  L",3,1,2
660,2032610160,BX,3337 FT INDEPENDENCE ST,01,B2,"BHULLAR, DILVINDER",3,1,2
661,2030640001,BX,4422 3 AVENUE,08,I1,ST BARNABAS NURSING H,7,5,2
662,1010360036,MN,727 8 AVENUE,04,D6,"CLINTON HOUSING WEST46TH PARTNERS, L.P.",7,5,2
663,1021230067,MN,2142 AMSTERDAM AVENUE,03,D3,2146 BETTER HOMES HOUSING DEVELOPMENT FU ND CORPORA,3,1,2
664,3053220069,BK,350 CONEY ISLAND AVENUE,08,W1,350 RAIR LLC,5,3,2
665,3047050022,BK,5733 KINGS HIGHWAY,03,D1,CHUMBERLY REALTY LLC,4,2,2
666,1019870017,MN,535 WEST 133 STREET,03,D2,NYC HOUSING AUTHORITY,4,2,2
667,4160260052,QN,65-08 ALMEDA AVENUE,01,A2,"WILMINGTON SAVINGS FUND SOCIETY, FSB, AS  TRUSTEE",3,1,2
668,4093990001,QN,113-02 ATLANTIC AVENUE,11,V1,SURJIT & SWARN LLC,3,1,2
669,4011830014,QN,33-16 61 STREET,02,C0,"SALAZAR, EDWIN E",3,1,2
670,4011550036,QN,53-03 BROADWAY,05,K2,"PAFOS REALTY, LLC",3,1,2
671,4008260028,QN,36-16 19 AVENUE,05,O5,3616 19TH AVENUE LLC,3,1,2
672,3040830031,BK,811 NEW LOTS AVENUE,04,S1,SPENCER-EPHRANNIE C,4,2,2
673,5069750131,SI,6097 AMBOY ROAD,08,M4,ST JOSEPHS CHURCH,4,2,2
674,4089140032,QN,78-19 87 AVENUE,01,B3,"GONZALEZ, CARMEN L",3,1,2
675,2032220062,BX,1930 SEDGWICK AVENUE,08,W5,BRONX COMMUNITY COLLEGE,31,29,2
676,4001900032,QN,43-20 40 STREET,02,C1,CHARISMA PROPERTIES LLC,4,2,2
677,1018010005,MN,2435 1 AVENUE,09,Q3,NYC HOUSING AUTHORITY,9,7,2
678,2035130022,BX,432 ZEREGA AVENUE,04,S9,"TWO GIRLS & A BOY,    .",3,1,2
679,5023590001,SI,1001 RICHMOND HILL ROAD,09,Q5,NYC DEPARTMENT OF PARKS AND RECREATION,15,13,2
680,3045800002,BK, FLATLANDS AVENUE,09,Q9,NYC DEPARTMENT OF PARKS AND RECREATION,3,1,2
681,3070220082,BK,2815 WEST 16 STREET,02,C0,"MUCCIARONE, JOHN",4,2,2
682,3055170039,BK,1690 60 STREET,08,W2,YESHIVAS NOVOMINSK,3,1,2
683,3044400001,BK,12266 FLATLANDS AVENUE,07,U9,NYC DEPARTMENT OF ENVIRONMENTAL PROTECTION,22,20,2
684,3041050047,BK,18 CRESCENT STREET,07,G9,URBAN REAL ESTATE HOLDINGS LTD,3,1,2
685,2033220047,BX,3157 VILLA AVENUE,04,C7,3165-3169 VILLA AVENUE LLC,5,3,2
686,3029230025,BK,897 GRAND STREET,04,D7,901-905-GRAND STREET CORP.,3,1,2
687,2059000001,BX,3545 JEROME AVENUE,09,Q1,NYC DEPARTMENT OF PARKS AND RECREATION,22,20,2
688,1007090003,MN,462 11 AVENUE,10,G1,BIFROST LAND LLC,4,2,2
689,5072060314,SI,223 INDUSTRIAL LOOP,10,G1,KINGS LOOP REALTY LLC,4,2,2
690,5071050674,SI,143 CLAY PIT ROAD,01,A1,"ALFANO, ANDREW",3,1,2
691,3031090036,BK,222 MOORE STREET,06,F5,VARET MOORE REALTY INC.,4,2,2
692,4101310037,QN,107-28 154 STREET,01,B3,"GRODON, FRANK C",3,1,2
693,3027240034,BK,419 MEEKER AVENUE,06,F9,GITMOR LLC,3,1,2
694,3019120036,BK,160 FRANKLIN AVENUE,04,S1,CONGREGATION BEIS MORDCHE OF CLASSO,3,1,2
695,2026190016,BX,586 EAST 161 STREET,08,P5,UNION RINCOENA INC,3,1,2
696,3018120001,BK,1119 BEDFORD AVENUE,08,P3,YMCA OF GREATER N Y,5,3,2
697,3018850026,BK,2 SKILLMAN STREET,05,O5,MALCHUS B''CHESED,4,2,2
698,4044080037,QN,31-16 LINDEN PLACE,05,H9,3118 LINDEN INC,3,1,2
699,3027410019,BK,44 WITHERS STREET,02,C0,44 WITHERS LLC,3,1,2
700,3025560041,BK,10 KENT STREET,09,Q1,NYC DEPARTMENT OF PARKS AND RECREATION,3,1,2
701,1022150116,MN,5210 BROADWAY,03,D9,NYC HOUSING AUTHORITY,8,6,2
702,5038160004,SI,623 LINCOLN AVENUE,01,A5,ANDREW BEKIRMAN,3,1,2
703,4043160024,QN,28-18 120 STREET,05,O2,"MASPETH 58 REALTY, LLC",3,1,2
704,2052280041,BX,3300 PALMER AVENUE,03,D9,PALMER AVE ESTATES LLC,3,1,2
705,2049430001,BX,3981 BOSTON ROAD,07,G2,"MOUNT SINAI PROPERTIES, INC.,",3,1,2
706,4010860058,QN,23-37 92 STREET,01,B1,"KARASAVIDIS, KOUZINIA",3,1,2
707,3041950040,BK,1033 GLENMORE AVENUE,08,M1,BAITUL MAMUR MASJID,3,1,2
708,3029140016,BK,1075 METROPOLITAN AVENUE,06,E1,KG REALTY INC,4,2,2
709,3039790025,BK,254 SCHENCK AVENUE,01,B2,"JAMES COHEN, BENJAMIN",3,1,2
710,1002050019,MN,119 MOTT STREET,04,C7,119 VM LLC,3,1,2
711,3020960066,BK,695 FULTON STREET,05,K1,FULTON THREE LLC,4,2,2
712,3020230050,BK,63 FLUSHING AVENUE,04,K4,NYC DEPARTMENT OF SMALL BUSINESS SERVICES,7,5,2
713,5070200004,SI,565 BLOOMINGDALE ROAD,01,B9,ROSSIVILLE A M E ZION,4,2,2
714,4095200025,QN,115-17 LIBERTY AVENUE,04,K4,P&K REAL PROPERTIES LLC,4,2,2
715,5037990017,SI,255 FREEBORN STREET,01,A6,JUDITH D BELLACH,4,2,2
716,3043310059,BK,727 SCHENCK AVENUE,01,B9,"LEACOCK, SAUNDERS",3,1,2
717,1005900028,MN,172 WEST 4 STREET,04,C7,DZ FAMILY ASSOCIATES LP,3,1,2
718,5008010171,SI,467 GANSEVOORT BOULEVARD,01,A2,RUYLE CYNTHIA,3,1,2
719,5007590079,SI,171 MOUNTAINVIEW AVENUE,01,A1,"KOPOLOVITS, ARIE",3,1,2
720,5054420020,SI,39 WOODLAND AVENUE,01,B2,KLEMNTYNA FALKENTHAL,3,1,2
721,5002150093,SI,749 POST AVENUE,01,B2,"CLOVE-POST PROPERTIES, LLC",3,1,2
722,3024530001,BK,352 KENT AVENUE,07,T9,NYS DEPARTMENT OF TRANSPORTATION,5,3,2
723,4126370050,QN,117-08 SPRINGFIELD BLVD,07,G5,HESS RETAIL STORES LLC,3,1,2
724,2056260073,BX,91 PILOT STREET,01,B2,"CORONA, JOHN",4,2,2
725,2049530126,BX,4137 BOSTON ROAD,10,G1,"DIANDO & FRIENDS, INC.",3,1,2
726,5070930029,SI,43 HARRIS LANE,01,A5,"MUNOZ SANTIAGO, MARCO A",3,1,2
727,4092470001,QN,84-17 125 STREET,02,C9,DB DALE LLC,56,54,2
728,5002180005,SI,131 ELIZABETH STREET,01,B3,ROBERT W MCBRATNEY,3,1,2
729,5012770269,SI,106 MACORMAC PLACE,01,A9,MORTIMER J HERBERT,3,1,2
730,3009600001,BK,235 6 AVENUE,08,M1,ST FRANCIS XAVIER RC,3,1,2
731,4043710008,QN,29-10 137 STREET,03,D4,UNAVAILABLE OWNER,5,3,2
732,5012370068,SI,3062 RICHMOND TERRACE,04,K4,TWENTY-FOUR SEVEN DEV,4,2,2
733,1013737505,MN,555 MAIN STREET,04,RM,ISLAND HOUSE TENANTS CORP.,3,1,2
734,4120150080,QN,117-41 142 PLACE,01,A1,"HINDS, ROSEANN",3,1,2
735,3022100038,BK,640 BEDFORD AVENUE,08,M1,YESHIVATH KEHILATH YAIKOV INC,5,3,2
736,4015920072,QN,94-43 43 AVENUE,08,Y2,NYC POLICE DEPARTMENT,3,1,2
737,4156590011,QN,13-66 PINSON STREET,01,B2,ZAMIRA MUCAJ,3,1,2
738,4130430023,QN,185-02 140 AVENUE,01,B2,CATHY PERKINS,3,1,2
739,2027960037,BX,1775 WEEKS AVENUE,04,S5,1777 WEEKS AVENUE LLC,3,1,2
740,3030310005,BK,270 UNION AVENUE,01,A1,JAMES CLARK,3,1,2
741,3067090036,BK,1605 AVENUE J,08,W2,YESHIVAH OF FLATBUSH,7,5,2
742,4016000061,QN,45-10 94 STREET,08,W1,"45-10 94TH STREET,LLC.",3,1,2
743,1007780057,MN,232 WEST 29 STREET,05,H3,BRISAM MANAGEMENT (DE) LLC,3,1,2
744,3008050062,BK,251 53 STREET,06,E1,251 53RD STREET ASSOCIATES,3,1,2
745,4095830002,QN,129-04 LIBERTY AVENUE,05,K9,129-06 LIBERTY AVENUE LLC,4,2,2
746,4092480016,QN,84-16 127 STREET,01,B3,"ZHENG, JIE",3,1,2
747,4133090033,QN,145-58 GUY R BREWER BLVD,05,K1,KS JORDYN 18 LLC,3,1,2
748,3037520002,BK,330 BELMONT AVENUE,06,F1,"330 BELMONT REALTY,",13,11,2
749,4090930001,QN,89-02 101 AVENUE,04,K4,89-01 ROCKAWAY BLVD CORP,3,1,2
750,3065100072,BK,945 EAST 7 STREET,01,A1,ORATZ FAMILY RESIDENCE TRUST,4,2,2
751,4067910001,QN,61-11 160 STREET,03,D4,ELECTCHESTER 4 HOUSING CO INC,16,14,2
752,4053510001,QN,40-40 172 STREET,07,G2,THE KOUFAKIS CHILDREN'S TRUST,4,2,2
753,4050440063,QN,138-47 BARCLAY AVENUE,03,D1,BARCLAY #2 REALTY CO,5,3,2
754,1011230042,MN,16 WEST 71 STREET,02,C5,HEIT RLTY CORP,4,2,2
755,1004930041,MN,13 SPRING STREET,04,D7,LIRA APARTMENTS CO LP,3,1,2
756,2030150062,BX,1815 WEST FARMS ROAD,03,D3,1815 WEST FARMS HOUSING DEVELOPMENT FUND  CORPORATI,3,1,2
757,4034620044,QN,1817 PUTNAM AVENUE,06,F9,PUTNAM COURTYARD LLC,5,3,2
758,5032200006,SI,1232 HYLAN BOULEVARD,05,G8,"M & F REALTY ASSOCIATES, LLC",3,1,2
759,5033550032,SI,475 SEAVIEW AVENUE,08,I1,STATEN ISLAND UNVRST HOSPITAL,9,7,2
760,4013510075,QN,70-09 45 AVENUE,04,D6,70-05 REALTY INC.,3,1,2
761,4030700090,QN,79-41 METROPOLITAN AVENUE,05,K1,"JACMAR PROPERTIES, LLC",3,1,2
762,3085140038,BK,5302 FILLMORE AVENUE,02,C6,"FILLMORE GARDENS CO-OPERATIVE, INC.",18,16,2
763,4108350084,QN,98-10 211 STREET,08,M1,"MASJID AR-RAHMAN, INC.",3,1,2
764,4028710038,QN,86-25 58 AVENUE,02,C0,"LI, MEI",3,1,2
765,4003510014,QN,36-11 12 STREET,08,I7,HOUR APARTMENT HOUSE III HOUSING,3,1,2
766,5028100102,SI,364 MEREDITH AVENUE,06,F9,"364 MEREDITH AVENUE, LLC",4,2,2
767,3077650023,BK,1157 EAST 39 STREET,02,C2,"ESCARMENT, BELIZE",4,2,2
768,5015970204,SI,321F HILLMAN AVENUE,01,A5,"LOBO, SHARON ANN",3,1,2
769,4074220015,QN,53-20 214 STREET,01,A1,RALPH M MATTONE,3,1,2
770,4053600011,QN,40-44 196 STREET,01,A1,BROTHER REALTY DEVELOPMENT LLC,4,2,2
771,5024507513,SI,43 BELMAR DRIVE WEST,02,R3,OAKS AT LATOURETTE CONDOMINIUM,90,88,2
772,3064850003,BK,1511 INDEPENDENCE AVENUE,02,C6,INDEPENDENCE GRDN OWNERS CORP,78,76,2
773,3056657501,BK,818 53 STREET,04,RM,UNAVAILABLE OWNER,3,1,2
774,4127270072,QN,190-12 WILLIAMSON AVENUE,01,A1,"MORRISON, GLENWYN W",3,1,2
775,1001790043,MN,29-31 LEONARD STREET,04,K4,"31 LEONARD STREET, LLC",3,1,2
776,3046020001,BK,86 EAST 49 STREET,08,I1,KINGSBROOK MED CENT,5,3,2
777,5009340510,SI, TODT HILL ROAD,09,Z8,UNITED BRETHRENS CHURCH,10,8,2
778,3031370049,BK,826 FLUSHING AVE,04,K4,818 FLUSHING MANAGEMENT LLC,3,1,2
779,5008670082,SI,106 CIRCLE ROAD,01,A3,UNAVAILABLE OWNER,4,2,2
780,5008110039,SI,100 WELLBROOK AVENUE,01,A5,JAMES N PARKS,3,1,2
781,4044400021,QN,6 BOULEVARD,01,A1,6 BOULEVARD LLC,4,2,2
782,3045550001,BK,803 WORTMAN AVENUE,07,Y6,NYC DEPARTMENT OF SANITATION,3,1,2
783,4004880114,QN,43-82 VERNON BOULEVARD,07,U2,"CONSOLIDATED EDISON CO.OF N.Y.,INC.",10,8,2
784,4024340001,QN,48-19 69 STREET,08,M1,SWAMINARAYAN SHUBH SANSKAR SANSTHA INC.,3,1,2
785,1003800050,MN,149 EAST 10 STREET,09,Q2,NYC DEPARTMENT OF PARKS AND RECREATION,3,1,2
786,5011980001,SI,1941 FOREST AVENUE,05,K1,"IVRI, LLC",3,1,2
787,3027780013,BK,300 AINSLIE STREET,02,C0,KATHERINE L. COLISTA TRUST A/K/A KATHERI NE L. BARN,3,1,2
788,2055150001,BX,178D EDGEWATER PARK,01,A8,EDGEWATER PARK OWNRSETC,47,45,2
789,2046470087,BX,3619 WHITE PLAINS ROAD,04,K4,"CENTLEX, LLC",3,1,2
790,3057490015,BK,195 65 STREET,07,U6,BROOKLYN UNION GAS CO,4,2,2
791,1019920013,MN,80 CLAREMONT AVENUE,08,W7,UNION THEOLOGICAL SEM,3,1,2
792,4021840011,QN,110-12 64 AVENUE,02,C6,MEADOW APARTMENT CORP,19,17,2
793,1014800010,MN,590 EAST 68 STREET,08,I1,ROCKEFELLER UNIVERSITY,25,23,2
794,1002670019,MN,333 MADISON STREET,08,M3,ST AUGUSTINE PARISHETAL,5,3,2
795,5027800047,SI,37 MEREDITH AVENUE,01,A1,THOMAS MAHONEY,3,1,2
796,3085590016,BK,2529 HENDRICKSON STREET,04,K4,2520 FLATBUSH AVENUE LLC,3,1,2
797,5016100016,SI,1414 RICHMOND AVENUE,04,S2,EDITH BROECKER,6,4,2
798,3071290033,BK,2222 EAST 3 STREET,01,A3,JOSEPH BEYDA,3,1,2
799,3051050004,BK,837 ROGERS AVENUE,08,M1,MAKDO CORP,3,1,2
800,3035680001,BK,774 SARATOGA AVENUE,08,W9,GAIA REALTY LLC,3,1,2
801,4122690045,QN,161-37 128 AVENUE,05,K1,MADISON QUEENS-GUY BREWER,3,1,2
802,3018760001,BK,39 HALL STREET,05,O6,RXR 9-47 HALL STREET OWNER LLC,13,11,2
803,5011070055,SI,2589 RICHMOND TERRACE,06,F2,DRURY ENTERPRISES INC,44,42,2
804,5006160062,SI,802 VAN DUZER STREET,01,A1,"VAN DUZER ESTATES, INC.",3,1,2
805,4085130002,QN,255-03 UNION TURNPIKE,05,K6,255 MALL LLC,6,4,2
806,2043600001,BX,974 WARING AVENUE,08,W3,NY INSTIT FOR ED OF B,3,1,2
807,3067400050,BK,1111 AVENUE N,11,V0,"ASHKENAZI,",3,1,2
808,5012720051,SI,13 HOLLAND AVENUE,01,B2,"FERREIRAS, ANGEL",4,2,2
809,4024530025,QN,79-20 QUEENS BOULEVARD,10,G1,7920 REALTY LLC,3,1,2
810,3019960031,BK,1194 BEDFORD AVENUE,08,M9,THE FOUNTAIN GROUP LLC,3,1,2
811,4027550008,QN,62-27 59 DRIVE,01,B2,62-27 59TH DRIVE LLC,3,1,2
812,2026100038,BX,1285 FULTON AVENUE,08,I7,BRONX-LEBANON SPECIAL,3,1,2
813,4030700078,QN,79-65 METROPOLITAN AVENUE,05,K7,COMMERCE BANK NA (KANSAS CITY),3,1,2
814,4062840012,QN,42-25 213 STREET,02,C2,42-25 213 STREET REALTY LLC,4,2,2
815,3017080001,BK,53 UTICA AVENUE,02,C1,FULTON PK ASSOC,22,20,2
816,4116650034,QN,121-01 116 AVENUE,08,N9,NYS OFFICE OF GENERAL SERVICES,3,1,2
817,3018930047,BK,100 STEUBEN STREET,03,D3,CLINTON HILL DEVELOPMENT II LLC,3,1,2
818,3058200054,BK,665 65 STREET,05,G8,665 65TH ST. REALTY CORP.,3,1,2
819,4017140018,QN,99-01 34 AVENUE,08,W1,NYC DEPARTMENT OF EDUCATION,3,1,2
820,4110250011,QN,114-31 FRANCIS LEWIS BLVD,02,C9,BASSFORD REALTY LLC,15,13,2
821,3009140027,BK,650 39 STREET,01,B3,"WU, LIGEN",3,1,2
822,5005410027,SI,229 BROAD STREET,04,K4,HERE AND THERE REALTY INC.,4,2,2
823,2050670055,BX,4431 MATILDA AVENUE,04,S1,"AHMED, MOHIUDDIN",3,1,2
824,4050410016,QN,133-38 41 AVENUE,07,G2,NAN ASSOCIATES LLC,3,1,2
825,4053610025,QN,40-14 FRANCIS LEWIS BLVD,01,B2,40-14 FRANCIS LEWIS LLC,3,1,2
826,3051360034,BK,200 VERONICA PLACE,02,C0,BARRY IBRAHIMA,3,1,2
827,5001500283,SI,153 BEMENT AVENUE,01,A5,ABDUL A BAH,3,1,2
828,4051920055,QN,43-34 UNION STREET,03,D4,KISSENA COOPERATIVE SECTION I,3,1,2
829,1015130063,MN,118 EAST 85 STREET,08,W2,RAMAZ SCHOOL,3,1,2
830,4110660001,QN,194-15 LINDEN BOULEVARD,08,M1,CHURCH OF GOD OF PROPHECY,3,1,2
831,5003140070,SI,650 BROADWAY,09,Q1,NYC DEPARTMENT OF PARKS AND RECREATION,16,14,2
832,4105090052,QN,87-37 PALERMO STREET,08,I1,3861 REALTY LLC,5,3,2
833,4105140077,QN,196-25 POMPEII AVENUE,02,C0,"GHANESS, NARHARRY",3,1,2
834,4000130035,QN,52-25 BORDEN AVENUE,,Z9,LIRR,10,8,2
835,4101710001,QN,108-57 GUY R BREWER BLVD,05,K1,SAMANTHA LAUNDRY CORP,4,2,2
836,1019220003,MN,259 WEST 116 STREET,04,C7,"255-259 WEST 116TH OWNER, LLC",3,1,2
837,5079710250,SI,236 RICHMOND VALLEY ROAD,05,K1,"BEST EQUITIES, LLC",4,2,2
838,4021860118,QN,65-47 110 STREET,02,C0,"MACAPINLAC, MANUEL A JR",3,1,2
839,4108350028,QN,208-22 JAMAICA AVENUE,05,K1,"PEP BOYS-MANNY, MOE&JACK OF DELAWARE, IN C.",3,1,2
840,3069960089,BK,2776 WEST 15 STREET,07,G9,1515-N LLC,3,1,2
841,4053920037,QN,42-48 162 STREET,02,C0,A & J ESTATES LLC,3,1,2
842,3038030011,BK,443 ALABAMA AVENUE,02,C1,LIVONIA TERRACE HDFC,11,9,2
843,1006400066,MN,24 BETHUNE STREET,02,C0,"24 BETHUNE STREET, LLC",3,1,2
844,4035400001,QN,10-51 IRVING AVENUE,06,F9,MESSING IRVING REALTY LLC,4,2,2
845,3080070016,BK,751 EAST 86 STREET,08,M1,THE ROMAN CATHOLIC  CHURCH OF OUR LADY O F MIRACLES,7,5,2
846,4030580043,QN,66-36 74 STREET,02,C2,LA CASETTA CORP,3,1,2
847,5011070031,SI,2541 RICHMOND TERRACE,05,O5,STATEN ISALND HOLDINGS LLC,3,1,2
848,4026330001,QN,53-02 FLUSHING AVENUE,10,G1,LEAR REALTY LLC,4,2,2
849,4037500705,QN,82-07 CYPRESS HILLS STREET,09,Z8,SPRUNG FAMILY CEMETERY SOCIETY INC,4,2,2
850,4073480001,QN,215-28 47 AVENUE,02,C6,ROCKY HILL TENANTS CORP,10,8,2
851,4062770002,QN,42-11 CORPORAL KENNEDY ST,02,C9,SHR APARTMENTS INC,12,10,2
852,4076380012,QN,69-05 215 STREET,02,C6,HOLLISCO OWNERS CORP,27,25,2
853,4076680010,QN,222-01 69 AVENUE,02,C6,"LEE, BRIAN H.",83,81,2
854,5007410030,SI,46 ARDMORE AVENUE,01,A5,DINA LEFKOWITZ,3,1,2
855,4154620001,QN,103 EAST 9 ROAD,01,B3,"BIL, JOHN C",3,1,2
856,4051560001,QN,37-46 ELDER AVENUE,09,Q1,NYC DEPARTMENT OF PARKS AND RECREATION,3,1,2
857,5037000042,SI,17 MAPLEWOOD PLACE,04,S2,ABUPLUS LLC,4,2,2
858,3020460077,BK,118 VANDERBILT AVENUE,03,D1,"KIMIABAKHSH, HENGAME",3,1,2
859,3004400027,BK,544 UNION STREET,04,S4,544-546 UNION STREET CORP.,3,1,2
860,4154530022,QN,733 CHURCH ROAD,01,A1,"MURPHY, EDWARD",3,1,2
861,4013500052,QN,69-71 44 AVENUE,02,C0,"SHI KEE, BING",3,1,2
862,4045820005,QN,160-31 13 AVENUE,01,A1,"CEGLIA LIVING TRUST, DATED JUNE 15, 2018",3,1,2
863,3080090039,BK,8818 GLENWOOD ROAD,01,A2,"BRYAN, MARKLAND",3,1,2
864,5000540031,SI,53 HIGHVIEW AVENUE,01,A1,"GARCIA, ENRIQUE JR.",3,1,2
865,4093880001,QN,106-02 ATLANTIC AVENUE,07,G2,WEJ ATLANTIC AVE LLC,3,1,2
866,4105240001,QN,196-01 POMPEII AVENUE,02,C6,HOLLISWOOD OWNERS CORP,79,77,2
867,3054240080,BK,229 PARKVILLE AVENUE,03,D8,PARKVILLE REALTY ASSOCIATES,3,1,2
868,4019440085,QN,53-11 104 STREET,02,C0,5311 104 STREET LLC,3,1,2
869,3019200002,BK,249 RYERSON STREET,03,D3,PRATT INSTITUTE,3,1,2
870,4005720044,QN,30-14 CRESCENT STREET,01,A9,CHURCH OF THE REDEEMER,3,1,2
871,3008440001,BK,111 58 STREET,06,E9,111 GROUP REALTY LLC,5,3,2
872,4018970029,QN,53-04 97 PLACE,06,E9,"JP98 STREET, LLC",3,1,2
873,4015220017,QN,42-22 77 STREET,02,C0,"CHAN, HING SHUNG",3,1,2
874,4005680007,QN,23-35 31 DRIVE,04,D6,2335 LLC,4,2,2
875,3033460001,BK,1581 MYRTLE AVENUE,07,U9,NYC TRANSIT AUTHORITY,3,1,2
876,3062120022,BK,1430 74 STREET,01,B2,FRED STRANO,3,1,2
877,3007970050,BK,253 52 STREET,06,E1,"PANTELIS, MICHAEL",3,1,2
878,3004720019,BK,4 DENNETT PLACE,02,C2,4 & 6 DENNETT PLACE LLC,3,1,2
879,4008920049,QN,19-27 21 DRIVE,02,C9,"21 STREET PROPERTIES, INC.",14,12,2
880,5038370039,SI,732 LIBERTY AVENUE,11,V0,HOUSING TRUST FUND CORPORATION,3,1,2
881,3041130029,BK,58 LOGAN STREET,01,B2,AVILES BEATRICE,3,1,2
882,2051300103,BX,4875 BALDWIN STREET,06,F1,BWT PROPERTIES LLC,3,1,2
883,3013990060,BK,1953 UNION STREET,01,B3,CLAYTON BOBBY L,3,1,2
884,1021010055,MN,675 RIVERSIDE DRIVE,09,Q9,NYC DEPARTMENT OF PARKS AND RECREATION,3,1,2
885,3003850001,BK,163 SMITH STREET,04,K4,165 SMITH REALTY LLC,3,1,2
886,2055680050,BX,2705 SCHLEY AVENUE,03,D3,NYC HOUSING AUTHORITY,3,1,2
887,4005820010,QN,33-24 29 STREET,01,B2,FATIMA SCOTTON,3,1,2
888,4051950069,QN,143-07 45 AVENUE,08,M1,"BOON CHURCH OF OVERSEAS CHINESE MISSION,  INC",3,1,2
889,3013430001,BK,87 UTICA AVENUE,04,S2,87 UTICA REALTY LLC,3,1,2
890,3027450014,BK,190 WITHERS STREET,02,C0,JOSEPH MORELLI,3,1,2
891,3076650004,BK,2915 AVENUE N,04,S1,2915-2921 AVENUE N PROPERTIES LLC,3,1,2
892,3017150021,BK,747 BEDFORD AVENUE,05,O1,"STEINWAY ESTATES, LLC",3,1,2
893,3009780030,BK,186 3 STREET,,Z9,"186 THIRD STREET BROOKLYN NY, LLC",5,3,2
894,2053900027,BX,2933 CODDINGTON AVENUE,01,A1,JON T ANNUNZIATA,3,1,2
895,5033950058,SI,78 APPLEBY AVENUE,01,A2,F & R HOSMER,3,1,2
896,2041060045,BX,1614 HAIGHT AVENUE,02,C2,CHRISTINE AHERN,6,4,2
897,5078640070,SI,561 ROCKAWAY STREET,01,B2,"LUKASZEWSKI, KENNETH",3,1,2
898,4003500017,QN,36-05 13 STREET,01,B9,"BRAVO, DAVID",3,1,2
899,3017120028,BK,20 KANE PLACE,08,M9,"SEATON, SAMUEL",4,2,2
900,5001580102,SI,130 ELM STREET,01,B2,KLEIN ERIK L,2,1,1
901,5001670016,SI,444 DELAFIELD AVENUE,01,A1,"CHAYA, STEPHEN",2,1,1
902,5001730038,SI,703 HENDERSON AVENUE,01,A1,"ROSALIA S. JACKSON, TRUSTEE",2,1,1
903,5001980029,SI,15 PARIS COURT,01,A5,"LINCOLN, DEXTER E JR.",2,1,1
904,5001990049,SI,70 TAYLOR STREET,01,B3,ONEIDA VIOAL,2,1,1
905,5002200035,SI,174 MYRTLE AVENUE,01,A1,KENNY ROBERT,2,1,1
906,5002250020,SI,280 MYRTLE AVENUE,01,A1,RICHARD C FLAHERTY,2,1,1
907,5002500016,SI,18 UNIVERSITY PLACE,01,A1,"SANGER, JOSEPH",2,1,1
908,5002950040,SI,717 OAKLAND AVENUE,01,A1,"MAHONEY, ANN MARIA",2,1,1
909,5003020044,SI,646 BEMENT AVENUE,01,A1,"O'LEARY, BRIAN",2,1,1
910,5003510019,SI,161 GREENLEAF AVENUE,01,A1,"HEMMER, ELIZABETH ANN",2,1,1
911,5003660085,SI,217 SOUTH GREENLEAF AVE,01,A0,STEPHEN W BOYLE,2,1,1
912,5004060005,SI,119 DICKIE AVENUE,01,A1,LINDA M STILAND,2,1,1
913,5004620074,SI,8 BRADLEY AVENUE,01,B2,"YU, YANWEN",2,1,1
914,5005100001,SI,490 BAY STREET,04,K4,490-492 BAY ACQUISITIONS LLC.,4,3,1
915,5005180072,SI,25 SMITH TERRACE,01,B1,"DEROSA, JR., RALPH",2,1,1
916,5005440150,SI,128 TARGEE STREET,08,M3,CHUR IMMACULATE CONCE,2,1,1
917,5005690092,SI,110 VICTORY BOULEVARD,04,S2,112 VICTORY BOULEVARD LLC,2,1,1
918,5005700008,SI,47 HOMER STREET,02,C3,YEASER MOSTAFA,2,1,1
919,5006690062,SI,108 ONTARIO AVENUE,01,B2,"VELIU, IMBERSON",2,1,1
920,5006950052,SI,20 MOONLIGHT COURT,01,B2,UNAVAILABLE OWNER,2,1,1
921,5007100036,SI,624 MANOR ROAD,01,A1,BRIAN W BURTNER,2,1,1
922,5007180070,SI,33 QUINLAN AVENUE,01,A1,"CHERIYAN, DAVID",2,1,1
923,5007230009,SI,2000 VICTORY BOULEVARD,07,G4,"MEIERS CORNERS ASSOCIATES, L.L.C.",2,1,1
924,5007270055,SI, WHEELER AVENUE,11,V0,RIDERA LLC,2,1,1
925,5007420022,SI,34 MARTIN AVENUE,01,B9,LAMO KOSIC,2,1,1
926,5009050021,SI,738 TODT HILL ROAD,01,A3,BARBARA J. SIMPSON,4,3,1
927,5009460008,SI,39 GELDNER AVENUE,01,A1,"LO, KA LEE",2,1,1
928,5010420120,SI,69 CATHERINE STREET,10,G1,JOHN J GALL,2,1,1
929,5011240010,SI,137 EATON PLACE,01,B1,"TIGNINI, GALILEO",2,1,1
930,5011830198,SI,395 LAKE AVENUE,01,A5,GILL BALDWINDER,2,1,1
931,5014690003,SI,159 MULLER AVENUE,01,A1,GARY S PETERSON,2,1,1
932,5014690016,SI,264 WATERS AVENUE,01,A1,"CICERO, FRANK",2,1,1
933,5015150042,SI,518 WEST CASWELL AVENUE,01,B2,"ALI, AMINA",2,1,1
934,5016430001,SI,69 DOMAIN STREET,01,B9,"COSTANTINO, CHRISTOPHER",2,1,1
935,5016580109,SI,189 ADA DRIVE,01,B2,"BOLLOLI, ROBERT",2,1,1
936,5018010010,SI,451 SPENCER STREET,06,F5,ANASTASIOS GLIKIS,5,4,1
937,5018550009,SI,2828 GULF AVENUE,05,O1,2828 GULF ASSOCIATES LLC,2,1,1
938,5022420073,SI,3173 RICHMOND ROAD,04,S9,3173 RICHMOND ROAD R,3,2,1
939,5027800087,SI,17 CANNON AVENUE,08,P2,GOLD STAR POST #1365,3,2,1
940,5028400220,SI,277 TOMPKINS AVENUE,01,A5,"TRUZSKOWSKI, MIECZYL",2,1,1
941,5028620051,SI,48 SETH LOOP,01,A5,ANTIONETTA CIARDIELLO,2,1,1
942,5028870023,SI,227 ODER AVENUE,01,B3,"ALISHAHI, AMIR HOMAYOUN",3,2,1
943,5031040045,SI,156 LILY POND AVENUE,01,A5,XUEPING LIANG,2,1,1
944,5031160013,SI,125 MILLS AVENUE,01,B2,"ADESANYA, MUSIBAU",2,1,1
945,5031210063,SI,86 MC CLEAN AVENUE,04,S1,GASTALDI MICHAEL,2,1,1
946,5032500005,SI,498 MC CLEAN AVENUE,01,B1,ON YOUR MARK INC,2,1,1
947,5032540016,SI,250 KENSINGTON AVENUE,01,A2,KENSINGTON PROPERTY 0909 CORP.,2,1,1
948,5032570012,SI,201 BIONIA AVENUE,01,A5,UNAVAILABLE OWNER,2,1,1
949,5032770006,SI,131 FOCH AVENUE,01,B3,"CHONG, KILUN",2,1,1
950,5033940063,SI,58 SCOTT AVENUE,01,A5,MAHENDRAKUMAR PARMAR,2,1,1
951,5034110058,SI,153 QUINCY AVENUE,01,A1,"LI, HONGYUAN",2,1,1
952,5034120050,SI,86 MC LAUGHLIN STREET,01,B2,"TVERSKAYA , YEKATERINA",2,1,1
953,5036200071,SI,43 LOCUST AVENUE,01,A5,"MODENA, JOSEPH",3,2,1
954,5043130032,SI,68 DALTON AVENUE,01,A1,CHARLES PLATT,2,1,1
955,5051470065,SI,123 CLEVELAND AVENUE,01,A0,CHRIST LUTHERAN CHURCH,2,1,1
956,5052660107,SI,355 THORNYCROFT AVENUE,01,A1,RUFINA LODUCA,2,1,1
957,5052720054,SI,4005 HYLAN BOULEVARD,04,S1,R&S HYLAN REAL ESTATE INC.,2,1,1
958,5052850014,SI,234 BEACH ROAD,01,A2,JIMMY MARTINEZ,2,1,1
959,5054380083,SI,8 RHETT AVENUE,01,B9,"LEE, GINA M",2,1,1
960,5054940003,SI,407 RIDGEWOOD AVENUE,01,A1,"BERNSTEIN, ARYEH",2,1,1
961,5061470018,SI,849 ROSSVILLE AVENUE,01,B9,CONRAD A MUSTO,2,1,1
962,5061650071,SI,21 KNESEL STREET,01,A1,"ROKICKI, LORRAINE",2,1,1
963,5064250046,SI,75 LIPSETT AVENUE,01,B2,"DENORA, JOHN",2,1,1
964,5067230076,SI,62 SEGUINE AVENUE,05,K2,62 SEGUINE AVE REALTY,3,2,1
965,5067500067,SI,187 WOODVALE AVENUE,01,B2,"MORAN, CYNTHIA",2,1,1
966,5070850006,SI,202 LUCILLE AVENUE,01,A5,"FERRAIUOLO, TRADY ANN",2,1,1
967,5070910187,SI,1572 WOODROW ROAD,01,B9,JOSEPH AMODEO,2,1,1
968,5074870240,SI, VETERANS ROAD WEST,11,V1,VETERANS  REALTY  CORP,3,2,1
969,5077100520,SI,442 RICHARD AVENUE,01,A2,"SANTORO, ALICE V",2,1,1
970,5078640025,SI,286 LORETTO STREET,01,B2,"STROFFOLINO, ANITA",2,1,1
971,5078870014,SI,250 MANHATTAN STREET,01,A2,ANTHONY MARCELLO,2,1,1
972,5078960008,SI,7392 AMBOY ROAD,11,V0,OUR LDY HELP CHRISTIANS,2,1,1
973,5080080001,SI,7033 AMBOY ROAD,08,M1,BETHEL UNITED METHODIST CHURCH,2,1,1
974,1004080021,MN,65 LUDLOW STREET,04,C7,LUDLOW 65 REALTY LLC,2,1,1
975,1004400001,MN,198 1 AVENUE,04,C7,"200 FIRST AVENUE ASSOCIATES,",5,4,1
976,1005940113,MN,499 CANAL STREET,04,S3,499 LANAC LLC,2,1,1
977,1008260055,MN,18 WEST 25 STREET,05,H3,BMF HOTEL CORP,2,1,1
978,1008340033,MN,11 WEST 32 STREET,05,O6,77 NY @ 32ND ST. LLC,2,1,1
979,1010940029,MN,625 11 AVENUE,05,GW,YUDE BET MEM INC.,2,1,1
980,1012770002,MN,505 5 AVENUE,05,O4,FIFTH AT 42ND LLC C/O,2,1,1
981,1018910055,MN,929 WEST END AVENUE,03,D1,STRAUSS PARK REALTY LLC,2,1,1
982,1018960057,MN,609 WEST 115 STREET,08,H8,COLUMBIA UNIV IN NYCTR,3,2,1
983,1019390032,MN,2268 ADAM C POWELL BLVD,04,C7,2268 ACP PARTNERS LLC,2,1,1
984,1020710027,MN,503 WEST 139 STREET,08,Y1,FIRE DEPARTMENT OF NEW YORK,4,3,1
985,2023590003,BX,527 WESTCHESTER AVENUE,09,Q6,NYC DEPARTMENT OF EDUCATION,2,1,1
986,2026950028,BX,783 DAWSON STREET,02,C0,783 DAWSON LLC,2,1,1
987,2027110077,BX,895 TIFFANY STREET,01,A5,"FAUSTIN, ERMINE",2,1,1
988,2027940009,BX,1660 MORRIS AVENUE,03,D1,"BRONX CARE ASSOCIATES, L.P.",2,1,1
989,2028140054,BX,1974 ANTHONY AVENUE,02,C5,"DE VILLA, CARMEN",2,1,1
990,2029080040,BX,1815 WASHINGTON AVENUE,08,M1,GREATER NEW YORK CORP,2,1,1
991,2030790173,BX,1983 CROTONA AVENUE,01,B2,NGUYEN NGA,2,1,1
992,2032140149,BX,2529B GRAND AVENUE,02,C0,2166 DEAN LLC.,2,1,1
993,2033240068,BX,3467 KNOX PLACE,01,B1,WILLODENE KETCHAM-ROBINS,2,1,1
994,2035650001,BX,680 STICKBALL BOULEVARD,09,Q2,NYC DEPARTMENT OF EDUCATION,2,1,1
995,2036900048,BX,2241 LAFAYETTE AVENUE,01,A1,LASTRA  EILEEN,2,1,1
996,2038140041,BX,2162 WESTCHESTER AVENUE,04,C7,OMZA HOLDING LLC,2,1,1
997,2040420013,BX,852 VAN NEST AVENUE,01,A5,"LARINO, MANUEL",2,1,1
998,2041110045,BX,1610 WILLIAMSBRIDGE ROAD,04,O8,KEEDEA LLC,2,1,1
999,2042350032,BX,2930 WILKINSON AVENUE,02,C0,"DI GIOVANNI, ANIELLO",2,1,1
1000,2042420053,BX,2859 EAST 195 STREET,01,A1,"SU, LINGYUN",2,1,1
1001,2042470024,BX,2054 CONTINENTAL AVENUE,01,B1,CONNIE M FORMATO,2,1,1
1002,2042740060,BX,1942 WILLIAMSBRIDGE ROAD,05,O5,"1942 REALTY ASSOCIATES, LLC",3,2,1
1003,2044890022,BX,2434 TIEMANN AVENUE,01,A5,VINCENT CARTELLA,2,1,1
1004,2045430011,BX,3020 BRONX PARK EAST,01,A1,"CLARK, MARIA",2,1,1
1005,2045890042,BX,1306 EAST GUN HILL ROAD,05,K2,GUN HILL EQUITIES CORP.,2,1,1
1006,2046760054,BX,820 EAST 218 STREET,02,C0,PAULINE J. BLAKE,2,1,1
1007,2046870003,BX,951 EAST 216 STREET,01,A2,"RUIZ, FRANCISCO",2,1,1
1008,2047000047,BX,1028 EAST 218 STREET,01,A5,SHIRLEY A FEARON,2,1,1
1009,2047050050,BX,1132 EAST 211 STREET,01,A2,UNAVAILABLE OWNER,2,1,1
1010,2047300053,BX,3438 GUNTHER AVENUE,01,B2,"TORRES, JOSE L",3,2,1
1011,2047420036,BX,3218 FENTON AVENUE,01,A5,"SHAW, SEYMOUR",2,1,1
1012,2047640012,BX,3143 KINGSLAND AVENUE,01,A2,"UDOYE, NNENNA ANTHONIA",2,1,1
1013,2047750015,BX,3037 BRUNER AVENUE,01,A1,HARRYLALL SAMAROO,2,1,1
1014,2047950040,BX,2822 BRUNER AVENUE,01,A2,"YUK, EDWARD",2,1,1
1015,2048410007,BX,4029 BARNES AVENUE,02,C0,FLORIZEL HENDRICKS,2,1,1
1016,2048410074,BX,740 EAST 228 STREET,01,B1,MCKENZIE CUTBERT,2,1,1
1017,2048510034,BX,811 EAST 226 STREET,02,C0,"ARONOV, JAFIM",2,1,1
1018,2048530068,BX,834 EAST 229 STREET,01,B2,SYLVESTER BENNETT,2,1,1
1019,2048540075,BX,842 EAST 230 STREET,02,C2,"842 EAST 230 STREET, LLC",3,2,1
1020,2048880002,BX,3601 BOSTON ROAD,05,K1,S NACLERIO,4,3,1
1021,2049690019,BX,4005 DYRE AVENUE,06,F9,EVANGELOS GEORGIOU,2,1,1
1022,2049780041,BX,1832 EDENWALD AVENUE,02,C0,CELIA QUINONES,2,1,1
1023,2050130027,BX,4209 ELY AVENUE,01,B3,"ROBERTS, LESLINE",2,1,1
1024,2052260017,BX,3343 DE REIMER AVENUE,01,B1,"EGWU, INNOCENT",2,1,1
1025,2054060053,BX,3144 RAWLINS AVENUE,01,A1,DAWN DIGIACOMO,2,1,1
1026,2054080142,BX,3211 RAWLINS AVENUE,01,A1,"COLON, ANA M",3,2,1
1027,2054450042,BX,2922 SAMPSON AVENUE,01,A1,"LUKELITCH, ERIKA",2,1,1
1028,2054720017,BX,841 VINCENT AVENUE,01,B3,COIRO EMILIO,2,1,1
1029,2054770033,BX,3245 PHILIP AVENUE,02,C2,"809 CLARENCE AVENUE, LLC",3,2,1
1030,2055170061,BX,2B EDGEWATER PARK,01,A8,EDGEWATER PARK OWNRSETC,58,57,1
1031,2055420041,BX,2550 BRUCKNER BOULEVARD,05,K8,900 BUSH AVENUE LLC,2,1,1
1032,2056270078,BX,62 SCHOFIELD STREET,01,A1,MICHAEL TORRES,2,1,1
1033,2056280023,BX,54 CAROLL STREET,02,C0,"LAVALLE, CATHERINE T.",3,2,1
1034,2056450029,BX,439 MINNIEFORD AVENUE,01,A1,"LAURIA, LINDA",2,1,1
1035,2056470014,BX,528 MINNIEFORD AVENUE,02,C0,BURTON  MARY S,4,3,1
1036,2057910388,BX,511 WEST 235 STREET,04,D7,"ARSLAE REALTY CO.,",2,1,1
1037,2058861290,BX,6145 LIEBIG AVENUE,02,C3,"O'BRIEN, HUGH",2,1,1
1038,2059130894,BX,4631 ARLINGTON AVENUE,01,A3,"GREENBERG, JEREMY M",2,1,1
1039,2059370499,BX,5253 SYCAMORE AVENUE,01,A3,"TUVIA, GUY",2,1,1
1040,2059530038,BX,5700 ARLINGTON AVENUE,03,D4,"J.P.MORGAN CHASE, LLP",3,2,1
1041,3000410002,BK,67 JAY STREET,04,K4,JAYAT REALTY CORP.,4,3,1
1042,3003510020,BK,254 PRESIDENT STREET,01,A9,"LAZARUS, THEODORE",2,1,1
1043,3003560002,BK,435 CLINTON STREET,02,C0,J MIRABITO,2,1,1
1044,3003820026,BK,160 WEST 9 STREET,02,C0,"SUKHU, DEO",2,1,1
1045,3006340070,BK,189 19 STREET,01,B3,ALLEN STEVEN R,2,1,1
1046,3006370027,BK,210 19 STREET,02,C0,"GIGLIOTTI, VITTORIA",2,1,1
1047,3006450021,BK,146 22 STREET,04,S2,PIETANZA JOSEPH,2,1,1
1048,3007420013,BK,820 44 STREET,02,C0,"CHEN, WAI WAN",2,1,1
1049,3007510076,BK,817 46 STREET,01,B9,"PEREZ, ANIBAL",2,1,1
1050,3007590002,BK,4621 7 AVENUE,04,S3,BAYHOME JOY REALTY CORP.,2,1,1
1051,3009030190,BK,36 STREET,07,U0,UNAVAILABLE OWNER,13,12,1
1052,3009170069,BK,515A 41 STREET,01,B1,"CHOW, JIN PAN",3,2,1
1053,3010020034,BK,454 3 AVENUE,04,S4,454 THIRD AVENUE REALTY CORP,2,1,1
1054,3010870046,BK,117 PROSPECT PARK WEST,02,C6,117 P P W HOUSING CORP,2,1,1
1055,3011390012,BK,766 DEAN STREET,01,A1,"RANDORF, DEBRA ANN",2,1,1
1056,3012330011,BK,99 ROGERS AVENUE,02,C4,RAN BKLYN LLC,2,1,1
1057,3012990034,BK,468 CROWN STREET,01,B1,"LEVY, MENACHEM M",2,1,1
1058,3012990039,BK,484 CROWN STREET,01,B1,YEHUDIS FRIEDMAN-TRUSTEE,2,1,1
1059,3013120076,BK,609 EMPIRE BOULEVARD,01,A4,"WILHELM, BARUCH",2,1,1
1060,3013160072,BK,329 STERLING STREET,03,D3,JACQUELYN 327 LLC,2,1,1
1061,3013730032,BK,1460 PARK PLACE,01,B1,"ANDREWS, OLVIN A",2,1,1
1062,3013920032,BK,1520 LINCOLN PLACE,01,B1,"AUSTIN, LOUISE",2,1,1
1063,3014450002,BK,423 RALPH AVENUE,08,Y1,FIRE DEPARTMENT OF NEW YORK,2,1,1
1064,3014740036,BK,1810 ST JOHNS PLACE,02,C0,"PINCKNEY, KAREN",2,1,1
1065,3017120018,BK,882 HERKIMER STREET,01,A9,BROWN BEVERLY J,2,1,1
1066,3017530025,BK,746 MYRTLE AVENUE,04,S2,"CHEN, FEN HUA",2,1,1
1067,3018600040,BK,1250 FULTON STREET,05,K1,"J. K. FULTON PROPERTY, LLC",8,7,1
1068,3018970038,BK,840 KENT AVENUE,02,C0,BENSONHURST MGMT INC.,2,1,1
1069,3019110013,BK,161 TAAFFE PLACE,02,C0,"CIPORA, LANDAU",2,1,1
1070,3021380035,BK,157 SOUTH 9 STREET,08,M3,PRIMERA IGLESIA LIBRE METHODISTA HISPANA,2,1,1
1071,3023120037,BK,171 NORTH 8 STREET,01,B2,"PARK, VERONICA",2,1,1
1072,3024490021,BK,341 SOUTH 5 STREET,02,C6,341 SOUTH 5TH ST HDFC,3,2,1
1073,3024500103,BK,328 KEAP STREET,01,B2,"MARTINEZ, LIDA M",2,1,1
1074,3024960022,BK,156 DUPONT STREET,02,C1,DUPONT STREET ASSOCIATES,2,1,1
1075,3025040035,BK,130 EAGLE STREET,01,B9,"SIEBOR, GRACE C",2,1,1
1076,3025040038,BK,1065 MANHATTAN AVENUE,02,C1,1065 EASGLE,2,1,1
1077,3026840014,BK,53 DIAMOND STREET,02,C1,CIELEPAK FRANCES,2,1,1
1078,3027190031,BK,143 BAYARD STREET,01,B9,"MARTINEZ, JOSE",2,1,1
1079,3027640003,BK,298 MANHATTAN AVENUE,01,B2,"ALI, FAISAL",2,1,1
1080,3027780012,BK,298 AINSLIE STREET,01,B9,ALLEVA FILOMENA,2,1,1
1081,3029940075,BK,25 STEWART AVENUE,11,V1,FLUSHING STEWART LLC,2,1,1
1082,3032450037,BK,194 WILSON AVENUE,04,S5,B AND R MANAGEMENT LIMITED PARTNERSHIP,2,1,1
1083,3034260028,BK,1342 BUSHWICK AVENUE,01,B2,BUSHWICK DECATUR LLC,2,1,1
1084,3039710049,BK,735 LIBERTY AVENUE,11,V1,ENY LIBERTY TOWERS LLC,2,1,1
1085,3040380101,BK,275 BERRIMAN STREET,01,A5,JOSEPH GEORGE G,2,1,1
1086,3041040053,BK,54 EUCLID AVENUE,01,B1,CHOEZ JOHN A,2,1,1
1087,3041110055,BK,966 JAMAICA AVENUE,02,C0,"CUELLAR, HECTOR R",2,1,1
1088,3041250029,BK,148 LOGAN STREET,01,B2,"ARCOS , MARIA  E",2,1,1
1089,3042270025,BK,466 LOGAN STREET,01,B2,REDWANUL HASAN,2,1,1
1090,3042960067,BK,649 ALABAMA AVENUE,02,C3,"GIBBS, WINSTON",2,1,1
1091,3042980053,BK,695 SHEFFIELD AVENUE,02,C3,"TAN , HONG JIANG",2,1,1
1092,3046060080,BK,39 EAST 52 STREET,01,B1,"ESPERT, JEAN",2,1,1
1093,3046310026,BK,214 EAST 96 STREET,02,C3,ANNABELLE BOYD,3,2,1
1094,3046410041,BK,111 EAST 54 STREET,01,B1,111 TRUST,2,1,1
1095,3046580005,BK,842 LENOX ROAD,01,A5,"RUSSELL, ROBIN",2,1,1
1096,3046740045,BK,401 EAST 48 STREET,02,C1,401 E 48 ST ASSOC.,2,1,1
1097,3046920036,BK,484 EAST 96 STREET,01,B2,"JEAN, LYONEL",2,1,1
1098,3046960054,BK,439 EAST 48 STREET,02,C0,"UDDIN, NASIR",2,1,1
1099,3047110068,BK,602 EAST 91 STREET,02,C0,"DELVOIS, MARCO",2,1,1
1100,3047980003,BK,563 BROOKLYN AVENUE,04,S3,PLAZA ELBA,3,2,1
1101,3048950052,BK,955 ALBANY AVENUE,01,A9,GORDON SHARON L,2,1,1
1102,3049490021,BK,1244 NEW YORK AVENUE,01,B2,"JACK, JIMI",2,1,1
1103,3049570027,BK,1264 ALBANY AVENUE,01,A9,"CARTY, FULVIA",2,1,1
1104,3050260011,BK,163 OCEAN AVENUE,03,D4,163 OCEAN TENANTS COR,2,1,1
1105,3051420020,BK,246 WESTMINSTER ROAD,01,B2,"POWELL, MARCIA",2,1,1
1106,3052080059,BK,515 EAST 22 STREET,02,C0,RICHARD J. HAWK,2,1,1
1107,3052090038,BK,413 EAST 23 STREET,01,A5,"WADE, EVELYN JUANITA",2,1,1
1108,3052830031,BK,410 GREENWOOD AVENUE,01,A1,RAYMOND IANNICELLI,2,1,1
1109,3053790047,BK,4312 17 AVENUE,01,B1,"GOMBO, SHULEM",2,1,1
1110,3053800037,BK,1676 42 STREET,01,B1,YC 2-10 TRUST,2,1,1
1111,3053990075,BK,703 EAST 5 STREET,01,A1,705 E 5TH LLC,2,1,1
1112,3054280055,BK,302 PARKVILLE AVENUE,01,B1,34 BROOKLYN CORP,2,1,1
1113,3054660016,BK,1618 51 STREET,01,B3,"1618, LLC, A DELAWARE LIMITED LIABILITY  COMPANY",2,1,1
1114,3054730058,BK,1751 53 STREET,01,B2,"NAIMAN, JOSEPH",2,1,1
1115,3054780069,BK,1647 54 STREET,01,B2,1649 54TH STREET LLC,2,1,1
1116,3054870072,BK,1819 55 STREET,02,C0,DAUM MENACHEM,2,1,1
1117,3055110015,BK,1722 59 STREET,01,B1,"KLEIN, FELICIA",2,1,1
1118,3055150025,BK,2146 59 STREET,01,B3,"GIPS, YECHIEL Z",2,1,1
1119,3055350060,BK,2047 63 STREET,01,A5,"HOROWITZ, JOSEPH",2,1,1
1120,3055560011,BK,2014 65 STREET,01,B1,"DILOLLO, EDWARD",2,1,1
1121,3056010029,BK,956 43 STREET,01,B1,"FREIDMAN, MAX",2,1,1
1122,3056270061,BK,4712 12 AVENUE,08,M1,CONGREGATION BNAI USHER INC,2,1,1
1123,3056600042,BK,1072 52 STREET,01,B2,"WERZBERGER, SHMIEL",2,1,1
1124,3056740059,BK,1029 55 STREET,02,C0,1029 HOLDING CO,2,1,1
1125,3056760070,BK,1213 55 STREET,01,B1,JOSEPH GROSSBERG,2,1,1
1126,3056977502,BK,5707 12 AVENUE,02,R6,UNAVAILABLE OWNER,2,1,1
1127,3057110015,BK,1228 59 STREET,01,B1,"KRASNIANSKI, RACHEL",2,1,1
1128,3058740039,BK,572 BAY RIDGE AVENUE,01,A9,"MOHARREM, AHMED",2,1,1
1129,3059420070,BK,541 76 STREET,02,C0,WASHINGTON DENNIS,2,1,1
1130,3059470047,BK,7620 COLONIAL ROAD,01,A5,THOMAS O JONES,2,1,1
1131,3059750137,BK,8060 HARBOR VIEW TERRACE,01,A3,"CLAVIN, J. PETER",2,1,1
1132,3060550021,BK,636 86 STREET,07,G4,SUNSHINE BROOKLYN LLC,2,1,1
1133,3061230056,BK,455 97 STREET,01,A5,"WONG, WARREN",2,1,1
1134,3061750069,BK,2123 71 STREET,01,B2,"NG, CHUN KIN",2,1,1
1135,3062180055,BK,2047 BAY RIDGE PARKWAY,01,B2,"PUMA, FRANK",2,1,1
1136,3062180056,BK,2045 BAY RIDGE PARKWAY,01,B2,"LIN, QING CAI",2,1,1
1137,3062360046,BK,1623 77 STREET,01,B3,"YAN, JIA MING",2,1,1
1138,3062430013,BK,1218 77 STREET,01,A5,GALINA SEMY,2,1,1
1139,3062660163,BK,1137 80 STREET,01,A5,"BURGER, JAMES PHILIP",2,1,1
1140,3062790008,BK,8005 12 AVENUE,01,A9,NUCCIO SALVATORE,2,1,1
1141,3063760075,BK,74 BAY 26 STREET,01,B3,"MADELINE DEROSSI TRUST, DATED OCTOBER 25 , 2017",2,1,1
1142,3064960029,BK,766 EAST 9 STREET,01,B2,"KHATOON, ZARYAN",2,1,1
1143,3064990053,BK,221 ELMWOOD AVENUE,02,C0,"FERSTMAN, YOSEF",2,1,1
1144,3065180076,BK,1093 EAST 5 STREET,01,A1,ALAN SASSOON 2012 IRREVOCABLE TRUST,2,1,1
1145,3065190014,BK,1020 EAST 7 STREET,01,B3,RHINE MIRIAM J,2,1,1
1146,3065240040,BK,5015 BAY PARKWAY,07,G9,IRREVOCABLE TRUST AGREEMENT FOR ROBYN BI SHKO,2,1,1
1147,3065280025,BK,1060 EAST 8 STREET,01,A1,"EDWARD AZAR, TRUSTEE OF EDWARD AZAR 2008  QPR TRUST",2,1,1
1148,3065290023,BK,1044 EAST 9 STREET,01,A3,SASSON ERIC,2,1,1
1149,3065290061,BK,1073 EAST 8 STREET,01,A3,GABRIEL ADES,2,1,1
1150,3065290071,BK,1045 EAST 8 STREET,01,A1,MARILYN CHIRA REVOCABLE TRUST,2,1,1
1151,3065420027,BK,1336 EAST 7 STREET,01,B2,"TEBELE, JEFFREY",2,1,1
1152,3065460057,BK,1275 EAST 10 STREET,01,A9,"KRESSNER, TOVA",2,1,1
1153,3065580044,BK,6308 24 AVENUE,02,C0,"LEE, SUSAN",2,1,1
1154,3065620074,BK,2433 65 STREET,01,B2,"POPILEVSKIY, ALEKSANDR",2,1,1
1155,3065720050,BK,907 AVENUE N,01,A7,"GELBFISH, JOSEPH",2,1,1
1156,3065730080,BK,1321 EAST 10 STREET,01,A9,JOSEPH SCHACHTER,2,1,1
1157,3065790053,BK,1401 WEST 6 STREET,02,C0,WU KEVIN,2,1,1
1158,3066020023,BK,1540 WEST 4 STREET,01,A9,"PARRILLA, JOSEPH",2,1,1
1159,3066120083,BK,1645 EAST 5 STREET,01,A9,ROMANO SELIM,2,1,1
1160,3066160032,BK,1566 EAST 10 STREET,04,S1,"DABBAH, ABRAHAM",2,1,1
1161,3066160084,BK,1519 EAST 9 STREET,01,A9,DIDIA RANDI,2,1,1
1162,3066500077,BK,294 KINGS HIGHWAY,04,S2,GODRANO REALTY CORP.,2,1,1
1163,3066600029,BK,1830 EAST 4 STREET,01,A3,"TAWIL, JAMES",2,1,1
1164,3066700045,BK,1894 WEST 10 STREET,02,C0,"LIN, ZHI CHAO TONY",3,2,1
1165,3066780027,BK,108 VAN SICKLEN STREET,01,B3,"CHATTAH, TEDDY",2,1,1
1166,3066830016,BK,1822 EAST 8 STREET,01,A1,"SOFFER, STEVEN",2,1,1
1167,3066850075,BK,1865 EAST 9 STREET,01,B2,"COHEN, BENJAMIN",2,1,1
1168,3066880003,BK,1312 GLENWOOD ROAD,01,B3,"BEROUKHIM, CYRUS",2,1,1
1169,3067410035,BK,1346 EAST 13 STREET,01,A3,"LAMM, ESTHER H",2,1,1
1170,3067610009,BK,1424 AVENUE O,08,I7,BAIS EZRA INC,2,1,1
1171,3068090003,BK,2612 QUENTIN ROAD,01,A1,"BLACK, REGINALD J",2,1,1
1172,3068310003,BK,2506 AVENUE R,01,A1,ANTAR MARK,2,1,1
1173,3069750016,BK,3912 LAUREL AVENUE,01,B2,"ELBOGEN, MALKY",2,1,1
1174,3070040026,BK,2846 WEST 36 STREET,02,C2,"OZUZU, JUDE E",2,1,1
1175,3070060036,BK,2874 WEST 33 STREET,01,A5,FATEMA SALLAM LIVING TRUST,2,1,1
1176,3071010027,BK,2042 WEST 4 STREET,01,B2,CARMELA SCALISI,2,1,1
1177,3071080062,BK,2125 EAST 5 STREET,01,B2,JEFFREY LEVY,2,1,1
1178,3071320057,BK,2215 EAST 5 STREET,01,A9,"ALSHKEFATI, EVETTE",2,1,1
1179,3071350023,BK,2140 EAST 9 STREET,01,A1,"HADRIYE, ISAAC M",2,1,1
1180,3071350038,BK,2174 EAST 9 STREET,02,C0,JAJATI LION,2,1,1
1181,3072980062,BK,1971 EAST 19 STREET,01,A3,"SAKKAL, ILENE",2,1,1
1182,3073570016,BK,4212 BEDFORD AVENUE,01,B1,"TALIO, JOSEPH C",2,1,1
1183,3073990081,BK,2295 EAST 14 STREET,01,A1,"BAUM, DAVID A",2,1,1
1184,3074490132,BK,2574 COYLE STREET,01,A1,GOZO NICHOLAS J,3,2,1
1185,3075900075,BK,974 EAST 27 STREET,04,S0,"MERMELSTEIN, LAURIE E.",2,1,1
1186,3075960017,BK,969 EAST 32 STREET,01,A9,"JEAN-BAPTISTE, MICHELLE",2,1,1
1187,3075970061,BK,1128 EAST 34 STREET,01,B2,DAVID J KATZMAN,2,1,1
1188,3076010067,BK,1096 EAST 38 STREET,01,B2,"DILLON, INGRID",2,1,1
1189,3076060072,BK,3190 BEDFORD AVENUE,01,B1,BNAI ISRAEL JEWISH CENTER OF EAST MIDWOO D INC,2,1,1
1190,3076060077,BK,3204 BEDFORD AVENUE,01,A1,DK BEDFORD REALTY LLC,2,1,1
1191,3076110038,BK,1017 EAST 29 STREET,01,B9,JOSEPH RABINOWITZ,2,1,1
1192,3076150055,BK,1190 EAST 34 STREET,01,B2,"GOLDBAUM, MICHAL",2,1,1
1193,3076330070,BK,1306 EAST 34 STREET,01,A9,"RABINOWITZ, DAVID M",2,1,1
1194,3076930097,BK,1480 EAST 32 STREET,01,B3,RITA SMOLLON,2,1,1
1195,3078240021,BK,1965 TROY AVENUE,01,A9,"LAGUERRE, LUBIN",2,1,1
1196,3078530045,BK,5506 AVENUE L,01,A9,"RADIX, NATASHA",2,1,1
1197,3079010036,BK,1505 EAST 56 STREET,01,A1,"BRYCE, SANDRA",2,1,1
1198,3081160001,BK,9023 AVENUE D,07,Y9,NYC DEPARTMENT OF ENVIRONMENTAL PROTECTION,2,1,1
1199,3081460055,BK,1320 ROCKAWAY PARKWAY,01,B2,DYMPNA C. GOBA,2,1,1
1200,3081640018,BK,1057 EAST 95 STREET,01,A1,"CLARKE, DANIEL",2,1,1
1201,3081650029,BK,1013 EAST 96 STREET,01,B2,"COOTE, NADRA LEE",2,1,1
1202,3082020038,BK,9302 FLATLANDS AVENUE,05,O7,CANARSIE EQUITIES CORP.,3,2,1
1203,3083930047,BK,7202 AVENUE N,01,B1,"VUGMAYSTER, ALLA",3,2,1
1204,3087960065,BK,3003 EMMONS AVENUE,05,H3,EMMONS HOSPITALITY,2,1,1
1205,3089000970,BK,45 BEACON COURT,01,A1,RAYMOND SCHAEFER,3,2,1
1206,4000400008,QN,10-39 51 AVENUE,02,C0,JUVENTINA CAPPOLA,2,1,1
1207,4001100006,QN,25-25 51 AVENUE,06,F5,"OUTDOOR PROMOTERS &TRADERS UNLIMITED, IN C",2,1,1
1208,4001170001,QN,50-01 39 AVENUE,03,D1,"SUNNYSIDE GARDEN APARTMENTS, LLC",5,4,1
1209,4001430028,QN,46-01 37 AVENUE,07,Y9,NYS DEPARTMENT OF TRANSPORTATION,6,5,1
1210,4003260059,QN,34-54 12 STREET,04,K4,CITY COLLISION INC,2,1,1
1211,4003500031,QN,36-28 14 STREET,,Z9,SONIC PROPERTIES LLC,2,1,1
1212,4003610012,QN,37-15 11 STREET,06,E9,"37-15 11TH STREET, LLC",2,1,1
1213,4003840015,QN,29-06 38 AVENUE,02,C1,ALYSSA GRAY REALTY CORP.,2,1,1
1214,4005800029,QN,25-30 BROADWAY,04,S9,"SOHO NEW YORK LODGING, LLC",2,1,1
1215,4005970114,QN,26-34 30 STREET,02,C1,30TH ST REALTY,2,1,1
1216,4006010034,QN,32-08 36 AVENUE,04,S4,"SOROTOS, IOANNIS",2,1,1
1217,4006140057,QN,31-34 33 STREET,03,D9,THIRTY THIRD STREET HOUSING DEVELOPMENT,2,1,1
1218,4006260010,QN,30-87 34 STREET,02,C1,3087 LLC,2,1,1
1219,4006520078,QN,25-78 37 STREET,01,B2,"FLORIO, FELICE",2,1,1
1220,4007020010,QN,25-85 43 STREET,02,C0,"2585 43RD , LLC",5,4,1
1221,4007150016,QN,25-71 44 STREET,01,B1,"SAKZEN44, LLC",2,1,1
1222,4007340065,QN,32-70 49 STREET,05,G8,3270 49TH STREET LLC,2,1,1
1223,4007980039,QN,20-18 42 STREET,01,B2,"BOUTSOURIS BABASSIKAS, ELENI",2,1,1
1224,4008820067,QN,20-34 23 STREET,01,B1,GIOVANNA M TRAUGOTT,2,1,1
1225,4011010029,QN,24-37 89 STREET,02,C0,VICTOR MARTINEZ,2,1,1
1226,4012280001,QN,39-76 58 STREET,08,W2,ST SEBASTIAN CHURCH,3,2,1
1227,4013010022,QN,40-11 69 STREET,04,S4,"JAAHAN, NASHMYN",2,1,1
1228,4013350061,QN,40-26 61 STREET,01,B1,"KARPOUZAS, SOPHIA",2,1,1
1229,4013650046,QN,26-34 92 STREET,01,B2,"AUCACAMA GONZALEZ, JUAN",2,1,1
1230,4013770016,QN,97-08 ASTORIA BOULEVARD,08,M1,ST GABRIELS R C CHURC,4,3,1
1231,4013800018,QN,30-26 83 STREET,02,C0,"LOZANO, SOCORRO",2,1,1
1232,4014270061,QN,32-15 97 STREET,01,B3,"BEGUM, RUMENA",2,1,1
1233,4015250092,QN,42-31 79 STREET,01,A1,"LEE, ZHEN XIANG",2,1,1
1234,4016150012,QN,97-12 42 AVENUE,02,C0,CORREA NEXSO,2,1,1
1235,4016950034,QN,100-17 NORTHERN BOULEVARD,05,K2,100 N BLVD LLC,2,1,1
1236,4017050015,QN,32-20 112 STREET,06,F1,"LEVINE, JOEL",2,1,1
1237,4017760066,QN,104-09 ROOSEVELT AVENUE,02,C5,JENNYS ROOMING HOUSE,2,1,1
1238,4019060016,QN,55-19 97 PLACE,01,B3,"ALTAMIRANO MENDEZ, NIDIA",2,1,1
1239,4019410010,QN,102-16 LARUE AVENUE,02,C0,NELSON JUCA,2,1,1
1240,4019420063,QN,103-71 52 AVENUE,01,B2,"PEREZ, JESUS A",2,1,1
1241,4020160049,QN,111-89 44 AVENUE,01,B1,"YANG, LAN XIANG",2,1,1
1242,4021020001,QN,64-33 98 STREET,04,D7,"QUEENS PORTFOLIO V, LLC",12,11,1
1243,4022180059,QN,108-11 69 AVENUE,01,A3,"AMINOV, GAVRIEL",3,2,1
1244,4022280026,QN,110-38 68 DRIVE,01,B1,"TAVDY, DAVID",2,1,1
1245,4022640127,QN,75-62 113 STREET,02,C1,"LIN, RAY-HWA",2,1,1
1246,4023110014,QN,50-21 49 STREET,06,E1,50-19 49TH STREET LLC,2,1,1
1247,4024450001,QN,70-31 48 AVENUE,08,M1,ST MARYS R C CHURCH,5,4,1
1248,4024750006,QN,51-41 SIMONSON STREET,02,C3,"LIN, MEI",2,1,1
1249,4024800002,QN,52-75 69 STREET,01,B2,"WONG, KIN-MAN",2,1,1
1250,4024830105,QN,52-84 72 PLACE,01,B2,GALLO ROSEANN,2,1,1
1251,4024960040,QN,53-20 72 STREET,01,A1,HOGAN JOHN,2,1,1
1252,4025190035,QN,55-16 43 STREET,06,E1,ROBINSON JUDITH,2,1,1
1253,4026110328,QN,52-19 FLUSHING AVENUE,06,F5,M&V REALTY CO.,3,2,1
1254,4026930117,QN,59-13 57 DRIVE,01,A2,PETILLO FRANK,2,1,1
1255,4027580070,QN,62-47 60 DRIVE,01,B3,"LAMCAJ, AMARILDO",2,1,1
1256,4028190083,QN,71-30 58 AVENUE,01,B2,KOENIG MARILYN E,2,1,1
1257,4029050027,QN,54-21 83 STREET,01,B2,"MAYI, LOURDES M",2,1,1
1258,4030260068,QN,64-04 70 STREET,01,A5,"TILI, DANA",2,1,1
1259,4030310060,QN,64-23 PLEASANTVIEW STREET,01,A1,JOSEPH F TRONZANO,2,1,1
1260,4030380041,QN,65-24 77 PLACE,01,B3,HAGEN JAMES,2,1,1
1261,4030420005,QN,65-08 80 STREET,01,A1,RONALD PIOTROWSKI HOLDING CORP.,2,1,1
1262,4031040142,QN,63-201 ALDERTON STREET,01,B1,RODERICK Q VALENZUELA,2,1,1
1263,4032740027,QN,25 MIDDLEMAY CIRCLE,01,A5,ESHKENAZI AZARIAH,2,1,1
1264,4033080001,QN,160 GREENWAY NORTH,01,A3,"MACKOOL, JAQUELINE",2,1,1
1265,4033300033,QN,83-36 BEVERLY ROAD,03,D4,ALIZIO REALTY CO,2,1,1
1266,4035550068,QN,1667 DECATUR STREET,01,B2,"VASQUEZ, MANUEL J",2,1,1
1267,4035910032,QN,60-51 75 AVENUE,01,B2,"STOPCZYK, EWA",2,1,1
1268,4036620042,QN,70-18 71 PLACE,01,A5,"SAJDERA, JANUSZ",2,1,1
1269,4037110064,QN,77-03 72 STREET,01,B2,"CASTILLO, PATRICIO",2,1,1
1270,4037140011,QN,61-22 COOPER AVENUE,04,S2,6122 COOPER LLC,2,1,1
1271,4037280003,QN,80-29 57 STREET,02,C0,118 DEVELOPMENT CORP.,2,1,1
1272,4037500010,QN,66-02 COOPER AVENUE,09,Z8,MT CARMEL CEMETERY,2,1,1
1273,4037770034,QN,67-36 79 STREET,02,C0,"CONCORDIA, FRANCESCO",2,1,1
1274,4038130016,QN,77-20 76 STREET,01,A2,7720 PROPERTY LLC,2,1,1
1275,4039360087,QN,119-27 6 AVENUE,01,A9,"MARY BEARD, CAROLYN",2,1,1
1276,4039740084,QN,126-09 11 AVENUE,01,A1,"HANG, XIEU LUAN",2,1,1
1277,4040460002,QN,111-04 14 AVENUE,01,B2,MELITZA MARTINEZ,2,1,1
1278,4040850030,QN,122-10 14 AVENUE,04,C7,C-POINT REALTY LLC,3,2,1
1279,4041160006,QN,15-30 130 STREET,06,F1,LATRIA TRANS LLC,2,1,1
1280,4044290022,QN,141-26 13 AVENUE,01,A9,"MCCARTHY, FRANCIS J",2,1,1
1281,4044930053,QN,149-58 POWELLS COVE BLVD,01,A3,DIMITRIOS POLITIS REVOCABLE FUNDED INTER  VIVOS TRU,2,1,1
1282,4045690027,QN,14-17 158 STREET,01,A1,GEORGE SHAILAS,2,1,1
1283,4045920018,QN,162-20 12 AVENUE,01,A2,"REDZEPAGIC, DZEVAD",2,1,1
1284,4047150004,QN,151-17 14 ROAD,01,A2,GRACE P E CHURCH,4,3,1
1285,4047330031,QN,154-21 20 AVENUE,01,B1,GIUSEPPE CICIO,2,1,1
1286,4047890027,QN,144-28 32 AVENUE,01,B3,"QIU, MEI JIN",2,1,1
1287,4047990093,QN,147-15 33 AVENUE,01,A4,"WONG, CHIN HONG",2,1,1
1288,4049410037,QN,32-50 FRANCIS LEWIS BLVD,05,K5,F.L. BLVD CORP.,2,1,1
1289,4049500030,QN,33-19 FARRINGTON STREET,06,E9,VIT ENTERPRISES LLC,2,1,1
1290,4051860054,QN,142-15 CHERRY AVENUE,03,D3,CHERRY GARDEN  LLC,3,2,1
1291,4052390058,QN,33-50 155 STREET,01,B3,"DOOLEY, EUGENE V",2,1,1
1292,4055140028,QN,189-35 44 AVENUE,02,C3,E CONTE,3,2,1
1293,4055200039,QN,196-35 44 AVENUE,01,B1,"MONOGIOUDIS, GUS",2,1,1
1294,4057700015,QN,169-16 23 AVENUE,01,A1,STELIOS KALOPEDIS AND ELLI KALOPEDI,2,1,1
1295,4057830030,QN,17-52 202 STREET,01,A3,JYNE SHIAU,2,1,1
1296,4060540091,QN,213-45 33 AVENUE,01,A2,SKIBOLA IVANICA,2,1,1
1297,4062000028,QN,38-08 205 STREET,01,A1,ANTHONY V POLIDORI,2,1,1
1298,4062040028,QN,40-21 201 STREET,02,C0,"YOU, CHONG REN",2,1,1
1299,4062080016,QN,40-25 205 STREET,01,A1,"SERVES, ANGELO",2,1,1
1300,4062450016,QN,38-18 216 STREET,01,A1,GINNANE THOMAS,2,1,1
1301,4063740031,QN,136-39 59 AVENUE,02,C0,"LIN, MIN DONG",2,1,1
1302,4067260010,QN,57-12 160 STREET,01,B3,"LIU, YI YING",2,1,1
1303,4068460031,QN,162-31 76 AVENUE,01,A1,"HERNANDEZ, SALVADOR",2,1,1
1304,4068570008,QN,80-65 162 STREET,01,A1,"COSTABALO, NARCISA E",2,1,1
1305,4071150141,QN,185-03 69 AVENUE,01,B2,"MAROTTI, ANTHONY  J JR.",2,1,1
1306,4073040021,QN,204-28 46 AVENUE,01,A5,FOOK LIN LEE,2,1,1
1307,4073560008,QN,199-21 48 AVENUE,01,B3,"JAW, HSIU CHIN",2,1,1
1308,4073670062,QN,48-31 208 STREET,01,A1,MEI JOSEPH K F,2,1,1
1309,4077660003,QN,209-06 RICHLAND AVENUE,01,A1,ALTERSON BEVERLY,2,1,1
1310,4079040041,QN,82-04 242 STREET,01,B3,"NAHIN, EMRUZ",2,1,1
1311,4080040225,QN,92-15 241 STREET,01,B2,"DHALIWAL, AVTAR",2,1,1
1312,4083510050,QN,58-26 256 STREET,01,B1,"ZHAO, WEI JIAN",2,1,1
1313,4084480001,QN,70-07 261 STREET,02,C6,GLEN OAKS VILLAGE OWNERS INC,64,63,1
1314,4085740131,QN,81-15 251 STREET,01,A2,RAMON PEREZ,2,1,1
1315,4085910046,QN,83-47 248 STREET,01,A2,"CHAND, SOM",2,1,1
1316,4086620002,QN,90-17 247 STREET,01,A1,DAVID FREDY,2,1,1
1317,4086680013,QN,250-12 87 DRIVE,01,A1,"MORALES, HENRY R",2,1,1
1318,4086680035,QN,251-28 87 DRIVE,01,A1,"PERSHAD, DANESHWARI",2,1,1
1319,4086970012,QN,79-50 261 STREET,01,A1,"CHAN, CURTIS",2,1,1
1320,4088430002,QN,86-39 79 STREET,01,A1,"CHI, YUXIANG",2,1,1
1321,4089440025,QN,90-28 75 STREET,01,B2,"ANDRADE, MARIA E",2,1,1
1322,4089770050,QN,89-03 97 STREET,01,B2,"CAMPOS, RAFAEL",3,2,1
1323,4089920209,QN,91-20 96 STREET,01,A5,"ZHAO, RU YAN",2,1,1
1324,4090790023,QN,101-25 78 STREET,01,B2,"NAUTH, CHANDRADAI",2,1,1
1325,4091300036,QN,105-17 77 STREET,02,C0,"LAMSAL, SURYA P",2,1,1
1326,4091670046,QN,106-76 97 STREET,02,C0,"MATONTI, EUGENE",3,2,1
1327,4091770119,QN,85-93 98 STREET,01,B3,ESMONT ROBERT A,2,1,1
1328,4092000064,QN,86-19 104 STREET,01,B3,NARDA SOODIN,2,1,1
1329,4092750056,QN,86-40 122 STREET,05,O2,86-40 122ND ST LLC,2,1,1
1330,4092780074,QN,124-13 JAMAICA AVENUE,04,S4,124 JAMAICA AV LLC,2,1,1
1331,4093850015,QN,104-38 94 AVENUE,01,A1,"CORONEL, EDISON",2,1,1
1332,4093980019,QN,94-26 113 STREET,01,B2,P DE SIENA,2,1,1
1333,4094440042,QN,127-15 95 AVENUE,01,B3,"RAMDATH, BOOPENDRA",2,1,1
1334,4094490045,QN,94-19 133 STREET,01,B3,"BOLIERE, DURAND",2,1,1
1335,4094840031,QN,101-54 117 STREET,08,N2,101-54 117TH ST LLC,3,2,1
1336,4095120056,QN,103-13 107 STREET,01,B3,"RUIZ, MARITZA",2,1,1
1337,4095250038,QN,107-16 103 STREET,01,A1,CALVARY ASSEMBLY OFGOD,2,1,1
1338,4095390040,QN,107-70 101 STREET,01,B3,"GONZALEZ, JAIME AURELIO",2,1,1
1339,4096990013,QN,139-50 87 ROAD,01,A1,"JAGNANAN, BISHNU",2,1,1
1340,4097000026,QN,87-10 143 STREET,01,B2,SAJJAN SINGH GHOTRA,2,1,1
1341,4098760039,QN,170-28 GRAND CENTRAL PKWY,01,B3,"FU, PEI YI",2,1,1
1342,4099830013,QN,90-18 144 PLACE,02,C0,"CHOWDHURY, JAYED",2,1,1
1343,4099890095,QN,146 STREET,07,U7,LIRR,6,5,1
1344,4100510033,QN,106-13 PRINCETON STREET,01,B2,"JEUNE, MADSEN",2,1,1
1345,4100670115,QN,109-11 VAN WYCK EXPRESSWAY,01,A1,JOSEPH CALHOUN III,2,1,1
1346,4101720038,QN,108-20 164 PLACE,01,A1,"AMITY BAPTIST CHURCH, INC.",2,1,1
1347,4101980012,QN,110-38 168 STREET,01,A1,"KAMAL, TASKINA",2,1,1
1348,4102040012,QN,111-10 167 STREET,01,A1,"NAIDOO, VERASAMMY",2,1,1
1349,4102440016,QN,169-10 107 AVENUE,01,A1,"RICHARDS, DAMIEN",2,1,1
1350,4103080052,QN,114-41 177 STREET,01,A1,CLARENCE PRYOR,3,2,1
1351,4103430047,QN,182-20 LIBERTY AVENUE,06,E1,LIBERTY EQUITIES,2,1,1
1352,4103770012,QN,104-07 189 STREET,01,B3,DENISE MILLER,2,1,1
1353,4104590008,QN,90-25 195 STREET,01,A2,HANIFF ANITA,2,1,1
1354,4105750038,QN,89-03 210 STREET,01,A1,CARL HARRIS,2,1,1
1355,4105810018,QN,88-28 207 STREET,01,A5,"LITON, MOHAMMED Z",2,1,1
1356,4106050011,QN,94-16 VANDERVEER STREET,01,B3,LUCIEN ULRICK,2,1,1
1357,4107700001,QN,218-02 97 AVENUE,06,F5,"LAM & LAM GROUP, LLC",2,1,1
1358,4108200033,QN,191-06 JAMAICA AVENUE,04,S2,"SANTOS, ALIPIO",2,1,1
1359,4108260043,QN,195-27 CARPENTER AVENUE,01,B1,"BERLELEY, LILLIAN",2,1,1
1360,4108580048,QN,190-27 103 AVENUE,01,A3,"KING, DONOVAN",2,1,1
1361,4108610019,QN,100-21 194 STREET,01,B3,ANGELA MOSES,2,1,1
1362,4108690047,QN,100-43 202 STREET,01,A1,"GARCIA, MELVIN",2,1,1
1363,4109050011,QN,202-02 109 AVENUE,01,B2,FRANCIN1 INCORPORATED,2,1,1
1364,4109110012,QN,109-12 205 PLACE,01,B3,MELVIN BROWN,2,1,1
1365,4109250018,QN,190-14 109 ROAD,01,B2,5 STANLEY LANE CORP,3,2,1
1366,4109300041,QN,110-12 195 STREET,01,A1,"GARDNER, SHARON J",2,1,1
1367,4109480092,QN,110-28 208 STREET,01,B3,"SAHAI, AMY N",2,1,1
1368,4111470001,QN,110-33 MONTEREY STREET,01,A2,"KINLOCK, VIVENE",2,1,1
1369,4111830033,QN,107-24 219 STREET,01,A1,"HENRY M. ULYSSE, CO-TRUSTEE",3,2,1
1370,4111980120,QN,110-11 SPRINGFIELD BLVD,01,B2,"FRANCOIS, JOSEPH",2,1,1
1371,4113220018,QN,116-29 221 STREET,01,B3,"MYLES, PATRICK D",2,1,1
1372,4115040025,QN,132-25 CENTREVILLE STREET,01,A2,"PALMA, LUIS",2,1,1
1373,4116130054,QN,109-59 133 STREET,01,B3,"BUDHAN, ANAND",2,1,1
1374,4116210061,QN,111-15 116 STREET,01,B3,SANDY CAPPELLO,2,1,1
1375,4116490047,QN,114-37 122 STREET,01,A1,RUPERT C PERSAUD,2,1,1
1376,4116710056,QN,115-19 127 STREET,01,A1,"ALVAREZ-SABOGAL, MARIA",2,1,1
1377,4116870025,QN,116-36 LINCOLN STREET,01,B1,MD KHALEDUR RAHMAN,2,1,1
1378,4116910037,QN,135-07 FOCH BOULEVARD,01,A1,"ALBA DEVELOPMENT, LLC",2,1,1
1379,4117140015,QN,116-51 121 STREET,01,A5,GUILLERMINA PINEDA,2,1,1
1380,4117160028,QN,117-37 122 PLACE,01,B2,"RASIAWAN, JAY",2,1,1
1381,4117220008,QN,130-53 115 STREET,01,A1,"PRASAD, KEVIN",2,1,1
1382,4118160012,QN,149-49 115 STREET,01,A1,"PERSAUD, JOSHUA J",2,1,1
1383,4119310122,QN,143-17 109 AVENUE,01,B3,"RAMCHARAN, VEDESH T",2,1,1
1384,4119630020,QN,111-24 LIVERPOOL STREET,01,A1,LEE ANNA,2,1,1
1385,4119630035,QN,111-54 LIVERPOOL STREET,01,A1,"WOODSON, MARGARET L",2,1,1
1386,4119640230,QN,112-14 148 STREET,01,B3,"LALTOO, CLIFFORD B",2,1,1
1387,4119640297,QN,111-15 LIVERPOOL STREET,01,A1,"WILLIAMS, JESSIE",2,1,1
1388,4119910022,QN,146-17 116 AVENUE,01,A1,L HAYNES CONG CH,2,1,1
1389,4120070268,QN,116-14 148 STREET,01,A1,"148 ETR HOLDINGS, LLC",2,1,1
1390,4120490008,QN,123-15 INWOOD STREET,01,B2,"LOW , MARIO A",2,1,1
1391,4120600081,QN,142-38 BASCOM AVENUE,01,A1,"HAMPTON, SHIRLEY C",2,1,1
1392,4121520049,QN,109-26 GUY R BREWER BLVD,01,B2,"ARCOS, JENNY P",2,1,1
1393,4124670059,QN,178-11 120 AVENUE,01,A1,"RIVERA, JUAN  D",2,1,1
1394,4125900035,QN,171-24 140 AVENUE,01,B3,"BABALOLA, OLAYIWOLA K",2,1,1
1395,4126660099,QN,186-19 122 AVENUE,01,B3,"HARRIOTT, ADRIAN",2,1,1
1396,4126720020,QN,121-32 192 STREET,01,A1,"LEWIS, ANNE-MARIE",2,1,1
1397,4129340170,QN,131-58 225 STREET,01,A5,"WARD, MARY",2,1,1
1398,4129780032,QN,241-48 132 ROAD,01,A1,STIMPSON TREVOR,2,1,1
1399,4130240034,QN,137-25 THURSTON STREET,01,A1,"WILLIAMS, COLIN",2,1,1
1400,4130410001,QN,183-02 140 AVENUE,01,B1,MJM DEVELOPMENT GROUP INC.,2,1,1
1401,4130870230,QN,222-19 NORTH CONDUIT AVENUE,01,A0,"DOWNIE, ALTHEA E.",2,1,1
1402,4132860162,QN,145-38 175 STREET,01,B2,"OTUBAGA, MARIAM B",2,1,1
1403,4133530006,QN,146-58 181 STREET,01,B2,"BECKFORD ALLEN, MARCIA",2,1,1
1404,4134600039,QN,146-28 227 STREET,01,B2,"BOYCE CHARLES, GLORIA",2,1,1
1405,4135020008,QN,144-33 231 STREET,01,A2,"CONNORS, PHYLLIS L",2,1,1
1406,4135130058,QN,229-20 SOUTH CONDUIT AVENUE,05,G8,"PARKWAY PROPERTIES,",2,1,1
1407,4137100018,QN,147-36 230 PLACE,01,A2,MANBAHAL JAMES B K,2,1,1
1408,4137330121,QN,235-11 BENTLEY ROAD,01,B2,"BELLO, JOSE L",2,1,1
1409,4137410069,QN,241-19 147 DRIVE,01,A2,PERGOLIZZI LINDA J,2,1,1
1410,4141610017,QN,156-24 101 STREET,01,B3,"POWELL, ROGER",2,1,1
1411,4155160052,QN,11-53 BEACH 9 STREET,01,A1,ROBERT W. COLBY FAMILY TRUST,2,1,1
1412,4156950114,QN,14-11 HARBOUR COURT,01,A2,DORNBUSH ROBERT,2,1,1
1413,4159720058,QN,409 BEACH 47 STREET,01,B9,"ANDERSON, CLIVE OLIVE",2,1,1
1414,4160510016,QN,69-21 THURSBY AVENUE,01,B1,LEROY CONYERS,2,1,1
1415,4160530028,QN,417 BEACH 69 STREET,01,B2,"CHETA, GEETANJALI",2,1,1
1416,4161240011,QN,3-04 BEACH 91 STREET,01,B2,"FERRERI, KATRIN",2,1,1
1417,4162460032,QN,134-04 CRONSTON AVENUE,01,B1,"LOFTUS-MUNNS, DEBORAH M",2,1,1
1418,4162810033,QN,147 BEACH 136 STREET,01,A1,"YERSHOV, ARIK",2,1,1
1419,4162830084,QN,184 BEACH 139 STREET,01,A3,"SMITH, CAROLYN",4,3,1
1420,4163160053,QN,148 BEACH 143 STREET,01,A1,"RUDBERG, NINA",2,1,1
1421,5001060035,SI,72 BRIGHTON AVENUE,02,C3,ELLIOT SOBOL,3,2,1
1422,5001490020,SI,20 PELTON AVENUE,01,B2,"IBAGBEOLA, OLUSOLA A",2,1,1
1423,5001490112,SI,136 DAVIS AVENUE,01,A1,"GONZALEZ, DAVID",2,1,1
1424,5001500112,SI,24 HOWARD COURT,01,A5,"PEREZ, ENISSA V",2,1,1
1425,5001650145,SI,435 DELAFIELD AVENUE,01,A1,ROBERT A GEISSLER,2,1,1
1426,5001820041,SI,476 DELAFIELD AVENUE,01,A1,"NIEVES, GEORGE",2,1,1
1427,5002220082,SI,132 1/2 ROE STREET,01,A1,TMROE 134 LLC,2,1,1
1428,5002530095,SI,565 METROPOLITAN AVENUE,01,A1,"BREEN, JOAN",2,1,1
1429,5003260372,SI,55 LAKELAND ROAD,01,A2,"ANTHONY DELLOMO, AS",2,1,1
1430,5003320176,SI,155 DRAKE AVENUE,01,A1,"O'BRIEN, DANIEL",2,1,1
1431,5003900111,SI,23 ELDRIDGE AVENUE,01,B2,"MAGRONE, THOMAS",2,1,1
1432,5004630131,SI,42 CASWELL AVENUE,01,A1,"PIMPSNER, RONALD",2,1,1
1433,5005050001,SI,372 BAY STREET,07,G2,COELLO DAVID T,2,1,1
1434,5005100026,SI,319 VAN DUZER STREET,01,A1,"FISHER, CHARLES E",2,1,1
1435,5005630059,SI,250 BROAD STREET,07,G3,BARI HOLDING CORP,4,3,1
1436,5005630098,SI,220 GORDON STREET,01,A1,"TROIANIELLO, THERESA",2,1,1
1437,5006590021,SI,30 ONEIDA AVENUE,01,A2,"MARCANO, MARIA",2,1,1
1438,5006650014,SI,146 SENECA AVENUE,01,A5,THOMAS STILE,2,1,1
1439,5007450029,SI,114 MARTIN AVENUE,01,A2,"AGOSTA, CARL",2,1,1
1440,5007550054,SI,368 FANNING STREET,01,B2,DI NIRO FAMILY IRREVOCABLE RESIDENCE TRU ST,2,1,1
1441,5007850063,SI,701 WOOLLEY AVENUE,01,A2,HEDEISHA ALI,2,1,1
1442,5008540017,SI,41 DUTCHESS AVENUE,01,A3,THE LEO FAMILY TRUST,2,1,1
1443,5009480069,SI,125 BEACON AVENUE,01,A1,"MEHNERT, CORAL",2,1,1
1444,5010290013,SI,21 PALMER AVENUE,01,A1,ALLEN PATRICIA A,2,1,1
1445,5010640038,SI,166 HAGAMAN PLACE,01,A1,"FERNANDO , SHAVEEN",2,1,1
1446,5010840097,SI,46 SHARPE AVENUE,01,B2,"RUSSO, JORGINA",2,1,1
1447,5010960038,SI,1640 CASTLETON AVENUE,01,B9,BERNARD WILKINSON,2,1,1
1448,5010970041,SI,200 TREADWELL AVENUE,01,A1,TONY OJO OHIKUARE,3,2,1
1449,5010990008,SI,145 CLINTON PLACE,01,A1,TIMOTHY OLSEN,2,1,1
1450,5011330106,SI,438 VILLA AVENUE,01,B2,ANNA MARIA TENERELLI,2,1,1
1451,5011920019,SI,125 VAN PELT AVENUE,01,A1,"FONSECA, LUIS",2,1,1
1452,5012130091,SI,22 DE HART AVENUE,06,E9,"BRUNI, CESARE",3,2,1
1453,5012630049,SI,29 ARLINGTON AVENUE,01,A2,GEORGE JIMINEZ,2,1,1
1454,5014370001,SI,1630 FOREST AVENUE,05,K7,"BANCO SANTANDER, S.A.",2,1,1
1455,5015760007,SI,49 NADAL PLACE,01,B2,JOSEPH A. CUCCURULLO,3,2,1
1456,5027050001,SI, VICTORY BOULEVARD,,Z7,CITY OF NEW YORK,25,24,1
1457,5028980009,SI,338 MOSEL AVENUE,01,A1,ALTHEA CUMBERBATCH,2,1,1
1458,5030040015,SI,47 MERLE PLACE,01,B2,"SURFSIDE PROPERTIES, LLC",2,1,1
1459,5031210044,SI,29 OCEAN AVENUE,01,B2,JOSEPHINE LIMA,2,1,1
1460,5032640011,SI,1016 HYLAN BOULEVARD,01,A9,"CHAN , PO FUN",2,1,1
1461,5032900021,SI,8 NEWBERRY AVENUE,01,A5,ROY BARBARINO,2,1,1
1462,5033320033,SI,297 ATLANTIC AVENUE,01,B2,FRANK LOMBARDO,2,1,1
1463,5033590023,SI,152 JEROME ROAD,01,A2,"CESERANO, CHRISTINE",2,1,1
1464,5033800032,SI,337 LIBERTY AVENUE,01,A2,MAU GROUP LLC,2,1,1
1465,5037360021,SI,174 KISWICK STREET,01,A1,"VICTOR BORG, TRUSTEE",2,1,1
1466,5037910045,SI,931 OLYMPIA BOULEVARD,01,A1,GUMERSINDO J CRUZ,2,1,1
1467,5038830022,SI,324 FREEBORN STREET,08,M1,RC CHUR ST MARGARET M,2,1,1
1468,5042740109,SI,122 PETER AVENUE,01,A2,"AQUINO, ANTHONY",2,1,1
1469,5043060006,SI,11 PROSPECT PLACE,01,B2,"IACOVIELLO, ERNESTO",2,1,1
1470,5044780604,SI,21 SABLE LOOP,01,A5,PATRICIA A CATELLO,2,1,1
1471,5052680151,SI,272 WINCHESTER AVENUE,01,A2,"MCLOUGHLIN, ADAM",2,1,1
1472,5053030033,SI,233 WIMAN AVENUE,01,A5,THE URSULA ROSA IRREVOCABLE TRUST,2,1,1
1473,5054380001,SI,24 RHETT AVENUE,01,B2,"LIMONCELLI, NICHOLAS",2,1,1
1474,5057250042,SI,32 WINSTON STREET,01,A5,"MOSLEHI, ASHRAFF",2,1,1
1475,5062540053,SI,36 NORTH RAILROAD ST,01,B2,ANTONIO CICCOTTO,2,1,1
1476,5070660001,SI,5 BARRY STREET,01,A5,"SAVIRI, ANTHONY",2,1,1
1477,5072060274,SI,125 INDUSTRIAL LOOP,06,E1,JEFFREY AND KEITH SCHAFFER,2,1,1
1478,5073140001,SI,4254 ARTHUR KILL ROAD,04,K4,SHARROTTSTRASSE INC,3,2,1
1479,5075340159,SI,20 STATION AVENUE,06,E1,BOB'S STATION GARAGE,2,1,1
1480,5075720115,SI,105 MADSEN AVENUE,01,A1,"MEROLLA, MICHAEL J",2,1,1
1481,5077960005,SI,83 BEDELL AVENUE,01,A2,GERALDINE L LINDSEY,2,1,1
1482,5078410061,SI,103 SPRAGUE AVENUE,01,A1,"TILATITSKY, CYNTHIA",2,1,1
1483,5078640037,SI,310 LORETTO STREET,01,B2,"FISHMAN, ELLA",2,1,1
1484,5080400067,SI,96 NASHVILLE STREET,01,A2,R J QUIRK,2,1,1
1485,1006440001,MN,555 WEST STREET,04,K4,NYC DEPARTMENT OF PARKS AND RECREATION,2,1,1
1486,1007450045,MN,312 WEST 22 STREET,02,C0,FOX  CAROL R,2,1,1
1487,1008240037,MN,174 5 AVENUE,05,O5,REVOCABLE TRUST OF CAROL SANDER,2,1,1
1488,1010760030,MN,691 10 AVENUE,04,C7,"691 TENTH,",2,1,1
1489,1012320045,MN,2330 BROADWAY,11,V1,BROADWAY 85TH LLC,2,1,1
1490,1014720013,MN,429 EAST 77 STREET,01,A4,"YADIGAROGLU , ION",2,1,1
1491,1015260037,MN,222 EAST 81 STREET,02,C0,222 EAST 81 REALTY LLC,3,2,1
1492,1015430050,MN,1558 2 AVENUE,04,S5,1558 SECOND AVENUE CORP,2,1,1
1493,1017240007,MN,73 WEST 126 STREET,03,D9,"GREAT HILL EQUITIES, INC.",2,1,1
1494,1017530140,MN,68 EAST 129 STREET,08,W4,CHILDREN'S FNDTN ETC,2,1,1
1495,1020270025,MN,2430 ADAM C POWELL BLVD,03,D3,NYC HOUSING AUTHORITY,2,1,1
1496,1022150427,MN,13 VAN CORLEAR PLACE,01,A1,"WALKER, WENDY",2,1,1
1497,2022870008,BX,372 WILLIS AVENUE,04,C7,ELSA M. FRIAS,2,1,1
1498,2023607501,BX,526A EAST 159 STREET,02,R3,MELROSE COURT CONDOMINIUM,74,73,1
1499,2023810062,BX,467 EAST 159 STREET,01,B2,"RODRIGUEZ, LUIS",2,1,1
1500,2027690193,BX,1380 RANDALL AVENUE,06,E9,MESTOUSIS ENTERPRISES LLC,5,4,1
1501,2029860025,BX,1229 VYSE AVENUE,01,B2,"RODRIGUEZ, MARISELA",2,1,1
1502,2030450044,BX,4329 3 AVENUE,05,GU,4343 THIRD AVE HOLDING CORP,2,1,1
1503,2030660065,BX,2414 HOFFMAN STREET,02,C0,2414 HOFFMAN LLC,2,1,1
1504,2032120038,BX,2320 UNIVERSITY AVENUE,01,B3,"DEKHKANOV, SHOLOM",2,1,1
1505,2032340019,BX,2249 HAMPDEN PLACE,02,C0,"GUZMAN, ENGELS",2,1,1
1506,2032730800,BX, EAST FORDHAM ROAD,09,Q1,NYC DEPARTMENT OF PARKS AND RECREATION,3,2,1
1507,2032980045,BX,2957 BAINBRIDGE AVENUE,02,C5,2955-57 BAINBRIDGE AVE REALTY CORP,2,1,1
1508,2034770011,BX,308 STEPHENS AVENUE,01,A2,"REYNOSO , GIANCARLO A",2,1,1
1509,2036610001,BX,1701 STORY AVENUE,05,K1,925 FUERTES REALTY LLC,2,1,1
1510,2036930077,BX,2223 STORY AVENUE,01,A1,"VEGA, ANGEL",2,1,1
1511,2037220001,BX,1681 BRUCKNER BOULEVARD,05,K1,1681 BRUCKNER BOULEVARD REALTY CORP.,2,1,1
1512,2037430027,BX,1150 MANOR AVENUE,02,C2,MARIANA LOPEZ,2,1,1
1513,2037730051,BX,1253 BOYNTON AVENUE,01,B1,"GONZALEZ, HECTOR LUIS JR",2,1,1
1514,2038160030,BX,2248 BLACKROCK AVENUE,01,A1,ROMAN EDGARDO,2,1,1
1515,2039180004,BX,1508 COMMONWEALTH AVENUE,01,B2,"RAMDAT, GANESHWARI",2,1,1
1516,2039370056,BX,1428 WHITE PLAINS ROAD,01,B1,FELTON KATHERINE,2,1,1
1517,2039580161,BX,1681 CASTLE HILL AVENUE,01,B3,"GIRJANAND, RAJESH P",2,1,1
1518,2039730020,BX,2422 TRATMAN AVENUE,01,B2,"KHAN, HAFEEZ",2,1,1
1519,2040390019,BX,1652 HOLLAND AVENUE,01,B2,"TAPIA, ROBERT",2,1,1
1520,2040780113,BX,2516 POPLAR STREET,01,B2,"ALI, REAZ",2,1,1
1521,2043110011,BX,2075 HERING AVENUE,01,A1,"FRROKU, GJON",2,1,1
1522,2045510048,BX,2909 BRONXWOOD AVENUE,02,C0,2907-2909 BRONXWOOD REALTY CORP.,2,1,1
1523,2045640034,BX,2756 SEXTON PLACE,01,B1,"GUERRIER, GARRY",2,1,1
1524,2045670075,BX,1457 ARNOW AVENUE,01,B1,1457 ARNOW LLC,2,1,1
1525,2046110015,BX,3214 PAULDING AVENUE,01,B3,EMMET D ALLEN,2,1,1
1526,2046160067,BX,3217 TENBROECK AVENUE,01,B1,"ROOKWOOD, KEINO",2,1,1
1527,2046640042,BX,715 EAST 216 STREET,01,A1,"PARKER, JULIUS",2,1,1
1528,2046790024,BX,829 EAST 220 STREET,02,C0,137 BEACH CORP.,2,1,1
1529,2046850023,BX,923 EAST 214 STREET,01,A1,WILWORTH BENJAMIN,2,1,1
1530,2048300051,BX,650 EAST 228 STREET,01,A1,"RIVERA , LOURDES",2,1,1
1531,2048340044,BX,4150 CARPENTER AVENUE,02,C1,"HP TYLER'S BRONX HDFC, INC.",2,1,1
1532,2048430082,BX,766 EAST 230 STREET,02,C0,EAST 230 ASSETS LLC,2,1,1
1533,2049720012,BX,3920 MERRITT AVENUE,06,F9,DILORENZO REALTY 12 LLC,4,3,1
1534,2054090677,BX,3386 CAMPBELL DRIVE,01,B1,"GIORGIO, RALPH J",2,1,1
1535,2054170021,BX,1470 OUTLOOK AVENUE,09,Q9,EVERS CHARLES,4,3,1
1536,2054270071,BX,2911 SCOTT PLACE,01,A1,"NUNEZ, AYMES",2,1,1
1537,2055170032,BX,3169 MILES AVENUE,02,C0,KING STEPHEN ENG,2,1,1
1538,2055990043,BX,2628 MILES AVENUE,01,B2,"CORNIELES, PAULINA",2,1,1
1539,2056260424,BX,54 CENTRE STREET,01,A1,NOSCHESE CARMEN,2,1,1
1540,2056280045,BX,27 SCHOFIELD STREET,01,A6,G CAVALIERE,2,1,1
1541,2056300075,BX,300 WILLIAM AVENUE,01,A5,"DELLACERRA, CATHERINE",2,1,1
1542,2056350152,BX,565 CITY ISLAND AVENUE,05,K1,"JOHNNY B'S REALTY, LLC",2,1,1
1543,2057490740,BX,3100 INDEPENDENCE AVENUE,01,A3,ARYEH JESELSOHN,2,1,1
1544,2057620402,BX,3431 CORLEAR AVENUE,01,B3,DILA SERRATA,2,1,1
1545,2058363101,BX,231 WEST 252 STREET,08,W6,RIVERDALE COUNTRY SCH,3,2,1
1546,3001930019,BK,68 DEAN STREET,04,S4,DAN DEAN LLC,2,1,1
1547,3004640039,BK,62 3 STREET,04,S3,"FIGUEROA, MARTA E",2,1,1
1548,3005550005,BK,155 KING STREET,11,V1,"KING STREET OWNER, L.L.C.",3,2,1
1549,3006330016,BK,130 18 STREET,01,B9,500 THATFORD INC.,2,1,1
1550,3006770044,BK,803 5 AVENUE,01,B9,"CALABRO, ITALIA",2,1,1
1551,3006770048,BK,207 32 STREET,01,B9,"LOPEZ, MARIA C",2,1,1
1552,3008070053,BK,469 53 STREET,04,S9,JOSE V. PEDRERO,2,1,1
1553,3009640042,BK,278 5 AVENUE,05,K1,280 5TH AVE REALTY LLC,4,3,1
1554,3012840061,BK,1263 CARROLL STREET,01,A4,"CAPLAN, MORDECAI",2,1,1
1555,3013740037,BK,1554 PARK PLACE,02,C3,"GEORGE, TREVOR",2,1,1
1556,3013970071,BK,1785 UNION STREET,01,B1,"ROYAL, AULDITH B",2,1,1
1557,3014200071,BK,1031 MONTGOMERY STREET,02,C1,MONTGOMERY ESTATE REALTY LLC,2,1,1
1558,3014280010,BK,652 LEFFERTS AVENUE,01,A5,652 LEFFERTS LLC,2,1,1
1559,3016260057,BK,689 QUINCY STREET,11,V0,689 QUINCY DEVELOPMENT LLC,3,2,1
1560,3017020001,BK,1754 FULTON STREET,02,C1,FULTON PK ASSOC,19,18,1
1561,3017660080,BK,23 HART STREET,02,C0,23 HART REALTY LLC,2,1,1
1562,3017740008,BK,207 NOSTRAND AVENUE,02,C1,PULASKI HOMES LLC,2,1,1
1563,3018940054,BK,549 MYRTLE AVENUE,04,D6,"E&M REALTY HOLDINGS, LLC",2,1,1
1564,3019940034,BK,26 CLAVER PLACE,01,B3,"WILSEY, SEAN",3,2,1
1565,3019957501,BK,110 PUTNAM AVENUE,02,R1,UNAVAILABLE OWNER,2,1,1
1566,3021200025,BK,156 LAFAYETTE AVENUE,01,B3,"MACARTHUR, ANDREW",2,1,1
1567,3022170066,BK,85 RUTLEDGE STREET,04,D6,YESH PROPERTIES LLC,2,1,1
1568,3023280019,BK,558 DRIGGS AVENUE,02,C4,DRIGGS  AVE  APARTMENTS   LLC,2,1,1
1569,3025230051,BK,189 HURON STREET,02,C1,189 HURON LLC,2,1,1
1570,3026850026,BK,629 HUMBOLDT STREET,02,C2,629 HUMBOLDT LLC,2,1,1
1571,3027580013,BK,104 CONSELYEA STREET,01,B9,104 CONSELYEA ST. CORP.,2,1,1
1572,3027850032,BK,451 LORIMER STREET,07,G4,GILDA REALTY CORP,2,1,1
1573,3031840046,BK,1019 WILLOUGHBY AVENUE,01,B2,"BBNA SERVICES, INC",2,1,1
1574,3032370022,BK,936 HART STREET,01,B2,"LUNG, LAI WAH",2,1,1
1575,3032480050,BK,305 STOCKHOLM STREET,02,C1,"305 STOCKHOLM, LLC",2,1,1
1576,3033140074,BK,105 GROVE STREET,01,B1,GRACE M CARTER,2,1,1
1577,3033200021,BK,366 MENAHAN STREET,02,C1,MENAHAN GARDENS LLC,2,1,1
1578,3035330050,BK,702 HOWARD AVENUE,01,B1,"SHAW, ALICE",2,1,1
1579,3035340016,BK,689 HOWARD AVENUE,01,B1,"STOKES, WELCHIA",2,1,1
1580,3035370003,BK,651 SARATOGA AVENUE,01,B1,"SUMRA, EDMUND",2,1,1
1581,3036000012,BK,857 THOMAS S BOYLAND ST,02,C0,"MAZEL DEVELOPMENT, INC.",2,1,1
1582,3037730047,BK,452 VERMONT STREET,01,B1,"ROGERS, CLIFFORD",2,1,1
1583,3038840298,BK,67 BULWER PLACE,01,A1,"GUSTARD, SANDRA",2,1,1
1584,3039340022,BK,114 ARLINGTON AVENUE,11,V0,340 BRADFORD LLC,2,1,1
1585,3041060019,BK,49 CRESCENT STREET,01,A9,"MARTINEZ, ANA LILIAN",2,1,1
1586,3041060072,BK,74 HEMLOCK STREET,01,B2,"NUNEZ, AGUETA",2,1,1
1587,3041300035,BK,428 RIDGEWOOD AVENUE,02,C0,"QUINTUNA, ROMEL HIDALGO SUCUZHANAY",2,1,1
1588,3041570057,BK,358 CHESTNUT COURT,01,B2,"SANCHEZ, RAFAEL",2,1,1
1589,3041740079,BK,416 GRANT AVENUE,01,B1,ST SYLVESTERS CHURCH,4,3,1
1590,3043080010,BK,746 BARBEY STREET,01,B2,"NAVARRO-CARABALLO, TRICIA",2,1,1
1591,3043120058,BK,701 ASHFORD STREET,01,A1,GONZALEZ SEBASTIAN,3,2,1
1592,3043210014,BK,742 SHEFFIELD AVENUE,02,C0,MICHELLE FORGENIE,2,1,1
1593,3045980084,BK,21 EAST 95 STREET,02,C3,SMITH SANDRA,2,1,1
1594,3046120018,BK,134 EAST 94 STREET,01,B1,"LEDLON, KEVIN",2,1,1
1595,3046520034,BK,302 EAST 98 STREET,02,C3,"ROMAIN, DONNA",2,1,1
1596,3046650014,BK,384 EAST 91 STREET,01,A1,J COSTELLO,2,1,1
1597,3046810003,BK,874 LINDEN BOULEVARD,01,A2,CALVIN CARTER JR,2,1,1
1598,3046940032,BK,435 ROCKAWAY PARKWAY,02,C3,"QUOW, EVERTON C",2,1,1
1599,3047090041,BK,58 EAST 89 STREET,01,B1,ROSE OTI-GIBSON,2,1,1
1600,3047210046,BK,537 EAST 49 STREET,01,A1,JEAN ROWE,2,1,1
1601,3047910042,BK,450 LINCOLN ROAD,04,S9,MANNING RUTH A,3,2,1
1602,3047940015,BK,620 EAST NEW YORK AVENUE,01,A9,FRANTZ ALEXIS,2,1,1
1603,3047960045,BK,576 NEW YORK AVENUE,01,A5,"CATO, JOHN C",2,1,1
1604,3047980018,BK,488 MAPLE STREET,02,C0,YVES M CHERISMEAU,2,1,1
1605,3048650018,BK,310 EAST 45 STREET,01,B2,"UDDIN, MD ROKAN",2,1,1
1606,3048730051,BK,893 BROOKLYN AVENUE,01,A1,Naomi Alleyne,2,1,1
1607,3048890037,BK,3511 SNYDER AVENUE,01,B9,BAZELAIS RODRIGUE,2,1,1
1608,3048930035,BK,3913 SNYDER AVENUE,01,A9,"MIGNOTT, HOWARD",2,1,1
1609,3049630054,BK,767 EAST 46 STREET,01,B1,"BROME , SHERLENE",2,1,1
1610,3049770057,BK,629 EAST 43 STREET,01,A9,"LAWRENCE, JASON",2,1,1
1611,3050150035,BK,783 EAST 40 STREET,01,B2,"EMMANUEL, GINA DORISCA",2,1,1
1612,3050300057,BK,277 MAPLE STREET,01,B1,"FORTUNE, LINCOLN",2,1,1
1613,3050730042,BK,61 WESTMINSTER ROAD,01,B2,"61 WESTMINSTER, LLC",2,1,1
1614,3051910032,BK,362 EAST 26 STREET,01,A5,"JACOBS, ANNA TAFT",2,1,1
1615,3052230064,BK,534 EAST 24 STREET,01,A1,"HUFFMAN, CLAIRE L MRS",2,1,1
1616,3052320037,BK,1041 CONEY ISLAND AVENUE,11,V1,ISRAEL JOYCE,2,1,1
1617,3052390007,BK,1809 GLENWOOD ROAD,01,A1,"ROSENBAUM , DANIEL",2,1,1
1618,3052450060,BK,2780 BEDFORD AVENUE,01,A5,"TITUS, GHISLAINE",2,1,1
1619,3052640045,BK,205 VANDERBILT STREET,02,C0,"WALTON, CAROLYN",2,1,1
1620,3052830020,BK,105 EAST 4 STREET,01,B2,"O'SULLIVAN, BRAIN J",2,1,1
1621,3053060020,BK,3513 12 AVENUE,01,B1,OLGA ASTUDILLO,2,1,1
1622,3053110046,BK,144 DAHILL ROAD,01,B1,"XIAO, WEI QIANG",2,1,1
1623,3053710016,BK,502 EAST 3 STREET,01,B1,"FIELD, YERACHMIEL S",2,1,1
1624,3054190016,BK,92 WEBSTER AVENUE,04,S1,SPIEGEL JACOB,2,1,1
1625,3054350071,BK,1735 46 STREET,01,B1,"DREW, LIVIAN",2,1,1
1626,3054350079,BK,1715 46 STREET,02,C0,AARON ORLANDER,2,1,1
1627,3054590025,BK,1640 50 STREET,08,M9,CONG CHEDMATH TORA V'CHESED,2,1,1
1628,3054760014,BK,2018 52 STREET,01,A3,"BERGER, DAVID",2,1,1
1629,3054790015,BK,1718 53 STREET,01,A9,"LOWY, JOEL",2,1,1
1630,3055050015,BK,1822 58 STREET,01,A9,"STRASSER, EUGENE",2,1,1
1631,3055730009,BK,6802 NEW UTRECHT AVENUE,04,S1,6802 NEW UTRECHT AVENUE LLC,2,1,1
1632,3056820053,BK,1167 56 STREET,01,B1,"SCHWARTZ, FRED",2,1,1
1633,3057160060,BK,1041 61 STREET,10,G7,1041 REALTY CORP,2,1,1
1634,3057620012,BK,1414 66 STREET,02,C0,"CHEN, MIAO LIAN",2,1,1
1635,3058170020,BK,336 64 STREET,02,C3,RENDON EMETERIO,2,1,1
1636,3059890052,BK,8026 5 AVENUE,04,S9,"VASILAKOS, ANASTASIOS",2,1,1
1637,3060390020,BK,1034 85 STREET,01,A3,"VISCOSO, PASQUALINA",2,1,1
1638,3061070017,BK,334 93 STREET,02,C1,334 93 LLC,2,1,1
1639,3061270008,BK,427 MARINE AVENUE,01,A5,"KONG, ANGELA",2,1,1
1640,3062060018,BK,1930 73 STREET,01,B1,"MA, ZHIFANG HUANG",2,1,1
1641,3063170038,BK,8200 21 AVENUE,01,A1,"WIGDER., MOSHE Y.",2,1,1
1642,3063730055,BK,1950 86 STREET,04,S1,THE CUZZI FAMILY IRREVOCABLE TRUST,2,1,1
1643,3063960027,BK,119 BAY 11 STREET,01,B1,"ZHOU, BENNY",2,1,1
1644,3064960058,BK,789 EAST 8 STREET,01,B2,WEITMAN MEYER,2,1,1
1645,3064990013,BK,198 FOSTER AVENUE,04,C7,198 FOSTER,2,1,1
1646,3065150036,BK,1092 EAST 3 STREET,01,A1,"DEPUTRON, RENEE",2,1,1
1647,3065160084,BK,1035 EAST 3 STREET,01,A1,ISAAC ADES,2,1,1
1648,3065210075,BK,945 EAST 8 STREET,01,A1,JOSEPH HARARY  C/O WA,2,1,1
1649,3065290053,BK,1093 EAST 8 STREET,01,A3,KATTAN STEVEN,2,1,1
1650,3065330030,BK,1162 EAST 8 STREET,01,B2,"IMANI, DAN",2,1,1
1651,3065390033,BK,1350 EAST 4 STREET,01,B1,"SULTAN, SARAH",2,1,1
1652,3065400055,BK,1373 EAST 4 STREET,01,A9,"GUTKIND-BENBARUCH, FRANCES",2,1,1
1653,3065430056,BK,701 AVENUE M,01,B3,HH REALTY EQUITIES LLC,2,1,1
1654,3065460072,BK,1237 EAST 10 STREET,01,A9,"BRONFIN, ALFRED",2,1,1
1655,3065890018,BK,1428 EAST 8 STREET,01,B1,"ZACCAI, AMY",2,1,1
1656,3065900079,BK,1441 EAST 8 STREET,01,A9,"ASHKENAZI, ROCHELLE J",2,1,1
1657,3065900089,BK,1417 EAST 8 STREET,01,A3,"CHEMTOB, DAVID",2,1,1
1658,3066020068,BK,1559 WEST 5 STREET,01,B1,"LEE, MARIANNA SAU FAN",2,1,1
1659,3066030014,BK,1518 WEST 3 STREET,02,C0,"TAK-YUEN, SO CO-TRUSTEE SO FAMILY TRUST",2,1,1
1660,3066120016,BK,1532 OCEAN PARKWAY,01,B1,YAKUP IMIR,2,1,1
1661,3066130036,BK,1656 EAST 7 STREET,01,A5,"GINDI, HARRISON D",2,1,1
1662,3066160059,BK,1579 EAST 9 STREET,01,B1,1579 EAST 9TH STREET LLC,2,1,1
1663,3066190069,BK,1621 WEST 13 STREET,02,C0,"LIN , GUI FEI",2,1,1
1664,3066267502,BK,1663 WEST 6 STREET,02,R1,UNAVAILABLE OWNER,2,1,1
1665,3066390022,BK,1632 EAST 8 STREET,01,A9,"MEZRAHI, NINA",2,1,1
1666,3066540018,BK,1728 WEST 2 STREET,01,B3,"KABARETI, HAROUN",2,1,1
1667,3066810337,BK,1942 EAST 5 STREET,01,A3,BETESH ELLIOTT,2,1,1
1668,3066960056,BK,877 EAST 12 STREET,01,A9,"SAFF, DAVID",2,1,1
1669,3067280045,BK,1214 EAST 18 STREET,01,A9,IRA RUDOWSKY,2,1,1
1670,3067330088,BK,1221 EAST 13 STREET,01,A5,"GUTWIRTH, JOSEPH",2,1,1
1671,3067720034,BK,1562 EAST 26 STREET,01,A1,"MOSKOVITS, DAVID",2,1,1
1672,3068757501,BK,159 BAY 35 STREET,02,R3,UNAVAILABLE OWNER,2,1,1
1673,3069140055,BK,163 BAY 46 STREET,01,A9,"AYE, THAN THAN",2,1,1
1674,3070890078,BK,1997 EAST 7 STREET,08,W9,AHAVA VE AHABA YESHIVA KETANA INC,2,1,1
1675,3070980070,BK,2037 WEST 8 STREET,01,B1,FRANCESCO EMILIO,2,1,1
1676,3071080067,BK,2115 EAST 5 STREET,01,A1,"DOUEK , JACQUELINE",2,1,1
1677,3071110074,BK,2021 EAST 8 STREET,01,A3,ABRAHAM E SHALAM,2,1,1
1678,3071510016,BK,2274 WEST 1 STREET,01,B2,"TRUST, THE GAMBUZZA",2,1,1
1679,3071570092,BK,2247 EAST 5 STREET,01,A9,SOLY BAWABEH,2,1,1
1680,3071760038,BK,367 AVENUE X,05,O5,367 AVENUE X LLC,2,1,1
1681,3071780007,BK,402 AVENUE W,01,B1,ELI SAFINA HAMADANI,2,1,1
1682,3072910126,BK,1233 AVENUE T,01,A9,"ALMAGRHRABI, JOSEPH",2,1,1
1683,3074050313,BK,2322 EAST 24 STREET,02,C0,"LEYBOVICH, SVETLANA",2,1,1
1684,3074540022,BK,2638 EAST 11 STREET,01,A2,GEORGE AMISTAD,2,1,1
1685,3075520100,BK,2946 BEDFORD AVENUE,08,W5,BROOKLYN COLLEGE,9,8,1
1686,3075900030,BK,937 EAST 26 STREET,01,B2,"PAPLANOS, NECHIE",2,1,1
1687,3075910033,BK,929 EAST 27 STREET,01,B1,"HYMOWITZ, DANIEL",2,1,1
1688,3076140058,BK,1894 NEW YORK AVENUE,01,B1,"CALLER, BAILA",2,1,1
1689,3076150051,BK,1180 EAST 34 STREET,01,A5,"ODES, DAVID",2,1,1
1690,3076310081,BK,1184 EAST 32 STREET,01,A9,GOLDBERG JOYCE S,2,1,1
1691,3076350043,BK,3508 AVENUE K,01,A9,EVA GANCZ,2,1,1
1692,3076430048,BK,2520 AVENUE L,01,A1,"BANASH, MORDECHAI",2,1,1
1693,3076640076,BK,1372 EAST 29 STREET,01,A1,JASON HIRSCH,2,1,1
1694,3076830039,BK,1415 EAST 29 STREET,01,A1,"SINGER, CHANA C",2,1,1
1695,3077880048,BK,1894 ALBANY AVENUE,01,A9,BENJAMIN DAPHNE B,2,1,1
1696,3077910001,BK,1890 TROY AVENUE,01,B2,"KAUR, KULJEET",2,1,1
1697,3078420011,BK,2155 TROY AVENUE,01,A9,"FRANCIS, DILWORTH",2,1,1
1698,3080520066,BK,1162 EAST 87 STREET,01,A2,JAMES MCGUIRE,2,1,1
1699,3080530058,BK,8715 STILLWELLS PLACE,01,B3,GRACE BEVACQUA DEPPERT,2,1,1
1700,3081480051,BK,544 EAST 99 STREET,01,B1,"LAM, YAU FU",2,1,1
1701,3081710125,BK,623 EAST 102 STREET,01,B1,"VINCENT-FENNER, ROBIN",2,1,1
1702,3083930055,BK,7234 AVENUE N,01,A5,"FLANDERS, BRETT",2,1,1
1703,3085050057,BK,1932 RYDER STREET,01,A9,CENTONZA MICHAEL,2,1,1
1704,3085380043,BK,3818 AVENUE T,01,A5,"WONG, LAI MUI",2,1,1
1705,3086340021,BK,2254 EAST 64 STREET,01,A1,"KOFMAN, ALEKSANDER",2,1,1
1706,3087130077,BK,34 WEST END AVENUE,08,M1,MANHATTAN BCH JEWISH,3,2,1
1707,3087150034,BK,3084 BRIGHTON 13 STREET,04,O8,BYMK FAMILY TRUST,2,1,1
1708,3087310051,BK,615 HAMPTON AVENUE,01,A4,"MANDELBLAT, ZARINA",2,1,1
1709,3089320744,BK,29 EBONY COURT,01,A1,GALLINA ROSE,2,1,1
1710,4000570011,QN,11-27 47 ROAD,01,B2,"RUIZ, LUCRECIA",2,1,1
1711,4000850022,QN,45-39 DAVIS STREET,06,E9,45-39 DAVIS STREET REALTY CORP.,2,1,1
1712,4001550027,QN,39-49 44 STREET,01,B1,"FRIEDMAN, JOSEPH  A",2,1,1
1713,4003610025,QN,37-14 12 STREET,06,E1,SHERMAN AVE COMPANY INC,2,1,1
1714,4003610028,QN,37-20 12 STREET,06,E9,TERESA D. MCLOUGHLIN LIVING TRUST,3,2,1
1715,4003980030,QN,39-14 29 STREET,02,C0,"MACIAS, FELIPE",2,1,1
1716,4006040041,QN,35-40 32 STREET,01,B2,"PAPADOPOULOS, GEORGE",2,1,1
1717,4006220070,QN,32-62 35 STREET,01,A1,"PALAZZOLO MINOR TRUST, DATED OCTOBER 15,  2013",2,1,1
1718,4007730047,QN,45-13 20 ROAD,01,B2,DESIMONE AUDREY,2,1,1
1719,4008040020,QN,23-33 37 STREET,02,C0,"GIAGKIOZIS, DIMITRIOS",2,1,1
1720,4008240057,QN,21-60 36 STREET,02,C0,"TSITSIPATIS, HRISOSTOMOS",2,1,1
1721,4008320012,QN,22-47 33 STREET,02,C0,MYKONOS REALTY LLC,2,1,1
1722,4008400052,QN,24-02 31 STREET,05,K5,2402 REAL ESTATES CORP,2,1,1
1723,4008650037,QN,24-10 23 AVENUE,01,A5,ANA C GONZALEZ,2,1,1
1724,4010860065,QN,23-19 92 STREET,01,B1,ORTIZ ALEX,2,1,1
1725,4012850061,QN,37-44 75 STREET,04,O8,PMART REALTY L.L.C.,2,1,1
1726,4013650050,QN,26-40 92 STREET,01,B2,"GIANCONTIERI, CHRISTOPHER",2,1,1
1727,4013730008,QN,99-16 25 AVENUE,01,B1,"ALI , MURATAB",2,1,1
1728,4013950019,QN,31-20 84 STREET,01,B3,"WANG , JIANN RONG",2,1,1
1729,4013960058,QN,31-03 84 STREET,01,B3,"ZUBIZARRETA, OSVALDO",2,1,1
1730,4014070040,QN,95-01 32 AVENUE,08,M1,KOREAN METHODIST CHURCH,2,1,1
1731,4014130068,QN,32-11 83 STREET,02,C0,MIRNA MEIS,2,1,1
1732,4016020071,QN,94-37 46 AVENUE,01,B2,"NOHAR, PRAMELLA",2,1,1
1733,4016570009,QN,105-33 DITMARS BOULEVARD,01,B2,ELCIDO MERCADO,2,1,1
1734,4017150019,QN,33-22 101 STREET,02,C0,"WANG, YUE PING",2,1,1
1735,4017400021,QN,35-36 100 STREET,01,B2,"OUTRIGHT REALTY, INC",2,1,1
1736,4017590023,QN,37-50 97 STREET,03,D1,6727 IGRAM ST,2,1,1
1737,4019890092,QN,45-03 104 STREET,04,S4,TINEE BEANEE LLC,2,1,1
1738,4021320054,QN,66-10 YELLOWSTONE BLVD,03,D4,66 10 YELLOWSTONE OWNERS CORP,2,1,1
1739,4022970034,QN,50-05 47 STREET,01,A9,NEWMAN BERTHA L,2,1,1
1740,4022970057,QN,50-42 48 STREET,01,B1,BARBARA CASAZZA,2,1,1
1741,4022980033,QN,50-01 48 STREET,01,B1,BENITES ZORAIDA,2,1,1
1742,4023800077,QN,65-41 JAY AVENUE,02,C0,"MARK CHOINSKI, AS TRUSTEE",2,1,1
1743,4024000037,QN,53-91 66 STREET,01,A1,"ALAGNA, ANTONIETTA",2,1,1
1744,4024880005,QN,52-53 73 STREET,01,B2,"PLUNKETT, FERGUS",2,1,1
1745,4026680070,QN,58-01 MASPETH AVENUE,01,B2,"AGUAYZA, JOSE",3,2,1
1746,4026930062,QN,57-18 61 STREET,02,C2,JERZY KOWALCZYK,2,1,1
1747,4027090015,QN,61-39 56 ROAD,02,C0,SEROWIK URSULA,2,1,1
1748,4027530302,QN,64-39 59 AVENUE,01,A2,ULANOWSKI STANLEY,2,1,1
1749,4029070022,QN,54-40 82 STREET,01,A1,"KUNG, WAILAN",2,1,1
1750,4030410050,QN,65-22 79 PLACE,01,A1,"SCOTTI, JARRIT J",2,1,1
1751,4033570029,QN,84-24 KEW GARDENS ROAD,02,C2,BORPIT REALTY THREE LLC,2,1,1
1752,4035530066,QN,1673 NORMAN STREET,01,A1,"DONG, ZHI YONG",2,1,1
1753,4036000094,QN,74-19 65 STREET,01,B1,VALENTIN JOSEFINA,2,1,1
1754,4036670451,QN,72-35 EDSALL AVENUE,01,B9,IRMGARD TURNER,4,3,1
1755,4036890054,QN,71-33 72 STREET,01,A1,FRANCESCO PULLARA,2,1,1
1756,4037310094,QN,80-71 CYPRESS AVENUE,01,A2,"EBERT, ROSEANNA MARI",2,1,1
1757,4038130033,QN,77-60 76 STREET,01,A9,J DUNN,2,1,1
1758,4038190025,QN,77-13 80 STREET,01,A2,"RIZZO, ROSA L",2,1,1
1759,4038230085,QN,78-62 74 STREET,01,B2,P HOFFMAN,2,1,1
1760,4038590177,QN,78-01 88 STREET,01,B2,O'SULLIVAN CATHERINE,2,1,1
1761,4038940007,QN,89-04 70 AVENUE,01,A1,"BONAPARTE, RICHARD",2,1,1
1762,4039410053,QN,121-39 7 AVENUE,01,A5,"ZHENG, JIANLIN",2,1,1
1763,4039790019,QN,9-01 129 STREET,01,A1,"ECK, JAMES",2,1,1
1764,4039820057,QN,7-35 130 STREET,01,B2,"BELTRAN GOMEZ, DIANA C",2,1,1
1765,4040040037,QN,11-27 127 STREET,02,C0,"LIU, XIU HUA",2,1,1
1766,4041310037,QN,18-34 126 STREET,01,B2,"WU, QIU PING",2,1,1
1767,4044310060,QN,35 CENTER DRIVE,01,A1,"DE LUCA, PHILIP",2,1,1
1768,4044480041,QN,1-24 MALBA DRIVE,09,Q8,MALBA ASSN,2,1,1
1769,4044660010,QN,147-21 2 AVENUE,01,A2,"SHIELDS, MICHAEL",2,1,1
1770,4045050047,QN,149-33 14 AVENUE,05,K7,GPP REALTY LLC,2,1,1
1771,4045450013,QN,154-41 10 AVENUE,01,A2,"THEOFANIS, DIMITRIOS",2,1,1
1772,4047280008,QN,16-10 FRANCIS LEWIS BLVD,01,B2,DIMITRIOS PAPALAZAROS,2,1,1
1773,4047770021,QN,142-26 32 AVENUE,01,A1,KIT FAN CHAN,2,1,1
1774,4051200086,QN,56-24 137 STREET,01,B1,"XU, PING",2,1,1
1775,4052510012,QN,33-59 166 STREET,01,A1,CAREY STEVEN F,2,1,1
1776,4053360016,QN,41-14 163 STREET,01,B3,THE THERESA MONGELLI TESTAMENTARY TRUST,2,1,1
1777,4053930023,QN,42-16 163 STREET,10,G7,"THE GORDIAN GROUP OF NY, LP",2,1,1
1778,4054280062,QN,43-44 171 STREET,01,A1,"DIVITTORIO, VINCENT",2,1,1
1779,4054370051,QN,158-08 45 AVENUE,04,S2,FANG ZHONG XUE,2,1,1
1780,4054450040,QN,45-01 166 STREET,01,A1,"DOAN, PHUONG NHU THI",2,1,1
1781,4055710028,QN,49-03 167 STREET,01,A0,"TIAN, BAOTANG",2,1,1
1782,4056330027,QN,196-68 48 AVENUE,01,A5,"WU, JUDY C.",2,1,1
1783,4056830020,QN,56-32 196 PLACE,01,A1,FRANCIS MAN-KEE CHU,2,1,1
1784,4057600035,QN,166-60 21 AVENUE,01,A1,"DRAMISIOTIS, CONSTANTINOS",2,1,1
1785,4057660070,QN,166-19 24 AVENUE,01,A1,"MOLLER, GEORGE JOHN",2,1,1
1786,4058630110,QN,211-77 15 ROAD,02,C6,"BAY TERRACE COOPERATIVE SECTION IV, INC.",48,47,1
1787,4059710046,QN,28-15 JORDAN STREET,01,A1,"DUSMET, ARTURO M",2,1,1
1788,4060560036,QN,214-30 29 AVENUE,01,A1,"BELCZYNSKI, MICHELE",2,1,1
1789,4060580033,QN,29-05 215 PLACE,01,A1,"CHIARENZA, ANTONINO",2,1,1
1790,4060760039,QN,33-29 200 STREET,01,A5,"HALL, KATHLEEN",2,1,1
1791,4061150031,QN,214-19 33 ROAD,01,A1,"PRESTI, EILEEN",2,1,1
1792,4061860035,QN,217-68 CORBETT ROAD,01,A1,CONTI ANTHONY,2,1,1
1793,4063650039,QN,134-23 58 ROAD,01,A1,EMANUEL DESENA,2,1,1
1794,4065850017,QN,73-24 136 STREET,01,A3,"BRODY, AARON",2,1,1
1795,4068370035,QN,160-14 76 ROAD,01,A1,"MARCELO GONZALEZ RAMON, ANGEL",2,1,1
1796,4073660032,QN,48-48 208 STREET,01,A2,KEITH M LOUIS,2,1,1
1797,4073850024,QN,50-40 OCEANIA STREET,01,A0,SUZANNE SMITONICK,2,1,1
1798,4074690057,QN,58-07 218 STREET,01,A1,SHU XIN LIANG,3,2,1
1799,4081060005,QN,8 PROSPECT AVENUE,01,A1,"CAMPESE, CHRISTOPHER",2,1,1
1800,4081380016,QN,42-07 WESTMORELAND STREET,01,A1,"FENG, YAOKUN",2,1,1
1801,4081450070,QN,254-09 40 AVENUE,01,A1,"CHEN, YUNG TSUNG",2,1,1
1802,4082210037,QN,52-02 MARATHON PARKWAY,04,S1,"JIMENEZ, LUZ G",2,1,1
1803,4082520001,QN,52-37 LEITH PLACE,01,A1,"PENIELLO, ROCCO",2,1,1
1804,4082630078,QN,48-42 GLENWOOD STREET,01,A1,"LIU, MICHELLE",2,1,1
1805,4083590051,QN,60-23 255 STREET,01,B1,"CHEN, XIAO JING",2,1,1
1806,4086650060,QN,248-35 89 AVENUE,01,A1,TORRES MERLITO,2,1,1
1807,4088780027,QN,91-15 85 ROAD,01,B3,"PEREZ, ARMANDO",3,2,1
1808,4089670052,QN,89-11 85 STREET,01,A9,"BATISTA, BRAULIO",2,1,1
1809,4089720124,QN,89-38 91 STREET,01,B3,"CHEN, SUYA",2,1,1
1810,4090190022,QN,85-15 95 AVENUE,01,B2,LUIS ASITIMBAY,2,1,1
1811,4091190016,QN,103-24 97 STREET,02,C0,"GOMEZ, ADAN",2,1,1
1812,4091460051,QN,105-19 84 STREET,01,A1,"NAJMI, KHALID",2,1,1
1813,4093200131,QN,112-17 ATLANTIC AVENUE,01,A5,"ROMBOT, RENDY",2,1,1
1814,4093380058,QN,88-26 132 STREET,01,B2,"FERREIRA, DANIEL",2,1,1
1815,4093640010,QN,89-10 VAN WYCK EXPRESSWAY,08,I1,JAMAICA HOSP,3,2,1
1816,4094390058,QN,94-11 121 STREET,01,B2,"MCDOWELL, ELMA ALLISON",2,1,1
1817,4095000004,QN,132-10 101 AVENUE,01,A9,"MAHASE, RONALD",2,1,1
1818,4095020132,QN,102-28 135 STREET,02,C0,"ROOPCHAN, CHATERAM",2,1,1
1819,4095380137,QN,104-68 116 STREET,01,A1,MEDINA EDDIE R,2,1,1
1820,4095580004,QN,120-08 103 AVENUE,02,C0,GURMEET KAUR,2,1,1
1821,4096090037,QN,107-27 129 STREET,01,A1,"RAMDASS, DHANRAJ",3,2,1
1822,4096880027,QN,88-29 146 STREET,01,B1,TIKALAL MUNTIE,2,1,1
1823,4097020014,QN,144-18 87 ROAD,01,A1,THE ADMINISTRATOR OF VETFRANS AFFAIRS,2,1,1
1824,4097140014,QN,141-33 PERSHING CRESCENT,02,C1,141-33 PERSHING CRESCENT LLC,2,1,1
1825,4099000006,QN,182-09 JAMAICA AVENUE,04,S2,DEEPNAVAOR MAHADIO,2,1,1
1826,4099720017,QN,137-34 90 AVENUE,01,B3,PRADO SEGUNDO E,2,1,1
1827,4101610058,QN,106-25 GUY R BREWER BLVD,01,A1,"UDDIN, MD JAMIL",2,1,1
1828,4101860036,QN,167-21 109 ROAD,01,A1,"GURUNG YADAV, KIRAN",2,1,1
1829,4102000079,QN,169-19 111 AVENUE,01,A1,"SKATES, KENNETH, TRUSTEE OF THE HELEN SK ATES IRREV",3,2,1
1830,4102000085,QN,169-11 111 AVENUE,01,B2,JOSEPH BOVELL,2,1,1
1831,4102160024,QN,176-11 93 AVENUE,01,A1,BRANCHE  BARBARA,2,1,1
1832,4102430089,QN,174-17 POLHEMUS AVENUE,01,B3,CARRASCO FERNANDO,3,2,1
1833,4102520066,QN,106-24 RUSCOE STREET,01,B1,MAXIE LINDO,2,1,1
1834,4102990021,QN,112-19 176 STREET,01,A1,NIHAR HOME CORP.,2,1,1
1835,4104370040,QN,188-41 JORDAN AVENUE,01,B3,"PALMER, JOANNE H",2,1,1
1836,4104540038,QN,88-36 190 STREET,01,A1,"KALICHARAN, DHARAMRAJ",2,1,1
1837,4104940139,QN,88-24 201 STREET,01,A1,"INGA, LUIS",3,2,1
1838,4105000024,QN,190-16 PALO ALTO AVENUE,01,A1,KOK PAK WONG,2,1,1
1839,4105890009,QN,87-75 FRANCIS LEWIS BLVD,01,A5,"BALBUENA, VICTORIA A",2,1,1
1840,4106940022,QN,94-53 218 STREET,01,A1,DAVID HOSSIN,2,1,1
1841,4106970019,QN,218-28 94 AVENUE,01,A1,DENISE L MCCARTY,2,1,1
1842,4107270028,QN,94-01 220 STREET,01,A1,"RASSIGA, PATRICIA",2,1,1
1843,4107590136,QN,215-40 JAMAICA AVENUE,08,M9,GREATER BETHEL CHURCH,2,1,1
1844,4108030008,QN,222-18 100 AVENUE,01,A1,"JEAN-LOUIS, NADINE",2,1,1
1845,4109190038,QN,109-16 210 STREET,01,A1,"FIELDS JR, MICHAEL",2,1,1
1846,4109650239,QN,111-08 207 STREET,01,A1,MAUREEN LESLIE,2,1,1
1847,4110390010,QN,198-01 116 AVENUE,01,A1,"ARNOLD, MARIA M",2,1,1
1848,4110850037,QN,99-10 213 STREET,01,B2,"HIRAKIS, PETER",2,1,1
1849,4110950045,QN,217-14 103 AVENUE,01,B3,"OLOJUOMO, BAMIKOLE",2,1,1
1850,4112340157,QN,217-11 114 ROAD,01,A5,"DORIEL KELLMAN, TRUSTEE",2,1,1
1851,4112430001,QN,223-02 114 AVENUE,01,A0,"DANTES, MARIE E",2,1,1
1852,4112730042,QN,114-102 229 STREET,01,A0,"BUTLER, DENICE",3,2,1
1853,4112990044,QN,115-90 218 STREET,01,A1,"SLADE, JOSEPH",3,2,1
1854,4113030159,QN,115-112 222 STREET,01,A1,JOHNNIE & MARIAN JOYNER,3,2,1
1855,4113440037,QN,132-37 81 STREET,01,B3,"COMO, ANN A//K/A ANT",3,2,1
1856,4114060015,QN,90-36 PITKIN AVENUE,01,A5,"PISTONE, ALPHONSO",2,1,1
1857,4116420004,QN,114-05 115 STREET,01,B3,SINGH SANDRA,2,1,1
1858,4116540036,QN,127-15 115 AVENUE,01,A1,CLIFFORD BENTON,2,1,1
1859,4116990052,QN,117-29 135 STREET,11,V0,AMOS GRANT,2,1,1
1860,4117020001,QN,135-21 ROCKAWAY BOULEVARD,05,K1,120 VAN WYCK CORP,2,1,1
1861,4117380004,QN,133-59 117 STREET,01,A1,DANIEL & R CLARK,2,1,1
1862,4119250054,QN,109-60 141 STREET,01,B3,"NARAIN, GOKARANSINGH",2,1,1
1863,4119500370,QN,109-53 LIVERPOOL STREET,01,B3,"GREEN, ALFONZO",2,1,1
1864,4119630043,QN,111-68 LIVERPOOL STREET,01,B3,"MARBURY, NORMAN",2,1,1
1865,4120270115,QN,146-05 120 AVENUE,01,B3,NYC HOLDING GROUP LLC,2,1,1
1866,4120320051,QN,140-10 123 AVENUE,01,A1,CATHERINE CAMPBELL,2,1,1
1867,4121660016,QN,150-13 112 AVENUE,01,B3,KENRICK H. BRAMBLE,2,1,1
1868,4122000034,QN,114-35 BEDELL STREET,01,B2,"CYRUS, COLIN B",3,2,1
1869,4122120046,QN,150-41 121 AVENUE,01,A2,"WILLIAM ALEXANDER, JR.",2,1,1
1870,4122480012,QN,161-12 119 ROAD,01,A1,"QUITO, ANTHONY",2,1,1
1871,4123690050,QN,168-29 119 AVENUE,01,B3,"MORFE, BIENVENIDO",2,1,1
1872,4123850062,QN,120-65 BEDELL STREET,06,E9,YK EQUITIES LLC,2,1,1
1873,4124490004,QN,185-15 BAISLEY BOULEVARD,08,M1,ST CATH SIENNA R C CH,3,2,1
1874,4127100027,QN,196-02 122 AVENUE,01,B3,"HENDERSON, GREGORY",2,1,1
1875,4127230001,QN,133-30 SPRINGFIELD BLVD,05,K1,SPRING-MERRICK REALTY,2,1,1
1876,4127270074,QN,190-06 WILLIAMSON AVENUE,01,A1,"WRIGHT-GRAY, MANGELA",2,1,1
1877,4131840012,QN,139-47 229 STREET,01,A1,"SPARKS, NICOYA",2,1,1
1878,4132700038,QN,165-24 144 AVENUE,01,A1,"SEERAJ, RAMRAJIE",2,1,1
1879,4132720047,QN,44-37 166 STREET,01,A1,"GEORGE, ALBERT",2,1,1
1880,4134610029,QN,227-15 147 AVENUE,01,A1,"NOEL, GISLENE",2,1,1
1881,4134840006,QN,227 STREET,07,U9,NYC DEPARTMENT OF ENVIRONMENTAL PROTECTION,2,1,1
1882,4134970005,QN,227-11 145 AVENUE,01,A2,JAMES MARGIE,2,1,1
1883,4135010083,QN,144-19 230 PLACE,01,B2,"HICKS, TIMOTHY N",2,1,1
1884,4135710052,QN,243-26 WELLER AVENUE,01,B3,"AHLUWALIA, CHARANPREET S",2,1,1
1885,4135730009,QN,141-28 247 STREET,01,B2,"SATCHELL, CARLENE",2,1,1
1886,4136600037,QN,253-06 CRAFT AVENUE,02,C0,"JONES, OWEN C K",2,1,1
1887,4136830056,QN,259-30 147 ROAD,01,B2,"ALBERT, DIANA",2,1,1
1888,4137330046,QN,235-32 148 ROAD,01,B3,OLUMUYIWA DURODOLA,2,1,1
1889,4139800052,QN,158-23 81 STREET,01,A1,"MYKYTENKO, TATIANA",2,1,1
1890,4141620067,QN,101-20 157 AVENUE,01,A1,HUGHES DAVID,2,1,1
1891,4142501461,QN,99-34 164 AVENUE,01,A1,"ACCARDI, SALVATORE",2,1,1
1892,4154560003,QN,730 CHURCH ROAD,01,A2,"KEANE, PETER",2,1,1
1893,4154600019,QN,811 CHURCH ROAD,01,A2,"MALLAZZO, ANTHONY M",2,1,1
1894,4155040026,QN,1324 VIRGINIA STREET,01,B2,"PLOTKIN, DAVID",2,1,1
1895,4155100052,QN,10-14 MOSS PLACE,01,B2,ROBERT S FRANK,2,1,1
1896,4155700121,QN,7-39 HENRY ROAD,01,A1,"BISTRICER, DAVID",2,1,1
1897,4156630057,QN,13-94 GIPSON STREET,01,A1,BARBARA PERRY,2,1,1
1898,4157820007,QN,2-76 WATJEAN COURT,02,C0,"WATJEAN, LLC",2,1,1
1899,4160580034,QN,72-48 ALMEDA AVENUE,01,B2,"SURILLO, NELSON",2,1,1
1900,4160880001,QN,73-17 BEACH CHANNEL DRIVE,05,K1,7301 BC LLC,2,1,1
1901,4161550080,QN,229 BEACH 99 STREET,02,C0,B&B REALTY DEVELOPME,2,1,1
1902,4161580037,QN,3-15 BEACH 102 STREET,01,A5,"MILLER, JOSEPH A JR",2,1,1
1903,4162170005,QN,121-11 NEWPORT AVENUE,01,B1,"DIVINEY, MICHAEL KILIAN",2,1,1
1904,4162450030,QN,5-17 BEACH 133 STREET,01,A1,CAROL HOLDEN,2,1,1
1905,4162790085,QN,178 BEACH 135 STREET,01,A1,"WEISS, JERRY",2,1,1
1906,4162820076,QN,164 BEACH 138 STREET,01,B2,FAYNKIKH BORIS,2,1,1
1907,4163020024,QN,325 BEACH 145 STREET,01,A1,KEITH R. BROWN CO-TRUSTEE,2,1,1
1908,5001140052,SI,100 CASTLETON AVENUE,08,I6,VERRAZANO REALTY COMP,2,1,1
1909,5001320203,SI,111 WALBROOKE AVENUE,01,A1,FRANK S CRANE,2,1,1
1910,5001610103,SI,199 NORTH BURGHER AVENUE,01,B2,RONALD WILLIAMS,2,1,1
1911,5001980048,SI,93 TAYLOR STREET,01,A1,"JOHN EDWARD ADDAMAN, CO- TRUSTEE",2,1,1
1912,5002270105,SI,45 CORNELL AVENUE,01,A2,JANET MILLER,2,1,1
1913,5002350022,SI,878 DELAFIELD AVENUE,10,G0,"WECKERLE, KAREN",2,1,1
1914,5002500035,SI,50 UNIVERSITY PLACE,01,A1,"JOSEPH M. PORCELLO, AS TRUSTEE",2,1,1
1915,5002920045,SI,151 MATHEWS AVENUE,01,A1,TIMOTHY KEARNS,2,1,1
1916,5003500028,SI,547 MANOR ROAD,01,B1,"SARMIENTO, SANDRA",2,1,1
1917,5003570158,SI,309 KINGSLEY AVENUE,01,A1,"MEAGHER, MICHAEL",2,1,1
1918,5003710053,SI,1795 VICTORY BOULEVARD,05,K1,"VALFAN REALTY, LLC",2,1,1
1919,5003780038,SI,152 COALE AVENUE,01,A5,"NEDUMANNIL, GEORGE",2,1,1
1920,5004750079,SI,334 CRYSTAL AVENUE,01,A9,WARREN BOYLE,2,1,1
1921,5005160074,SI,14 JACKSON STREET,01,A1,MICHELLE R ROLLER,2,1,1
1922,5005370001,SI,2 HYGEIA PLACE,01,B2,OLUBUNMI OLUSHINA,2,1,1
1923,5005420042,SI,45 TARGEE STREET,01,A1,"HOPKINS, ERIC D",2,1,1
1924,5005680034,SI,294 TARGEE STREET,01,A5,"DENG, ZHAOHUI",2,1,1
1925,5005870150,SI,25 HOWARD AVENUE,01,A3,"HEDAYATI, ABDOLELLAH",2,1,1
1926,5005930042,SI,38 THERESA PLACE,01,A1,DOWNING CYD,2,1,1
1927,5006890321,SI,543 VALLEYVIEW PLACE,01,A3,543 VALLEYVIEW PLACE,2,1,1
1928,5006950056,SI,10 MOONLIGHT COURT,01,B2,ZBIGNIEW GAJEWSKI,2,1,1
1929,5007250082,SI,126 QUINLAN AVENUE,01,A2,"AKERMAN, MARIE",2,1,1
1930,5008700013,SI,1551 RICHMOND ROAD,05,O7,INTERSTATE DEVELOPMENT L P,2,1,1
1931,5010430057,SI,55 DECKER AVENUE,01,B3,ANTHONY BELFIORE,3,2,1
1932,5010440065,SI,383 HEBERTON AVENUE,01,B3,"ETIENNE, JOE",2,1,1
1933,5010440129,SI,110 DECKER AVENUE,01,A1,PECORALE VINCENT J,2,1,1
1934,5011390058,SI,704 PORT RICHMOND AVENUE,01,B1,IZET KRAJA,2,1,1
1935,5011460022,SI,50 MURDOCK PLACE,01,A5,"PEREZ, ALBERTO",2,1,1
1936,5011520013,SI,183 PULASKI AVENUE,01,A1,"YESEPKIN, ARKADI",2,1,1
1937,5012250004,SI,69 BUSH AVENUE,01,A1,"LIN, JIN XI",2,1,1
1938,5012430050,SI,150 HARBOR ROAD,01,A2,"MUNIZ VIDALS, ARIEL",2,1,1
1939,5012460069,SI,226 HARBOR ROAD,01,A1,MARIA FABBROCILE,2,1,1
1940,5012460097,SI,282 HARBOR ROAD,01,A1,"COLSON, LINDA",2,1,1
1941,5012570081,SI,242 GRANDVIEW AVENUE,01,A1,JEFFREY D'ALBERO,2,1,1
1942,5015150050,SI,504 WEST CASWELL AVENUE,01,A2,PRIMONT AMANDA,2,1,1
1943,5015160043,SI,33 SUMNER AVENUE,01,A5,"ZHOU, YOUPING",2,1,1
1944,5016820092,SI,38 ELEANOR PLACE,01,A5,ANTHONY CROSLAND,2,1,1
1945,5021400225,SI,193 SIGNS ROAD,01,B1,BARRY A CANOVAS,4,3,1
1946,5029650011,SI,183 CHESTNUT AVENUE,01,B2,CHESTNUT COUTR,2,1,1
1947,5030710075,SI,12 JUDITH COURT,01,A5,KIT FEI LO,2,1,1
1948,5030740072,SI,32 WADSWORTH AVENUE,01,A1,"JOB, UY SY",2,1,1
1949,5030870001,SI,57 CLEVELAND PLACE,08,W2,NEW YORK CITY SCHOOL CONSTRUCTION AUTHOR ITY,18,17,1
1950,5032660031,SI,60 SAND LANE,01,A2,"60 SAND, LLC",2,1,1
1951,5033010018,SI,70 ALTER AVENUE,01,B1,"MINUCCI, JOHANNA",2,1,1
1952,5033350009,SI,236 DELAWARE AVENUE,01,A2,C GULLA,2,1,1
1953,5033450046,SI,243 LIBERTY AVENUE,01,B1,RALPH A PALMA,2,1,1
1954,5033960021,SI,312 NORWAY AVENUE,01,A5,WOJCIECH ZADROZNY,2,1,1
1955,5035620076,SI,58 ADAMS AVENUE,01,A1,WM F MINETT JR,2,1,1
1956,5037250001,SI,408 HUNTER AVENUE,01,A1,"PORRETTA, RICHARD",2,1,1
1957,5040690036,SI,116 HETT AVENUE,01,A1,RENUKA CHADHA,2,1,1
1958,5041990012,SI,55 NEW DORP PLAZA,05,K1,"CHI, XIN YI",2,1,1
1959,5042190052,SI,280 NEW DORP LANE,05,K1,LAANRO REALTY INC,2,1,1
1960,5042640040,SI,81 CEDARVIEW AVENUE,01,B2,PARKER GENEE,2,1,1
1961,5043090113,SI,18 DALE AVENUE,01,A5,PAUL B. CORIGLIANO,2,1,1
1962,5045890001,SI,545 GREAVES AVENUE,01,A5,PHILIP MATTHEWS,2,1,1
1963,5051120025,SI,26 KEEGANS LANE,01,A1,"MAZZEI, GERARDO",2,1,1
1964,5051390020,SI,25 OCEAN ROAD,01,A2,"OLSEN, DOUGLAS",2,1,1
1965,5051450011,SI,35 NELSON AVENUE,01,A1,DONALD MILEY,2,1,1
1966,5054940088,SI,630 ARTHUR KILL ROAD,07,G3,"630 SNF, LLC",2,1,1
1967,5056870196,SI,32 ANNADALE ROAD,01,B2,SPANO MARIE G,2,1,1
1968,5062380047,SI,175 VINELAND AVENUE,01,B9,NARCISA PANNONE,2,1,1
1969,5062620012,SI,194 JEFFERSON BOULEVARD,08,W1,NYC DEPARTMENT OF EDUCATION,4,3,1
1970,5063380132,SI,621 RENSSELAER AVENUE,01,A1,"GIARRATANO, ERIC",2,1,1
1971,5065720027,SI,65 TUCKAHOE AVENUE,01,B2,"MANCINI, JOANNE",2,1,1
1972,5069010015,SI,384 ASHLAND AVENUE,01,B2,CATALANO CHRISTOPHER,2,1,1
1973,5070760087,SI,1527 WOODROW ROAD,01,A1,JOHN F FLYNN,2,1,1
1974,5072060130,SI,220 INDUSTRIAL LOOP,06,E2,JABE CONTRACTING LLC,2,1,1
1975,5072060235,SI,2917 ARTHUR KILL ROAD,06,E1,PLATINUM MOBILE 1 CORP.,2,1,1
1976,5075720121,SI,117 MADSEN AVENUE,01,B2,"AMODIO, JOHN",2,1,1
1977,5078530080,SI,42 JOLINE AVENUE,01,A1,"RIZZO, MARY ANN",2,1,1
1978,5078850078,SI,365 CHELSEA STREET,11,V0,"MOLINELLI, PETER",2,1,1
1979,5080220081,SI,138 FISHER AVENUE,01,A2,MARK  D'AMBROSI,2,1,1
1980,5080460013,SI,7447 AMBOY ROAD,05,O7,"PIZZO, PAUL",7,6,1
1981,1001600021,MN,474 PEARL STREET,08,Z1,NYC DEPARTMENT OF CITYWIDE ADMINISTRATIVE SERVICES,2,1,1
1982,1002230028,MN,452 GREENWICH STREET,04,S5,MCCARTHY SEAN,2,1,1
1983,1005720054,MN,21 WEST 8 STREET,04,C7,"21-23-25 WEST 8TH STREET, LLC",2,1,1
1984,1006080074,MN,169 WEST 12 STREET,03,D4,171 W 12 ST INC,2,1,1
1985,1007430080,MN,160 9 AVENUE,02,C6,NINTH AVENUE APARTMENT CORP,5,4,1
1986,1008000023,MN,127 WEST 24 STREET,05,O6,THE HORNE BUILDING OWNERS CORP,2,1,1
1987,1011417501,MN,104 WEST 70 STREET,04,RM,WALTON CONDOMINIUM,2,1,1
1988,1012240013,MN,149 WEST 93 STREET,02,C6,OLD RIDGE INC,8,7,1
1989,1013190104,MN,203 EAST 45 STREET,05,K2,203 E 45TH MANAGEMENT LLC,2,1,1
1990,1014720034,MN,440 EAST 78 STREET,03,D1,BEDFORD REAL ESTATE PARTNERS LLC,2,1,1
1991,1016910004,MN,1912 1 AVENUE,04,D6,NYC HEALTH AND HOSPITALS CORPORATION,2,1,1
1992,1018650001,MN,1021 AMSTERDAM AVENUE,08,M1,THE CATHEDRAL CHURCH OF ST. JOHN THE DIV INE,8,7,1
1993,1018840036,MN,1064 AMSTERDAM AVENUE,08,I6,AMSTERDAM NURSING HOME CORPORATION (1992 ),2,1,1
1994,1020040102,MN,2328 JOE DIMAGGIO HIGHWAY,05,K2,"2328 ON TWELFTH,",3,2,1
1995,1020510120,MN,220 EDGECOMBE AVENUE,02,C5,MODLE BATES CORP.,2,1,1
1996,1021360052,MN,19 FT WASHINGTON AVENUE,03,D1,21 FT. WASHINGTON AVENUE  CA HDFC,2,1,1
1997,2023400372,BX,303 RIDER AVENUE,,Z9,"RIDER REALTY,    .",2,1,1
1998,2023470038,BX,145 EAST 149 STREET,04,K4,EAST 149 REALTY CORP.,2,1,1
1999,2024020005,BX,726 COURTLANDT AVENUE,04,S9,COURTLANDT AVENUE REALTY LLC,3,2,1
2000,2024500040,BX,1261 MORRIS AVENUE,08,Y1,FIRE DEPARTMENT OF NEW YORK,2,1,1
2001,2025770060,BX,453 WALES AVENUE,01,B9,JR & R AUTO REPAIR CENTER LLC,3,2,1
2002,2025990092,BX,1040 EAST 149 STREET,06,F8,"BUCKEYE TERMINALS, LLC",4,3,1
2003,2026120007,BX,1276 FULTON AVENUE,08,I1,BRONX-LEBANON HOSPITAL CENTER,3,2,1
2004,2026670080,BX,780 EAST 161 STREET,01,B2,RICARDO NAVARRETE M SANCHEZ,2,1,1
2005,2027680251,BX,543 MANIDA STREET,11,V1,543 MANIDA LLC,2,1,1
2006,2028660070,BX,82 MACOMBS ROAD,08,W1,NYC DEPARTMENT OF EDUCATION,2,1,1
2007,2030680120,BX,2018 LAFONTAINE AVENUE,02,C0,"MENA, HECTOR",2,1,1
2008,2030780041,BX,2496 HUGHES AVENUE,02,C1,HUGHES GARDENS LLC,2,1,1
2009,2030780048,BX,620 EAST FORDHAM ROAD,05,K7,JB CAMPUS REALTY LTD,2,1,1
2010,2030890067,BX,693 EAST 183 STREET,01,B2,"SEGARRA, SEGUNDO B",2,1,1
2011,2031060055,BX,761 EAST TREMONT AVENUE,05,K1,STRONG EQUITIES INC,4,3,1
2012,2032560094,BX,2759 KINGSBRIDGE TERRACE,01,B1,"MONCION, PEDRO",2,1,1
2013,2032890010,BX,2782 POND PLACE,01,B3,"SUAREZ, LUIS D",2,1,1
2014,2033950045,BX,4219 PETERS PLACE,01,A1,"MARGARET A. YNGSTROM, TRUSTEE",2,1,1
2015,2034290320,BX,408 HARDING PARK,01,A2,"NUNEZ, ROSA",2,1,1
2016,2036530050,BX,1630 BRUCKNER BOULEVARD,05,K6,G & T CONSULTING CO,6,5,1
2017,2036920070,BX,2221 HERMANY AVENUE,01,A1,"TORRES, HECTOR JR",2,1,1
2018,2036990031,BX,2346 QUIMBY AVENUE,01,B2,HARDYAL SOOKDEO,2,1,1
2019,2037360068,BX,1131 COLGATE AVENUE,02,C0,VALENTIN ZOILA,2,1,1
2020,2040350003,BX,756 MORRIS PARK AVENUE,04,S2,"SALVATORE DESIENO, INC.",2,1,1
2021,2040660016,BX,1569 HAIGHT AVENUE,01,B1,"STOJKU, ARBER",2,1,1
2022,2040660018,BX,1563 HAIGHT AVENUE,01,B3,"GALANTE, ANTHONY SR.",2,1,1
2023,2041920045,BX,1827 PILGRIM AVENUE,02,C0,"LIN, HUI",2,1,1
2024,2043640038,BX,1070 WARING AVENUE,01,B1,"RODRIGUEZ, MARIAM",2,1,1
2025,2044620037,BX,2582 TENBROECK AVENUE,01,A5,"FLORES, YESENIA A",2,1,1
2026,2044760069,BX,2535 FENTON AVENUE,01,A1,"MERCORA, JOSEPH",2,1,1
2027,2044810119,BX,2559 WOODHULL AVENUE,01,A5,"NGUYEN, HAU",2,1,1
2028,2044870015,BX,2530 WESTERVELT AVENUE,01,B3,"PERSICHILLI, DOMENICO",2,1,1
2029,2045270041,BX,1290 ARNOW AVENUE,02,C0,"GONZALEZ, RAFAEL",2,1,1
2030,2045280025,BX,2731 YOUNG AVENUE,01,B3,"ROBERTS-BUREY, PANCHETA P",2,1,1
2031,2045670125,BX,2915 O'NEILL PLACE,01,B1,"TEJADA, DAMIAN",2,1,1
2032,2045880019,BX,3032 BOUCK AVENUE,01,B2,"ALVAREZ CHAMBA, CLAUDIO E",2,1,1
2033,2046650014,BX,765 EAST 217 STREET,01,B2,"JOACHIM, ERIC",2,1,1
2034,2046760035,BX,811 EAST 217 STREET,01,B3,BX 217 LLC,2,1,1
2035,2047910032,BX,1831 ARNOW AVENUE,01,B2,"SURIEL, YANIRA D",2,1,1
2036,2048330018,BX,675 EAST 230 STREET,01,B1,"AUSTIN, HETTY",2,1,1
2037,2048330020,BX,673 EAST 230 STREET,01,A1,"NARAYANAN, CHRISTOPHER J",2,1,1
2038,2048490030,BX,813 EAST 224 STREET,01,B2,"REID, MARCUS S",2,1,1
2039,2048580001,BX,968 EAST 223 STREET,01,B1,"MURSHED, NAJEEB A",2,1,1
2040,2048850062,BX,3414 ELY AVENUE,01,B1,JENNY DISTIN,2,1,1
2041,2048980070,BX,1244 EAST 224 STREET,02,C0,"SAM, GREGORY L",2,1,1
2042,2049420143,BX,3655 HARPER AVENUE,01,B2,"WARDALLY, TERRENCE",2,1,1
2043,2049990009,BX,4256 BYRON AVENUE,01,B2,"DALDAN, INC.,",2,1,1
2044,2050390072,BX,684 EAST 237 STREET,01,B2,"THOMAS, KENNETH L",2,1,1
2045,2053450019,BX,3200 WATERBURY AVENUE,01,A2,"MARYANN FINOCCHI, TRUSTEE",2,1,1
2046,2053500040,BX,3110 EAST TREMONT AVENUE,04,S3,RUI WEN HE,2,1,1
2047,2053980050,BX,1416 HOBART AVENUE,01,B3,AURORA IMPERIA,2,1,1
2048,2054140002,BX,1454 STADIUM AVENUE,01,B1,"MEDINA, ANDRE",2,1,1
2049,2054160176,BX,3277 AMPERE AVENUE,04,S1,GOULAS JIMMY,3,2,1
2050,2055290417,BX,44 PENNYFIELD AVENUE,01,B1,ANGELISI ALFONSO,2,1,1
2051,2055370112,BX,952 BALCOM AVENUE,01,A5,ANNA GUADAGNO,2,1,1
2052,2055430020,BX,3594 EAST TREMONT AVENUE,05,O7,THROGGS NECK URGENTCARE CORP.,2,1,1
2053,2055620061,BX,2886 ROOSEVELT AVENUE,11,V1,2886 ROOSEVELT LLC,2,1,1
2054,2056270009,BX,28 SCHOFIELD STREET,01,A1,"DOYLE, JAMES J.",2,1,1
2055,2056340019,BX,453 CITY ISLAND AVENUE,05,K1,459 REALTY CORP,5,4,1
2056,2056380104,BX,167 ROCHELLE STREET,01,B1,167 ROCHELLE STREET LLC,2,1,1
2057,3003880031,BK,300 BERGEN STREET,07,G5,98 THIRD AVENUE REALTY LLC,2,1,1
2058,3006340064,BK,201 19 STREET,01,B9,"LEVINSON, ANDREW NEWMAN",2,1,1
2059,3006350010,BK,60 20 STREET,06,E1,GG MASTER REALTY LLC,2,1,1
2060,3008730055,BK,289 18 STREET,01,B2,"AVIDOR, MAOR",2,1,1
2061,3008970052,BK,275 22 STREET,01,B3,JAIME LUPERCIO,2,1,1
2062,3010020025,BK,140 8 STREET,02,C3,"KRASE, KATHRYN S",2,1,1
2063,3012570007,BK,257 BROOKLYN AVENUE,01,B9,"KIRSCHBAUM, DANIEL",4,3,1
2064,3012720006,BK,792 EASTERN PARKWAY,08,P7,TZIVOS HASHEM INC,2,1,1
2065,3012850034,BK,1404 PRESIDENT STREET,01,A1,RUTH BACKER,2,1,1
2066,3012990028,BK,456 CROWN STREET,08,M1,BAIS ISRAEL OF CROWNHEIGHTS,2,1,1
2067,3013420066,BK,1703 DEAN STREET,03,D1,DEAN STREET PROJECT LLC,2,1,1
2068,3014270020,BK,830 EMPIRE BOULEVARD,04,D6,800-830 EMPIRE BLVD LLC,2,1,1
2069,3014280016,BK,666 LEFFERTS AVENUE,01,B1,REUVEN KOMAROVSKY,2,1,1
2070,3014530024,BK,1976 BERGEN STREET,01,B1,"ASHMAN , DAVID",2,1,1
2071,3016050027,BK,412 KOSCIUSZKO STREET,01,B2,"WEN, SIYI",2,1,1
2072,3017820040,BK,373 KOSCIUSZKO STREET,01,B9,"ARCHER, MARLENE",2,1,1
2073,3023830007,BK,10 HOPE STREET,05,K1,10 HOPE STREET,2,1,1
2074,3024880011,BK,90 CLAY STREET,02,C1,90 CLAY LLC,2,1,1
2075,3027700024,BK,319 GRAHAM AVENUE,04,D7,ONE GRAHAM LLC,2,1,1
2076,3027750038,BK,107 POWERS STREET,01,B9,FLORA MINICHIELLO REVOCABLE TRUST,2,1,1
2077,3027800016,BK,78 POWERS STREET,02,C2,"NIEWINSKI, PIOTR",2,1,1
2078,3028150001,BK,512 GARDNER AVENUE,06,E9,"R.L.R. INVESTMENTS, L",2,1,1
2079,3028360011,BK,96 LOMBARDY STREET,06,E9,301 WOODCLEFT AVENUE LLC,3,2,1
2080,3028430001,BK,115 DIVISION PLACE,06,E1,"115 DIVISION PLACE,",3,2,1
2081,3028660031,BK,244 FROST STREET,02,C1,"244 FROST, LLC",2,1,1
2082,3029190032,BK,15 JUDGE STREET,02,C1,"15 JUDGE STREET, LLC",2,1,1
2083,3032460005,BK,179 WILSON AVENUE,08,Y2,NYC POLICE DEPARTMENT,2,1,1
2084,3032560007,BK,1349A MYRTLE AVENUE,04,S1,"ALBARRACIN, MIGUEL",2,1,1
2085,3034730001,BK,1603 BUSHWICK AVENUE,04,S1,2104 HUGHES AVE.  CORP.,2,1,1
2086,3034740027,BK,1610 BUSHWICK AVENUE,07,G3,1610 LLC,3,2,1
2087,3034870067,BK,58 SUNNYSIDE AVENUE,01,B1,"FRANKO, NICHOLAS P",2,1,1
2088,3035960011,BK,887 SARATOGA AVENUE,02,C0,"LANGAIGNE, TITO A",2,1,1
2089,3037580027,BK,334 BRADFORD STREET,01,B2,334 BRADFORD STREET LLC,2,1,1
2090,3039120038,BK,20 HIGHLAND PLACE,02,C0,LEONARDI MARIA L,2,1,1
2091,3039500043,BK,2875 ATLANTIC AVENUE,05,K2,"SALETA-STEVENSON ENTERPRISES, INC.",2,1,1
2092,3039550004,BK,193 ELTON STREET,01,A1,"DE JESUS, FRANCISCO",2,1,1
2093,3039830026,BK,300 ASHFORD STREET,01,B2,THE O. VALENTINE 'EL TRUST,2,1,1
2094,3040700046,BK,386 ATKINS AVENUE,01,B1,"USHER-BAUN, TARA",2,1,1
2095,3041080130,BK,37 AUTUMN AVENUE,01,B2,PINKY RAMCHARAN IRREVOCABLE TRUST,2,1,1
2096,3041270012,BK,165 RICHMOND STREET,04,S1,SNT PROPERTIES CORP,2,1,1
2097,3042130001,BK,2709 PITKIN AVENUE,02,C1,MHANY 2011 HOUSING DEVELOPMENT FUND CORP ORATION,13,12,1
2098,3042940016,BK,28 MALTA STREET,01,B1,"WILLIAMS, JAMES F",2,1,1
2099,3043350011,BK,830 CLEVELAND STREET,01,B2,"JONES, CARROLL",2,1,1
2100,3045290041,BK,945 CRESCENT STREET,01,B9,"SUS-DEVELOPMENTAL DISABILITIES SERVICES,  INC.",2,1,1
2101,3046450032,BK,340 EAST 91 STREET,02,C3,MARRIOTT JOEL,2,1,1
2102,3047620048,BK,663 EAST 51 STREET,01,A2,GRANT  MURIEL,2,1,1
2103,3048480032,BK,623 LENOX ROAD,01,B9,"GOLD, RACHEL E",2,1,1
2104,3048650019,BK,314 EAST 45 STREET,01,B2,"HIGHLAND, LISA",2,1,1
2105,3048660022,BK,318 EAST 46 STREET,01,A9,"316 EAST 46, LLC",2,1,1
2106,3049710049,BK,3703 FOSTER AVENUE,01,A9,THE INGRID S. CLARK IRREVOCABLE LIVING T RUST,2,1,1
2107,3049730004,BK,3908 AVENUE D,01,A9,"KEITH, MCDONALD",2,1,1
2108,3051110020,BK,2734 SNYDER AVENUE,03,D3,SNYDER RESIDENCE LLC,2,1,1
2109,3052140019,BK,2717 NEWKIRK AVENUE,01,B2,FRITZ EMMANUEL,2,1,1
2110,3053450031,BK,1468 40 STREET,01,B1,SAMUEL ROTH,2,1,1
2111,3053630023,BK,1534 41 STREET,01,B2,"GUTTMANN, SARAH",2,1,1
2112,3053810014,BK,1620 41 STREET,02,C3,1620 41 STREET REALTY CORP,2,1,1
2113,3054940035,BK,1814 55 STREET,02,C3,CONGREGATION BETH M/GLUG,2,1,1
2114,3055040055,BK,1755 59 STREET,01,B1,"HERZOG, MORDECHAI",2,1,1
2115,3055100015,BK,1620 59 STREET,01,A9,"TYBERG, ABRAHAM",3,2,1
2116,3055520043,BK,1680 65 STREET,01,B3,"LI, XI LI",2,1,1
2117,3056010047,BK,971 44 STREET,01,B1,"AHMED, FAYEZ S",2,1,1
2118,3056050029,BK,1340 43 STREET,01,B1,JACOB JEREMIAS,2,1,1
2119,3056450053,BK,965 51 STREET,02,C3,"SCHWARTZ, LOUIS",2,1,1
2120,3056900018,BK,1232 56 STREET,02,C0,"SEGELBAUM, GITTLE",2,1,1
2121,3059430024,BK,640 BAY RIDGE PARKWAY,01,A5,"LIGUORI, NICHOLAS F",2,1,1
2122,3059640072,BK,959 78 STREET,01,B1,FRANC BRUNO,2,1,1
2123,3060060057,BK,245 83 STREET,01,A1,PRG78 LTD.,2,1,1
2124,3061410059,BK,272 DAHLGREN PLACE,02,C0,"SWEENY, MICHELLE",3,2,1
2125,3061960024,BK,2042 72 STREET,01,B1,"BERARDINELLI, DOMENICO",2,1,1
2126,3062070019,BK,2032 73 STREET,01,B2,"LIANG, LIAN ZHEN",2,1,1
2127,3062450027,BK,1444 77 STREET,01,B3,ANN MARIE CRISCIONE,2,1,1
2128,3062580014,BK,1520 78 STREET,01,B1,"CHEN, QI PING",2,1,1
2129,3063910017,BK,8741 14 AVENUE,01,B9,SORCI FAMILY IRREVOCABLE LIVING TRUST,2,1,1
2130,3064050040,BK,8738 19 AVENUE,01,B2,YUEN CHEUNG,2,1,1
2131,3064157501,BK,102 BAY 31 STREET,02,R3,UNAVAILABLE OWNER,2,1,1
2132,3065350040,BK,1186 EAST 10 STREET,01,A1,"BLOCK, JUDITH S",2,1,1
2133,3065360058,BK,1169 EAST 10 STREET,01,A9,ZALMAN ARYEAH KOPEL,2,1,1
2134,3065420040,BK,1364 EAST 7 STREET,01,B2,"TAUB, YISROEL DOVID",2,1,1
2135,3065430039,BK,1282 EAST 8 STREET,01,A9,SAMSTEIN JORDAN,2,1,1
2136,3065430062,BK,1359 EAST 7 STREET,01,B1,"CHETRIT, ABRAHAM",2,1,1
2137,3065700079,BK,1407 EAST 7 STREET,01,A9,"EIDA, MAURICE",2,1,1
2138,3065700085,BK,1393 EAST 7 STREET,01,A1,JOSEPH SHAMAH,2,1,1
2139,3065910042,BK,1480 EAST 10 STREET,01,A1,"BETESH, STANLEY",2,1,1
2140,3065970006,BK,54 AVENUE O,08,M1,CONG BNAI ISAAC MAPLE,3,2,1
2141,3066090038,BK,1672 EAST 3 STREET,01,A9,"MANSOUR, RAPHAEL",2,1,1
2142,3066130074,BK,1551 OCEAN PARKWAY,01,A5,"NACHMANI , YAFFA",2,1,1
2143,3066230061,BK,1641 WEST 9 STREET,02,C0,"CONG, JOANNE",2,1,1
2144,3066420062,BK,1641 EAST 10 STREET,01,A9,"SAFDIEH, MENASHE SONNY",2,1,1
2145,3066600035,BK,1852 EAST 4 STREET,01,A9,HABER RALPH,2,1,1
2146,3066780097,BK,43 KINGS PLACE,01,A1,GORODETSKAYA YEVGENIYA,2,1,1
2147,3066950048,BK,1249 CONEY ISLAND AVENUE,06,E7,"SNL XI, LLC",2,1,1
2148,3067577502,BK,1924 OCEAN AVENUE,03,R4,UNAVAILABLE OWNER,2,1,1
2149,3067840024,BK,1698 EAST 22 STREET,01,A1,"ABBERBOCK, JUDY",2,1,1
2150,3068090061,BK,1783 EAST 26 STREET,01,A1,"CAZO-COHEN, ELI",2,1,1
2151,3068260022,BK,1934 EAST 21 STREET,01,A1,SIMON VAKNIN,2,1,1
2152,3069440165,BK,2000 SHORE PARKWAY,09,Q1,NYC DEPARTMENT OF PARKS AND RECREATION,4,3,1
2153,3070000059,BK,3743 NEPTUNE AVENUE,01,B2,"DENIS ZAZVONOV, AS TRUSTEE",2,1,1
2154,3070210068,BK,2849 WEST 17 STREET,08,M1,CHR MISSN OF ST JOHN,2,1,1
2155,3070850128,BK,194 VAN SICKLEN STREET,01,A1,"SUTTON , ELLIOT",2,1,1
2156,3070890039,BK,1976 EAST 8 STREET,02,C3,SIMON LEVIOV,2,1,1
2157,3071070054,BK,2115 EAST 4 STREET,01,A1,"BETESH, ELLIOT",3,2,1
2158,3071080145,BK,1920 OCEAN PARKWAY,01,B2,JB OCEAN REALTY LLC,2,1,1
2159,3071110056,BK,2063 EAST 8 STREET,01,A1,ALBERT EAST 8 ST. CORP.,2,1,1
2160,3071310015,BK,2188 EAST 5 STREET,01,A5,ZAKI HABER,2,1,1
2161,3071310024,BK,2214 EAST 5 STREET,01,B2,2214 E 5TH ST LLC,2,1,1
2162,3071320039,BK,2174 OCEAN PARKWAY,01,A1,"FATIHA, ALBIER",2,1,1
2163,3071400001,BK,76 AVENUE V,07,U9,NYC DEPARTMENT OF ENVIRONMENTAL PROTECTION,4,3,1
2164,3071730026,BK,94 STRYKER STREET,02,C3,"LEONG, KYIN FWAT",3,2,1
2165,3072130065,BK,2539 WEST 3 STREET,02,C0,"BIGNOLA, IRENE M",2,1,1
2166,3072920077,BK,1927 EAST 13 STREET,01,B1,"SCABA, JACK",2,1,1
2167,3072930068,BK,1949 EAST 14 STREET,01,A3,"MANN, DANIELA",2,1,1
2168,3073180014,BK,2020 EAST 14 STREET,02,C0,"SADIA, MAMROUT",2,1,1
2169,3073240031,BK,2518 OCEAN AVENUE,04,O8,2518 OCEAN AVENUE LLC,3,2,1
2170,3073270013,BK,2016 EAST 23 STREET,01,B3,"KAMEO, MORDI",2,1,1
2171,3073480005,BK, AVENUE U,07,U8,NYC TRANSIT AUTHORITY,2,1,1
2172,3074050749,BK,2361 EAST 27 STREET,01,B2,NAYMON LEONID,3,2,1
2173,3074290010,BK,2402 KNAPP STREET,07,G5,"KNAPP,",2,1,1
2174,3074690019,BK,4654 BEDFORD AVENUE,02,C2,ARNOM LLC,2,1,1
2175,3076080015,BK,1073 EAST 26 STREET,01,A9,FRANCISCUS MARGARET E,2,1,1
2176,3076090036,BK,1021 EAST 27 STREET,01,A1,VAISELBERG ROCHELLE,2,1,1
2177,3076220040,BK,1181 EAST 22 STREET,01,A1,SENIOR  RICHARD,2,1,1
2178,3076430055,BK,1226 EAST 26 STREET,01,A1,SHERER SUSAN,2,1,1
2179,3076670018,BK,1367 EAST 31 STREET,01,B2,"GUNSBURG, TZVI",2,1,1
2180,3076740083,BK,1586 EAST 21 STREET,01,B2,"SANTOLI, MARION",2,1,1
2181,3076800034,BK,1437 EAST 26 STREET,01,A3,"MILLER, YAAKOV",3,2,1
2182,3076880028,BK,1539 EAST 27 STREET,01,A1,MINKOFF YISRAEL,2,1,1
2183,3077100033,BK,1615 EAST 37 STREET,01,A1,"GAROMO, ROBERT",3,2,1
2184,3078220028,BK,1329 EAST 40 STREET,01,B3,JEAN GEDEON,2,1,1
2185,3078540010,BK,1389 EAST 56 STREET,02,C0,"BURNETT, GENINA",2,1,1
2186,3079030058,BK,1434 EAST 59 STREET,01,A9,"BLYDEN, GALE A",2,1,1
2187,3079040018,BK,1459 EAST 59 STREET,01,A9,"ERSKINE, DEBORAH R",2,1,1
2188,3079040076,BK,2474 RALPH AVENUE,01,A9,MARIA MA A/K/A ZIAO Q,2,1,1
2189,3080210042,BK,8416 FLATLANDS AVENUE,04,K4,EAW RUTLAND INC,3,2,1
2190,3081710037,BK,10212 FARRAGUT ROAD,01,B2,WAYNE LEACOCK,2,1,1
2191,3082440021,BK,1319 EAST 98 STREET,01,A2,S&EMANAGEMENT LLC,2,1,1
2192,3084130021,BK,2047 EAST 72 STREET,01,A9,MARTINEZ RAMON G,2,1,1
2193,3084940056,BK,1666 EAST 55 STREET,01,A9,JOAN GURRERA,2,1,1
2194,3087200014,BK,3209 CONEY ISLAND AVENUE,08,P9,"OCEANA HOMEOWNERS ASSOCIATION, INC.",3,2,1
2195,3087430009,BK,295 EXETER STREET,01,A1,"KRUM, LLC",2,1,1
2196,4000130001,QN,2 STREET,11,V9,CON EDISON,3,2,1
2197,4000310009,QN,5-41 49 AVENUE,01,B3,"LEE, HORTON JAMES",2,1,1
2198,4000380001,QN,53-01 VERNON BOULEVARD,06,E1,"SCHUMAN PROPERTIES,INC",3,2,1
2199,4003040008,QN,52-13 35 STREET,01,B2,52-13 35TH LLC,2,1,1
2200,4003400027,QN,35-04 29 STREET,02,C0,"MJH HOLDINGS, INC",2,1,1
2201,4003700001,QN,37-33 28 STREET,02,C1,37-33 28TH REALTY CORP,2,1,1
2202,4004050002,QN,27-17 41 AVENUE,02,C0,"LEE, ARAHM",3,2,1
2203,4004570175,QN,4202 21 STREET,07,G3,"ARLAK, LLC",2,1,1
2204,4005180013,QN,31-17 12 STREET,04,S2,31 17 19 1Z LLC,6,5,1
2205,4005330011,QN,14-33 31 ROAD,02,C3,JOT REALTY INC.,2,1,1
2206,4005330037,QN,14-34 31 AVENUE,03,D1,"JML CPA, LLC",2,1,1
2207,4005490036,QN,30-18 23 STREET,02,C1,"30-18 23RD STREET, LLC",2,1,1
2208,4005890136,QN,31-13 30 STREET,02,C2,KEANE ASSOCOATES LP,2,1,1
2209,4006220022,QN,32-39 34 STREET,01,B2,JOSEPH XUEREB,2,1,1
2210,4006530082,QN,25-58 38 STREET,02,C1,ZALO REALTY LLC,2,1,1
2211,4006610032,QN,28-30 38 STREET,01,B2,KUMAR ROMESH,2,1,1
2212,4007430025,QN,50-11 30 AVENUE,02,C0,"CHANCER, ALAN M",2,1,1
2213,4007590011,QN,22-43 47 STREET,01,B1,J CILENTO,2,1,1
2214,4007600029,QN,21-11 48 STREET,01,B2,"ROEMOM, LLC",2,1,1
2215,4008000002,QN,41-05 20 AVENUE,01,B2,"KASTANIS, FRANK",2,1,1
2216,4008080007,QN,21-67 37 STREET,01,A5,"INGRASSIA, MARY",2,1,1
2217,4008190012,QN,23-61 36 STREET,01,B3,MANUEL VAZQUEZ,2,1,1
2218,4008720065,QN,25-20 CRESCENT STREET,02,C1,ASAK ASSOCIATES LLC,2,1,1
2219,4011710036,QN,75-09 NORTHERN BOULEVARD,07,G4,75-15 REALTY LLC,2,1,1
2220,4011760029,QN,32-50 81 STREET,01,B1,"LEE, CHUN KONG",2,1,1
2221,4012700074,QN,35-53 70 STREET,02,C0,"KOSTNER-RERECICH, LINDA",2,1,1
2222,4013420056,QN,42-35 65 STREET,02,C1,4233 REALTY LLC,2,1,1
2223,4013920048,QN,30-21 94 STREET,01,A5,"DIAZ, LUIS H",2,1,1
2224,4013990044,QN,31-27 87 STREET,02,C0,JUAN F JEREZ,2,1,1
2225,4014060010,QN,31-10 95 STREET,01,A5,PANINERO MANAGEMENT INC.,2,1,1
2226,4014940062,QN,41-58 75 STREET,02,C3,"NILKAMHANG, SAWEG",2,1,1
2227,4015070018,QN,41-24 JUDGE STREET,01,B3,"HENRIQUEZ, GRACIELA",2,1,1
2228,4015490016,QN,86-18 BROADWAY,05,K1,KAM LUN FOOD PRODUCTS,4,3,1
2229,4015700056,QN,43-11 ITHACA STREET,08,M1,"JAIN CENTER AMER,INC",2,1,1
2230,4017730025,QN,107-13 37 DRIVE,02,C0,"PAGUAY , MANUEL",2,1,1
2231,4018530039,QN,90-58 51 AVENUE,01,B1,ELENI TZITZI,2,1,1
2232,4019440013,QN,53-16 104 STREET,01,B1,"PR & TR REALTY, LLC",2,1,1
2233,4019680029,QN,110-62A CORONA AVENUE,08,M1,"CAPILLA EVANGELICA,INC",2,1,1
2234,4022430042,QN,112-19 JEWEL AVENUE,01,A3,"JABER, FARID",2,1,1
2235,4024060028,QN,53-10 68 STREET,01,B2,ANTHONY PADRO,2,1,1
2236,4024210026,QN,67-14 51 ROAD,01,B1,"CHAN, SHU Y",2,1,1
2237,4024870003,QN,52-29 73 STREET,01,A1,JAMES M O'BYRNE,2,1,1
2238,4027290034,QN,60-44 59 ROAD,01,B2,ROBERT SCORCE,2,1,1
2239,4027520027,QN,57-53 65 STREET,01,B2,CIORCIARI DAVID J & EILEEN B,2,1,1
2240,4029070025,QN,54-48 82 STREET,01,B3,"YE, SHAN CHENG",2,1,1
2241,4031650032,QN,67-50 BURNS STREET,02,C0,"YIN, BAIHUA",2,1,1
2242,4034070054,QN,1877 GROVE STREET,02,C0,NICOLA BENENATI,2,1,1
2243,4034980057,QN,66-18 60 PLACE,02,C0,"RIPEPE, GIOACCHINO",2,1,1
2244,4036100031,QN,61-47 LINDEN STREET,02,C0,"LINDEN 47 GROUP, LLC",3,2,1
2245,4037020004,QN,67-27 COOPER AVENUE,01,B2,ELEANOR STAIB,2,1,1
2246,4037290013,QN,80-60 57 STREET,01,B3,"FODOR, KATALIN",2,1,1
2247,4038100444,QN,83-40 72 DRIVE,05,O5,GLENDALE PROPERTIES LLC,2,1,1
2248,4038340077,QN,78-59 83 STREET,01,B2,"KARWOWSKI, ROBERT",2,1,1
2249,4038820004,QN,90-39 83 AVENUE,02,C0,ROSENKRANTZ KEVIN,2,1,1
2250,4039000114,QN,91-48 71 AVENUE,01,B3,"FURST, MICHAEL",2,1,1
2251,4039240008,QN,3-35 127 STREET,01,B2,THOMAS TULLY,2,1,1
2252,4039970034,QN,13-24 123 STREET,01,B1,CHEN & HUANG REALTY LLC,2,1,1
2253,4040240044,QN,10-27 117 STREET,01,B1,"SHANG, JI LE",2,1,1
2254,4040510003,QN,14-27 116 STREET,01,B3,"JIANG, WENYU",2,1,1
2255,4041350041,QN,18-34 130 STREET,01,B2,PASSERO  ANTHONY,2,1,1
2256,4042240027,QN,23-10 121 STREET,01,B2,"MAKRIDIS, NIKOLAOS",2,1,1
2257,4042940020,QN,123-02 26 AVENUE,01,A5,"RAMOS, VICTOR M",2,1,1
2258,4043430125,QN,139-19 31 ROAD,03,D4,EMBASSY COOP INC,4,3,1
2259,4044670051,QN,2-33 148 STREET,01,A2,"OH , SUN L",2,1,1
2260,4044730088,QN,148-12 5 AVENUE,01,A2,MUSCA FAMILY TRUST,2,1,1
2261,4045380074,QN,11-10 154 STREET,04,K4,11-10/12 154TH STREET LLC,2,1,1
2262,4046320032,QN,146-29 20 ROAD,01,A1,"LANCELLOTTI, TRUSTEE, CATHY A",2,1,1
2263,4046580010,QN,147-10 23 AVENUE,01,B2,"CHEN, QUN",2,1,1
2264,4046660028,QN,149-45 17 ROAD,01,B2,"CHEN, JIAN DAN",3,2,1
2265,4047080068,QN,151-07 21 AVENUE,01,A1,"CONLON, JOSEPH C",2,1,1
2266,4047980050,QN,147-08 BAYSIDE AVENUE,08,M9,ALL GENERATIONS PRESBYTERIAN CHURCH OF N Y,2,1,1
2267,4048620043,QN,23-14 160 STREET,01,A2,"ALTAMURO, VINCENT",2,1,1
2268,4049080035,QN,163-09 32 AVENUE,01,A5,"FIRRINCIELI, SALVATORE",2,1,1
2269,4049210011,QN,29-12 168 STREET,01,A1,"REILLY, KATHLEEN M",2,1,1
2270,4049840019,QN,145-32 33 AVENUE,01,A1,RAZIQ ABDUL,2,1,1
2271,4050370092,QN,132-47 41 AVENUE,02,C3,LIN MO CHUN,2,1,1
2272,4050580003,QN,150-19 BARCLAY AVENUE,11,V0,"FOREVER 99 HOLDINGS, LLC",2,1,1
2273,4053180021,QN,36-11 194 STREET,05,K2,CLINCO REALTY CORP,2,1,1
2274,4053710047,QN,42-23 195 STREET,01,A5,"LIN, JIA QUAN",2,1,1
2275,4053750060,QN,146-19 BEECH AVENUE,08,M1,TRUE JESUS CHURCH IN FLUSHING,2,1,1
2276,4056160036,QN,196-44 47 AVENUE,01,A2,"SFAKIANOS, NICHOLAS",2,1,1
2277,4057600074,QN,166-07 21 ROAD,01,A1,SIDNEY SANDOR,2,1,1
2278,4057680015,QN,166-20 24 ROAD,01,A1,"MAGAGNA, RICHARD",2,1,1
2279,4060260025,QN,32-40 200 STREET,01,A5,KAN ALEXANDER C,2,1,1
2280,4060600017,QN,32-13 210 STREET,01,A3,YEE KEUNG CHAN,2,1,1
2281,4060740032,QN,199-13 34 AVENUE,01,A5,"BIONDOLILLO, GERALDINE A",2,1,1
2282,4060760025,QN,200-19 34 AVENUE,01,A5,"CHIFFRILLER, THOMAS",2,1,1
2283,4062110029,QN,38-14 208 STREET,01,A0,"LI, XIAOFENG",2,1,1
2284,4063530006,QN,130-08 58 AVENUE,01,B3,"ZHENG, MEI FANG",2,1,1
2285,4068390024,QN,77-30 162 STREET,08,M9,CHURCH OF HOPE IN NEW YORK,2,1,1
2286,4069630051,QN,175-12 JEWEL AVENUE,01,A5,"CHUNG, HON FAN",2,1,1
2287,4072460041,QN,182-51 AVON ROAD,01,A1,"GILKAROV, GEORGE",2,1,1
2288,4072500058,QN,184-47 TUDOR ROAD,01,A1,"ARONOFF, JOSEPH",2,1,1
2289,4073150020,QN,211-42 45 DRIVE,01,B3,"HUNTER, GEORGIA",2,1,1
2290,4078180016,QN,85-24 215 STREET,01,A1,"NG - LIM, WENDY",2,1,1
2291,4081160058,QN,40-24 247 STREET,01,A5,"STONE , MICHAEL A",2,1,1
2292,4081220023,QN,248-04 41 AVENUE,01,B2,"SUSAN VOON WONG, AS",2,1,1
2293,4087250011,QN,269-24 80 AVENUE,01,A3,"BOODHOO, RAMNAUTH",2,1,1
2294,4087500005,QN,82-12 257 STREET,01,A0,"LOPEZ, WALTER",2,1,1
2295,4088430008,QN,86-23 79 STREET,01,B2,YEVOLI DEIDRE,2,1,1
2296,4089190024,QN,84-20 JAMAICA AVENUE,04,S9,WOODHAVEN RESDNTS BL/ASN,2,1,1
2297,4090390024,QN,94-30 97 STREET,02,C0,"ROJAS, ANA",2,1,1
2298,4090950004,QN,89-10 102 ROAD,01,B9,"RAHMAN, AKBOR",2,1,1
2299,4091820013,QN,102-26 PARK LANE SOUTH,01,A1,R WOLF,2,1,1
2300,4092750035,QN,121-02 HILLSIDE AVENUE,04,S2,"HUSSAINI, SYED M",2,1,1
2301,4093270087,QN,87-33 117 STREET,01,A1,SAINI PRITAM K,2,1,1
2302,4093420007,QN,134-14 JAMAICA AVENUE,05,O2,MEDISYS HEALTH NETWOR,2,1,1
2303,4094330141,QN,115-07 103 AVENUE,01,A9,MONA LEE JONES,2,1,1
2304,4094390016,QN,93-18 123 STREET,01,B2,"DHARAM DEO, INDRA",2,1,1
2305,4095020118,QN,101-11 134 STREET,01,A1,VICTOR GARCIA,2,1,1
2306,4095320025,QN,104-38 110 STREET,01,B3,"SINGH, RISHI",2,1,1
2307,4095320035,QN,104-58 110 STREET,01,A1,BASDEO KELVIN,2,1,1
2308,4095380007,QN,115-20 LIBERTY AVENUE,04,K4,115-20 LIBERTY AVE LLC,2,1,1
2309,4096480011,QN,138-28 QUEENS BOULEVARD,04,D7,WHITE ROCK MANAGEMENT GROUP LLC,2,1,1
2310,4097080053,QN,139-65 87 AVENUE,01,A1,"BHUIYAN , TANIM",2,1,1
2311,4098180076,QN,167-18 HILLSIDE AVENUE,05,K2,SUPER FUNDING CORP,2,1,1
2312,4098390005,QN,167-11 HILLSIDE AVENUE,05,K2,ANS BROTHERS LLC,2,1,1
2313,4100620020,QN,148-14 105 AVENUE,01,B1,AMERICAN STEEL GATECP,2,1,1
2314,4102190309,QN,175-07 LIBERTY AVENUE,01,B2,"LEWIS, WINNIE",2,1,1
2315,4102260059,QN,170-19 105 AVENUE,01,B2,"RAZZAQUE , MOHAMMAD A.",2,1,1
2316,4102410021,QN,105-07 171 PLACE,01,B2,"TINEO, ERISAUL",2,1,1
2317,4103070001,QN,17610 MURDOCK AVENUE,01,A1,SYLVIA E TAYLOR,2,1,1
2318,4104050028,QN,187-43 QUENCER ROAD,01,A1,"PETERS, SHERYL ANN",2,1,1
2319,4105260117,QN,86-21 MARENGO STREET,01,A1,ZION HIA,2,1,1
2320,4105560053,QN,90-14 207 STREET,01,A1,FOULA KARRAS,2,1,1
2321,4106170064,QN,93-09 VANDERVEER STREET,01,A1,"LALLJIE, JIMMY A",2,1,1
2322,4106450080,QN,90-30 213 STREET,02,C0,KAZAL DAS,3,2,1
2323,4107380015,QN,221-64 91 ROAD,01,B2,"PRASHAR, RAJINDER K",2,1,1
2324,4109630220,QN,111-15 205 STREET,01,B3,"CAMPBELL, SHELDON",2,1,1
2325,4110350041,QN,194-47 115 DRIVE,01,A1,GREGORY GRIMES,2,1,1
2326,4112700016,QN,114-77 226 STREET,01,A5,"JEREMIAH, HEATHER",2,1,1
2327,4115010024,QN,133-18 PECONIC STREET,01,A5,FORTEZZA VITO,3,2,1
2328,4116500053,QN,114-31 123 STREET,01,A1,"NERO, CHARLES",2,1,1
2329,4116500056,QN,114-27 123 STREET,01,A1,"LATIFAN , KALLID",2,1,1
2330,4116870014,QN,116-18 132 STREET,01,B3,"THOMAS, CLAUD G",2,1,1
2331,4116980037,QN,134-09 120 AVENUE,01,A1,"BIALKO, MARGARET",2,1,1
2332,4119470163,QN,147-58 ARLINGTON TERRACE,02,C0,"MCCREE, PETAL ROBERTS",2,1,1
2333,4119540054,QN,111-27 VAN WYCK EXPRESSWAY,01,B3,SARGEANT EGINSON B,3,2,1
2334,4119690049,QN,114-31 139 STREET,01,B3,ALLEN & MARY SUE SUBER,2,1,1
2335,4120030250,QN,116-31 144 STREET,01,B3,"MOHABIR, BISONDAI",2,1,1
2336,4120220033,QN,147-21 119 AVENUE,01,B3,SALMO CORPORATION,2,1,1
2337,4121020072,QN,147-07 SUTTER AVENUE,01,A1,MICHAEL LEWIS,2,1,1
2338,4121850035,QN,114-40 155 STREET,01,A1,"NICHOLSON, TARA",2,1,1
2339,4121910014,QN,155-16 115 ROAD,01,A1,"MAZUMDER, MD IQBAL HOSSAIN",3,2,1
2340,4122040255,QN,154-17 118 AVENUE,01,A9,DANIEL & PATSY LIPFORD,2,1,1
2341,4122230001,QN,153-11 125 AVENUE,01,A2,"EJIOFOR, JOY U",2,1,1
2342,4122240001,QN,116-19 155 STREET,01,B3,"CHADNEE, SHAMSUNNAHER",2,1,1
2343,4122430029,QN,119-18 LONG STREET,01,B3,"HEMMINGS, FRANKLIN L",2,1,1
2344,4124030079,QN,115-21 172 STREET,01,A1,"CHANDISINGH, YURI",2,1,1
2345,4124700048,QN,176-25 120 AVENUE,01,A1,WILLIAM C. GRANT,2,1,1
2346,4126740080,QN,192-15 122 AVENUE,01,A1,"DADA, OLAYINKA G",2,1,1
2347,4128900002,QN, HOOK CREEK BOULEVARD,07,U9,NYC DEPARTMENT OF ENVIRONMENTAL PROTECTION,2,1,1
2348,4129610023,QN,133-23 222 STREET,01,A1,"WATSON , ROSEMARY A",2,1,1
2349,4129650009,QN,133-18 227 STREET,01,A1,ROLAND MICHEL,2,1,1
2350,4131810058,QN,138-44 233 STREET,01,A1,PHILLIPS          RONALD,2,1,1
2351,4132650150,QN,246-32 NORTH CONDUIT AVENUE,02,C0,AMOS BEARDS,2,1,1
2352,4133560023,QN,146-22 183 STREET,01,A1,"NICHOLSON, THEODORE A",2,1,1
2353,4136850010,QN,259-23 FRANCIS LEWIS BLVD,01,B3,"SANCHEZ CORDERO, ELIZABETH",2,1,1
2354,4136890017,QN,259-36 148 DRIVE,01,A2,JEAN SEBASTIAN CLAUDE,2,1,1
2355,4140130064,QN,159-04 CROSS BAY BOULEVARD,07,G3,UNAVAILABLE OWNER,2,1,1
2356,4141590018,QN,156-28 99 STREET,01,A1,"DE LIO, DOMINICK",2,1,1
2357,4142050030,QN,97-17 164 AVENUE,01,B3,"D'ANDREA, ANTHONY",2,1,1
2358,4153130004,QN,22 WEST 9 ROAD,01,A2,"KELLY, MURIEL J.",2,1,1
2359,4153180029,QN,10 WEST 13 ROAD,01,B3,STEVEN R ELLIS,2,1,1
2360,4153180061,QN,39 WEST 14 ROAD,01,A1,PROPERTY 1000 LLC,3,2,1
2361,4156910068,QN,24-22 BAYSWATER AVENUE,08,M1,BAIS MEDRASH EYUN TFILAH INC,2,1,1
2362,4157170016,QN,10-22 DICKENS STREET,01,A1,"KOBI, SHLOMO",2,1,1
2363,4159620088,QN,515 DELMORE COURT,01,A1,120-25 140TH STREET LLC,2,1,1
2364,4160530056,QN,70-18 AMSTEL BOULEVARD,04,S2,ROBINSON GARY L,2,1,1
2365,4161550083,QN,219 BEACH 99 STREET,01,A1,219 ROCK HOSPITALITY LLC,2,1,1
2366,4162070016,QN,447 BEACH 125 STREET,01,A1,"OTTON, JAMES",2,1,1
2367,4162270005,QN,117-07 ROCKAWAY BEACH BLVD,01,B3,"WOOLRIDGE, JOSEPH",2,1,1
2368,4162470043,QN,516 BEACH 136 STREET,01,B3,"SAVAGE, MARY GRACE",3,2,1
2369,4162720006,QN,2-81 BEACH 138 STREET,01,A1,ADELLE LAWRENCE,2,1,1
2370,5000010070,SI,15 BAY STREET,07,Y7,UNITED STATES OF AMERICA,2,1,1
2371,5000710087,SI,75 CLINTON AVENUE,01,A1,"DONAHUE, SARAH",2,1,1
2372,5000780097,SI,110 KISSEL AVENUE,01,A4,JAMES HAYES,2,1,1
2373,5001360001,SI,471 FOREST AVENUE,05,K7,BANCO SANTANDER S.A.,2,1,1
2374,5001780043,SI,290 NORTH BURGHER AVENUE,01,A1,"ON YOUR MARK, INC.",2,1,1
2375,5001810071,SI,497 DELAFIELD AVENUE,01,B2,"ROSADO, AIDE",2,1,1
2376,5001970020,SI,73 BARKER STREET,10,G0,"AJDINOVSKI, SABAN",2,1,1
2377,5002120001,SI,661 CARY AVENUE,07,G2,661 CARY AVE LLC,3,2,1
2378,5002230035,SI,383 CLOVE ROAD,01,A1,KRISTI A CRETELLA,4,3,1
2379,5002310037,SI,136 RAYMOND PLACE,01,A1,MICHAEL HAYES,2,1,1
2380,5002540018,SI,709 METROPOLITAN AVENUE,01,A2,"TARASIEWICZ, ALLAN",2,1,1
2381,5003560243,SI,218 MANOR ROAD,01,A2,"ZORCIK, ROBERT",2,1,1
2382,5003720012,SI,62 RAYMOND AVENUE,01,A0,"CHRISTENSEN, KEITH",2,1,1
2383,5003740079,SI,92 CONSTANT AVENUE,01,B3,DANIEL & JACQUELINE S,2,1,1
2384,5004270016,SI,23 DAKOTA PLACE,01,A1,"SURAT, ERIC",2,1,1
2385,5004580007,SI,11 SEWARD PLACE,01,B2,"WU, YIN JU",2,1,1
2386,5004780032,SI,343 WILLOWBROOK ROAD,01,A2,ARVEI NACHAL FAMILY TRUST,2,1,1
2387,5005090008,SI,478 BAY STREET,05,K2,C.W. BAY LLC,2,1,1
2388,5005260006,SI,79 BROAD STREET,02,C1,ISLAND J LLC,2,1,1
2389,5006080051,SI,75 SUNNYSIDE TERRACE,01,B2,JACK CARONE,2,1,1
2390,5006870049,SI,399 OCEAN TERRACE,01,A2,MRUDULA PAREKH,2,1,1
2391,5007020065,SI,9 AREA PLACE,01,A5,GEORGEKUTTY P SAMUEL,2,1,1
2392,5007680061,SI,52 LIVINGSTON AVENUE,01,A0,6905 REALTY CORP,2,1,1
2393,5007950037,SI,729 WILLOWBROOK ROAD,01,A9,BESNIKE CANKA,2,1,1
2394,5008490042,SI,25 VISTA AVENUE,01,A1,RICHARD ERICKSON,2,1,1
2395,5008490178,SI,15 HASBROUCK ROAD,01,A1,"FAKARIS, GEORGE",2,1,1
2396,5009480058,SI,109 BEACON AVENUE,01,A1,"HARTMAN, DIANA C",2,1,1
2397,5010080036,SI,1938 RICHMOND TERRACE,06,F5,TERRACE DEVELOPMENT LLC,4,3,1
2398,5010160028,SI,67 NEW STREET,01,A1,"JOYNER, RUTH S",2,1,1
2399,5010340001,SI,109 ANDERSON AVENUE,01,B3,MARION  NORBERG,2,1,1
2400,5010360004,SI,263 PORT RICHMOND AVENUE,05,O2,"CAMELOT OF STATEN ISLAND, INC.",3,2,1
2401,5010390011,SI,105 CORTLANDT STREET,01,A1,"TREJO, JORGE",2,1,1
2402,5010400023,SI,21 LEXINGTON AVENUE,01,A1,LORRAINE DEMARTINO,2,1,1
2403,5011160004,SI,53 JOHN STREET,01,B2,GARCIA ELEAZAR M,2,1,1
2404,5011200007,SI,15 INNIS STREET,04,S2,GERARDI FAMILY PARTNERS.LLC,2,1,1
2405,5011490052,SI,12 MORNINGSTAR ROAD,01,B9,ALEX CORTEZ,2,1,1
2406,5011590033,SI,43 LAKE AVENUE,01,A1,SYLVIA J. CASTRO,2,1,1
2407,5012220093,SI,364B VAN PELT AVENUE,01,B2,"NEW BRIGHTON PROPERTIES, LLC.",2,1,1
2408,5012340194,SI,2109 FOREST AVENUE,04,K4,2109 FOREST AVE. REALTY CORP.,2,1,1
2409,5012530006,SI,77 GRANDVIEW AVENUE,01,A1,JESSIE SMITH,2,1,1
2410,5012720403,SI,15 BENJAMIN PLACE,01,A1,WILLIALM E MORRIS,2,1,1
2411,5026340001,SI,4100 VICTORY BOULEVARD,08,W1,NYC DEPARTMENT OF EDUCATION,2,1,1
2412,5028300049,SI,2 HYLAN BOULEVARD,08,P7,NYC DEPARTMENT OF PARKS AND RECREATION,4,3,1
2413,5028440135,SI,103 CHESTNUT AVENUE,01,A1,ESNY CONSTRUCTRION SERVICES INC,2,1,1
2414,5028490005,SI,519 TOMPKINS AVENUE,02,C3,ANGELO REONEGRO,2,1,1
2415,5028620087,SI,18 BELAIR ROAD,01,A2,"HOLDER, MICHAEL J",2,1,1
2416,5032090029,SI,23 WHITNEY AVENUE,01,A1,WILLIAM ELKIK,2,1,1
2417,5032520043,SI,317 NORWAY AVENUE,01,B2,"AJMAL, FAIZAN L",2,1,1
2418,5032790001,SI,37 FOCH AVENUE,01,B2,"ANBINDER, POLINA",2,1,1
2419,5033500030,SI,1416 HYLAN BOULEVARD,07,G4,PHILIP BLESSINGER,2,1,1
2420,5034180025,SI,7 LAVA STREET,01,A5,"LI, QINBIN",2,1,1
2421,5035300100,SI,96 LIBERTY AVENUE,01,A2,PATRICK DELLA DONNA,2,1,1
2422,5035980043,SI,21 BRYANT AVENUE,01,A1,JOHN J LEAHY,2,1,1
2423,5040070220,SI,325 PENN AVENUE,01,A2,ANNA CARTER,2,1,1
2424,5040430081,SI,64 WINHAM AVENUE,01,A2,"FREEO, STEPHEN A",2,1,1
2425,5044780284,SI,153 COTTER AVENUE,01,A9,JOSEPH VENEZIANO,2,1,1
2426,5051560017,SI,88 MONTICELLO TERRACE,01,A1,"PIROZZI, ANGELO",2,1,1
2427,5052490021,SI,11 OCEANVIEW PLACE,01,A1,"VINCENT CANGIANO, TRUSTEE",2,1,1
2428,5052760049,SI,4085 HYLAN BOULEVARD,05,K2,MARAT ETELZON,3,2,1
2429,5052760053,SI,4091 HYLAN BOULEVARD,04,K4,G-T-B-II HYLAN LLC,2,1,1
2430,5053210060,SI,91 OCEANIC AVENUE,01,A6,MICHAEL MASELLA,2,1,1
2431,5054260010,SI,26 SANDGAP STREET,01,B2,IRINA APTEKAR-LEVIN,3,2,1
2432,5055980001,SI,3700 RICHMOND AVENUE,04,O8,AN PAGE HOLDING CORP,2,1,1
2433,5062540051,SI,40 NORTH RAILROAD ST,01,A2,DONALD & JOSEPHINE MCANDREWS IRREVOCABLE  TRUST,2,1,1
2434,5063247501,SI,5291 AMBOY ROAD,02,R6,UNAVAILABLE OWNER,2,1,1
2435,5063930018,SI,191 BOARDWALK AVENUE,01,B2,"ASHBY, WAYNE",2,1,1
2436,5066660057,SI,15 NAVIGATOR COURT,01,A5,BIAGIOLI MICHAEL A,2,1,1
2437,5067440036,SI,27 CAROL COURT,01,B2,"ANZALONE, MICHAEL",2,1,1
2438,5078510044,SI,165 NANCY LANE,01,A3,"MARTINELLI, JOHN",2,1,1
2439,5078840037,SI,398 MANHATTAN STREET,01,B2,GALLO FAMILY IRREVOCABLE SUPPLEMENTAL NE EDS TRUST,2,1,1
2440,5079910023,SI,47 ELLIS STREET,01,A1,"KRAKOWER, ALLEN J",2,1,1
2441,5080170009,SI,63 NASHVILLE STREET,01,A1,"D'ESPOSITO, VINCENT",2,1,1
2442,1001580061,MN,39 PEARL STREET,08,Z1,US GENERAL SERVICES ADMINISTRATIONN,3,2,1
2443,1002000022,MN,73 MOTT STREET,04,C7,LUN WOO CO INC,2,1,1
2444,1004180057,MN,274 GRAND STREET,04,S9,274 GRAND REALTY LLC,2,1,1
2445,1007540012,MN,353 WEST 30 STREET,03,D5,CINTON HOUSING DEVELO,2,1,1
2446,1008000033,MN,109 WEST 24 STREET,04,K4,111 WEST 24 ST ASSOCS              C/O M ONTAUK RUG AND CARPET,2,1,1
2447,1009620100,MN,462 1 AVENUE,08,I1,NYC HEALTH AND HOSPITALS CORPORATION,7,6,1
2448,1016370043,MN,160 EAST 110 STREET,05,K1,"WALL STREET PROPERTY HOLDINGS, LLC",3,2,1
2449,1018750042,MN,220 WEST 104 STREET,04,C7,KIWI REALTY LLC,2,1,1
2450,1019077505,MN,132 WEST 123 STREET,02,R1,UNAVAILABLE OWNER,2,1,1
2451,1019550020,MN,306 WEST 129 STREET,08,M1,NEW YRK CONGRGATIONETAL,2,1,1
2452,2023600097,BX,3172 3 AVENUE,06,F9,3162-72 3RD AVE RLTYCP,2,1,1
2453,2024480021,BX,1065 MORRIS AVENUE,02,C0,"CURIEL, BIENVENIDO",2,1,1
2454,2025260046,BX,1066 UNIVERSITY AVENUE,02,C0,"BENJAMIN, KOSYOUTH",2,1,1
2455,2025930001,BX, ROSE FEISS BOULEVARD,07,U6,"CONSOLIDATED EDISON CO.OF N.Y.,INC.",11,10,1
2456,2027720225,BX,1361 EAST BAY AVENUE,06,F4,1361 EAST BAY AVE LLC,2,1,1
2457,2029310072,BX,1371 FRANKLIN AVENUE,01,B2,1371 FRANKLIN AVE LLC,2,1,1
2458,2030060001,BX,1085 HOME STREET,10,G1,1301 WESTCHESTER AVEASC,2,1,1
2459,2030790076,BX,1977 CROTONA AVENUE,01,B2,GUILLERMO VASQUEZ,2,1,1
2460,2031240054,BX,877 HORNADAY PLACE,01,B2,"RUIZ , SANTO P",3,2,1
2461,2032050009,BX,2610 GRAND AVENUE,08,M1,GREATER NY CORP OF 7TH DAY ADVENTISTS,2,1,1
2462,2032340022,BX,2241 HAMPDEN PLACE,02,C0,2241 HAMPDEN PLACE LLC,2,1,1
2463,2033310007,BX,3044 DECATUR AVENUE,02,C3,KAGAN AVI,2,1,1
2464,2033550059,BX,369 EAST 207 STREET,01,B2,RAMOS ALFONSO,3,2,1
2465,2033640025,BX,10A EAST 236 STREET,02,C0,"O'SHEA, LAURA",2,1,1
2466,2033750068,BX,277 EAST 234 STREET,01,B1,LAURA O'SHEA,2,1,1
2467,2034970044,BX,445 LELAND AVENUE,01,B3,ROBERT AVANT,2,1,1
2468,2035280017,BX,1930 RANDALL AVENUE,08,P5,KIPS BAY BOYS CLUB IN,3,2,1
2469,2037170027,BX,1050 MANOR AVENUE,02,C0,"WORRELL, EUDORA EUNIC",2,1,1
2470,2038150048,BX,1009 HAVEMEYER AVENUE,02,C0,GONZALEZ DEMETRIA,2,1,1
2471,2038300085,BX,2313 GLEASON AVENUE,01,A1,"HARPAL, KAMLA",2,1,1
2472,2038610134,BX,1375 BRONX RIVER AVENUE,02,C3,"NARVAEZ, PEDRO L",2,1,1
2473,2039320012,BX,2055 WESTCHESTER AVENUE,08,W2,R C CHURCH ST HELENA,3,2,1
2474,2039640018,BX,1445 DORIS STREET,02,C1,BALLAGH PROPERTIES LLC,2,1,1
2475,2039660023,BX,2161 GLEBE AVENUE,01,B2,"RIVERA, LUZ Y.",2,1,1
2476,2039720026,BX,1521 ZEREGA AVENUE,01,B2,PADILLA PACHEO JACOBO,2,1,1
2477,2039750031,BX,1465 ROWLAND STREET,02,C0,LUCKY V AND CO LLC,2,1,1
2478,2042420055,BX,2851 EAST 195 STREET,01,B2,SHINGO PROPERTY LLC,2,1,1
2479,2043300026,BX,2129 HAIGHT AVENUE,01,A1,"PENNA, GIULIANO",2,1,1
2480,2043920011,BX,1455 ASTOR AVENUE,08,M4,SISTERS OBLATES TO THE BLESSED TRINITY,2,1,1
2481,2044550069,BX,2416 ESPLANADE,01,A1,DELUCA SYLVANA,2,1,1
2482,2044620035,BX,2574 TENBROECK AVENUE,01,A5,"DEEN, MOHAMED S",2,1,1
2483,2044810117,BX,2565 WOODHULL AVENUE,01,A5,ERROL D SCAFE,2,1,1
2484,2046220058,BX,3301 BARKER AVENUE,02,C0,"JONES, KATIE",2,1,1
2485,2046230042,BX,3349 OLINVILLE AVENUE,02,C0,PARKSTONE TL LLC,2,1,1
2486,2046460001,BX,3601 WILLETT AVENUE,02,C1,"KASTRATI, GJEVAT",5,4,1
2487,2046620025,BX,713 EAST 214 STREET,01,B1,"THOMPSON, RUDY SR.",2,1,1
2488,2046730046,BX,3642 BARNES AVENUE,01,B3,"SANDERS, ROSA",2,1,1
2489,2047280070,BX,3550 BOSTON ROAD,07,G9,3550 BOSTON ROAD LLC,2,1,1
2490,2047670038,BX,3012 MICKLE AVENUE,01,B1,"LOPEZ-CASTILLO, DARWIN",2,1,1
2491,2047960007,BX,2939 GRACE AVENUE,01,B1,"CABREJA, DOMINGO",2,1,1
2492,2048430017,BX,749 EAST 229 STREET,02,C0,MINZIE PAULET,2,1,1
2493,2049730028,BX,3957 PROVOST AVENUE,10,G1,"SALOMONE & COMPANY,",2,1,1
2494,2050390063,BX,4350 RICHARDSON AVENUE,02,C3,"RAMNAUTH, MANESHWAR N",2,1,1
2495,2050870053,BX,4632 WHITE PLAINS ROAD,04,S1,SHOKEYE DAUDA,2,1,1
2496,2052590085,BX,3820 BOSTON ROAD,04,K4,"DEREIMER OWNERS, LLC.",2,1,1
2497,2053360033,BX,1260 EDISON AVENUE,01,B1,"MURPHY, VERONICA M",2,1,1
2498,2053500028,BX,1372 EDWARDS AVENUE,01,B2,APOLONIO DELGADO,2,1,1
2499,2053880041,BX,2883 ZULETTE AVENUE,01,A1,"SANTIAGO, EDUARDO",2,1,1
2500,2054080260,BX,3151 PARSIFAL PLACE,01,A1,HARRISON MCKAY,2,1,1
2501,2054730018,BX,833 WILCOX AVENUE,01,A2,"VAIANA , GEORGE JR.",2,1,1
2502,2054790054,BX,828 CLARENCE AVENUE,01,B2,"DE LA HOZ, DEREK",2,1,1
2503,2054980029,BX,243 MEAGHER AVENUE,01,B1,RUBEN & MARIA LOPEZ,2,1,1
2504,2055180294,BX,3127 WISSMAN AVENUE,01,B1,"HO, FRANK",2,1,1
2505,2055900106,BX,187 REVERE AVENUE,01,B3,JOSEPH M. BOYLE REVOCABLE TRUST,2,1,1
2506,2056260243,BX,15 PELL PLACE,01,A1,"MCGUIRE, JUNE M",2,1,1
2507,2056360150,BX, CITY ISLAND AVENUE,11,V1,JMC HOLDINGS,3,2,1
2508,2056530215,BX,2577 FLINT AVENUE,01,B1,MARINE RICARDO,2,1,1
2509,2059390422,BX,5291 INDEPENDENCE AVENUE,01,A3,VICTORIAN PRESERVATION GUILD LLC,2,1,1
2510,3003730014,BK,14 4 PLACE,02,C3,"NARDO, RICHARD",2,1,1
2511,3004430058,BK,289 CARROLL STREET,02,C3,"BALAC, JOANN",2,1,1
2512,3005300038,BK,84 VISITATION PLACE,01,B1,VISITATION CONSTRUCTION LLC,2,1,1
2513,3005770046,BK,38 DIKEMAN STREET,02,C3,DIKEMAN REALTY GROUP LLC,2,1,1
2514,3006340062,BK,205 19 STREET,01,B2,"FERRARO, MARIA",2,1,1
2515,3006437503,BK,207 22 STREET,02,R1,SOUTH SLOPE LIBERTY CONDOMINIUM,2,1,1
2516,3006650047,BK,213 29 STREET,01,B9,"RAWAL, KANTILAL",2,1,1
2517,3006650048,BK,211 29 STREET,01,B9,CONA MARIE,2,1,1
2518,3008760034,BK,474 17 STREET,01,B3,474 17TH STREET LLC,3,2,1
2519,3008780051,BK,611 18 STREET,01,B2,"DICOSTANZA, JOHN W JR",2,1,1
2520,3009560047,BK,214 6 AVENUE,02,C1,PRESIDENT ADAMS REALT,3,2,1
2521,3010270060,BK,175 13 STREET,01,B3,"LECHOWIT, MARIE",2,1,1
2522,3011440069,BK,195 ST MARKS AVENUE,02,C3,BRANDON  KIM D,2,1,1
2523,3012900068,BK,305 CROWN STREET,02,C2,CHEVRA MACHZIKET HSHECHUNA,2,1,1
2524,3012910027,BK,1292 CARROLL STREET,01,A5,SIMON BACKER,2,1,1
2525,3012950032,BK,182 CROWN STREET,01,A4,ROUTEE JORDAN,2,1,1
2526,3013080016,BK,240 SULLIVAN PLACE,01,B1,240 SULLIVAN LLC,2,1,1
2527,3013110003,BK,431 BROOKLYN AVENUE,01,B1,MEIR SHIMSHONI,2,1,1
2528,3013880064,BK,907 EASTERN PARKWAY,01,B1,PETER BORISUTE,2,1,1
2529,3014430026,BK,2372 PACIFIC STREET,02,C2,2372 PACIFIC LLC,2,1,1
2530,3014510001,BK,451 RALPH AVENUE,08,I1,NYS OFFICE OF MENTAL HEALTH,2,1,1
2531,3017180001,BK,60 NOSTRAND AVENUE,07,G9,NYC DEPARTMENT OF SANITATION,2,1,1
2532,3018690018,BK,304 HERKIMER STREET,01,B1,"PARK, KYUNG HEE",2,1,1
2533,3019280006,BK,229 SKILLMAN STREET,02,C0,"MEHRING, ZVI",2,1,1
2534,3022030001,BK,687 KENT AVENUE,07,G4,NEW AUTO DIAGNOSTICINC,2,1,1
2535,3023230016,BK,294 NORTH 8 STREET,04,C7,RMW 294 LLC,2,1,1
2536,3023900013,BK,46 GRAND STREET,04,S2,MINC PLATFORM LLC,2,1,1
2537,3024130004,BK,378 SOUTH 1 STREET,04,S2,402 HOOPER LLC,2,1,1
2538,3024160006,BK,317 WYTHE AVENUE,04,S5,DOMINO EFFECT LLC,3,2,1
2539,3026240045,BK,150 NEWEL STREET,03,D1,150 NEWEL ENTERPRISES LLC,2,1,1
2540,3026920032,BK,777 MEEKER AVENUE,06,E1,"CARTER, JEFFREY",3,2,1
2541,3027250006,BK,14 HERBERT STREET,02,C0,"WASHACK, ANDREW JOHN",2,1,1
2542,3027510031,BK,605 LORIMER STREET,01,A9,"BUONO, GLORIA",2,1,1
2543,3027750012,BK,186 AINSLIE STREET,01,B9,MICHAEL FIORE,2,1,1
2544,3030310046,BK,13 SCHOLES STREET,02,C0,13 SCHOLES ST HOUSING DEVP FUND,2,1,1
2545,3031830013,BK,24 TROUTMAN STREET,01,B1,PINE REALTY LLC,2,1,1
2546,3032090037,BK,243 SUYDAM STREET,02,C1,243 SUYDAM LLC,2,1,1
2547,3032340020,BK,702 HART STREET,01,A1,HART OF BUSHWICK LLC,2,1,1
2548,3032450023,BK,1362 DEKALB AVENUE,02,C1,LA BOLILLA INC,2,1,1
2549,3033230001,BK,93 LINDEN STREET,03,D1,LINDEN STREET HOLDINGS LLC,2,1,1
2550,3033280026,BK,378 GROVE STREET,03,D1,380 GROVE STREET LLC,2,1,1
2551,3033340001,BK,357 WILSON AVENUE,02,C1,NYC HOUSING AUTHORITY,3,2,1
2552,3034660030,BK,1508 BUSHWICK AVENUE,07,G3,BUSHWICK BH LLC,2,1,1
2553,3035520006,BK,205 GRAFTON STREET,01,B1,LISA M WEDDERBURN,2,1,1
2554,3035810013,BK,323 GRAFTON STREET,01,B1,BRATHWAITE JOSEFINA,2,1,1
2555,3036410023,BK,1079 THOMAS S BOYLAND ST,01,B2,"BELFON, MERVYN",2,1,1
2556,3036610015,BK,100 JAMAICA AVENUE,04,S2,SANTOS D MONEGRO,2,1,1
2557,3038060064,BK,566 NEW JERSEY AVENUE,01,B1,"FRASER, CYNTHIA",2,1,1
2558,3038860051,BK,129 SUNNYSIDE AVENUE,01,B9,"FOUNTAIN, HANA",2,1,1
2559,3039220030,BK,3 JEROME STREET,01,B1,"MARRERO, RAMON M",2,1,1
2560,3039340014,BK,117 HENDRIX STREET,01,B1,BHAGWANTIE SOOKOO,2,1,1
2561,3039870002,BK,405 LINWOOD STREET,02,C2,"AVILA PARKS, SILVIA",4,3,1
2562,3041620038,BK,95 GLEN STREET,01,B3,"HOSSAIN, ISMAIL",2,1,1
2563,3042020028,BK,186 SHERIDAN AVENUE,01,B3,"PERSAUD, SAHADEO",2,1,1
2564,3042440045,BK,1227 BELMONT AVENUE,01,B2,PATTI LEONARDA,3,2,1
2565,3042940123,BK,649 WILLIAMS AVENUE,01,A5,"ORR , DIANNE E",2,1,1
2566,3043190019,BK,738 ALABAMA AVENUE,01,B2,"COX , TIM",2,1,1
2567,3043390050,BK,775 ESSEX STREET,01,B3,TISHA D. PILE,2,1,1
2568,3045490006,BK,770 WORTMAN AVENUE,01,A2,"BENEDITH, ELMO A",2,1,1
2569,3046920040,BK,494 EAST 96 STREET,02,C3,494 E 96 STREET INC.,2,1,1
2570,3047020044,BK,5401 SNYDER AVENUE,01,B1,"CAMPBELL, RICHARD",2,1,1
2571,3048620033,BK,539 LINDEN BOULEVARD,04,S1,"RILEY, MARCEL A",2,1,1
2572,3048890054,BK,205 EAST 35 STREET,01,B3,"BROOKLYN ACTION DEVELOPMENT CORP.,",2,1,1
2573,3049340037,BK,3411A CLARENDON ROAD,01,A1,"SAMSON, KWAME",3,2,1
2574,3049490016,BK,1238 NEW YORK AVENUE,01,B2,"VAISHALI BAHL, SHELLY",2,1,1
2575,3051520012,BK,1072 FLATBUSH AVENUE,05,K1,FREDA REALTY CO,2,1,1
2576,3051950060,BK,359 EAST 29 STREET,01,B1,"WILLACY, SALVADORE",2,1,1
2577,3052000025,BK,580 MARLBOROUGH ROAD,01,B2,"RODNEY, JOSEPH G",2,1,1
2578,3053280021,BK,130 OCEAN PARKWAY,03,D1,"NEXTSTAR REALTY, LLC",2,1,1
2579,3053320034,BK,143 DAHILL ROAD,02,C0,"KABIR, HUMAYUN",2,1,1
2580,3053950029,BK,674 EAST 2 STREET,01,B3,WOMEN'S LEAGUE COMMUNITY,2,1,1
2581,3054040042,BK,1783 45 STREET,02,C0,SMK TRUST,2,1,1
2582,3054050015,BK,1722 43 STREET,01,B2,"STEINMETZ, IRENE",2,1,1
2583,3054340074,BK,1629 46 STREET,01,A1,"SIEGER, ESTHER",2,1,1
2584,3054960040,BK,1584 57 STREET,02,C0,NEWMAN JACOB,2,1,1
2585,3055000053,BK,2063 58 STREET,01,A5,"HOFFMANN, ELI",2,1,1
2586,3055140007,BK,5907 20 AVENUE,01,B1,THE MALLOZZI FAMILY REVOCABLE LIVING TRU ST,2,1,1
2587,3055200004,BK,6013 19 AVENUE,01,A9,RIVKY HERTZ,2,1,1
2588,3055660018,BK,1559 68 STREET,01,A5,"CHONG, YIN LEAN",2,1,1
2589,3055980013,BK,1216 42 STREET,01,B2,OSTREICHER JACOB,2,1,1
2590,3056200020,BK,1036 46 STREET,02,C0,SHIRLEY LERNER BROOKLYN QUALIFIED PERSON AL ETC.,2,1,1
2591,3057030001,BK,5809 11 AVENUE,02,C0,HERSKO LEAH,2,1,1
2592,3057520035,BK,1170 65 STREET,01,B1,JIM VAN NGUYEN,2,1,1
2593,3058800059,BK,1043 70 STREET,01,B1,SPADARO FRANK,2,1,1
2594,3059450068,BK,955 76 STREET,01,A5,"DELLAPORTE, CIRO",2,1,1
2595,3059860025,BK,166 80 STREET,01,A1,FRANCIS J ULRICH,2,1,1
2596,3060860001,BK,9119 3 AVENUE,05,K2,9101 K HOLDING LLC,2,1,1
2597,5080450076,SI,228 LEE AVENUE,01,B2,"WICK, MICHAEL",2,1,1
2598,1002740006,MN,57 MONROE STREET,07,T9,NYC DEPARTMENT OF SANITATION,2,1,1
2599,1004400034,MN,203 AVENUE A,04,C7,NEW YORK EQUITY FUND 2004 LLC,2,1,1
2600,1006360014,MN,300 WEST 10 STREET,02,C4,CHAD 300 WEST 10TH STREET LLC,2,1,1
2601,1006750012,MN,613 WEST 29 STREET,11,V1,WEST SIDE 11TH & 29TH LLC,7,6,1
2602,1007440046,MN,308 WEST 21 STREET,02,C4,"PROLIFIA, LLC",2,1,1
2603,1008000020,MN,135 WEST 24 STREET,04,D6,LAM GEN 25 LLC,2,1,1
2604,1008030028,MN,113 WEST 27 STREET,04,S9,JEE FOO REALTY CORP,2,1,1
2605,1008230041,MN,164 5 AVENUE,08,P2,THOR 164 5TH AVE LLC,2,1,1
2606,1008300079,MN,830 AVENUE OF THE AMER,05,O5,PAUL SIN HAN KIM,2,1,1
2607,1009290001,MN,401 1 AVENUE,03,D4,EAST MIDTOWN PLAZA,6,5,1
2608,1010530032,MN,613 9 AVENUE,04,C7,"NINTH AVENUE REALTY, LLC",2,1,1
2609,1010580033,MN,709 9 AVENUE,04,C7,"709 9TH AVENUE,",2,1,1
2610,1011210055,MN,48 WEST 69 STREET,02,C5,"ERZULI, LLC",2,1,1
2611,1012020010,MN,55 WEST 88 STREET,02,C2,"88 WEST 88, LLC",2,1,1
2612,1014300002,MN,1313 3 AVENUE,04,C7,1313 REALTY CO LLC,2,1,1
2613,1014740008,MN, YORK AVENUE,,Z7,NYS DEPARTMENT OF TRANSPORTATION,2,1,1
2614,1014837501,MN,524 EAST 72 STREET,03,R4,BELAIRE CONDOMINIUM ASSOC,2,1,1
2615,1015450026,MN,1585 1 AVENUE,04,C7,1585 REALTY COMPANY,2,1,1
2616,1017210021,MN,30 MT MORRIS PARK WEST,02,C5,JULIUS JAMES,2,1,1
2617,1020480042,MN,618 ST NICHOLAS AVENUE,02,C4,"ECDO COMMUNITY PARTNERSHIP HDFC, INC.",2,1,1
2618,2024560070,BX,1126 CARROLL PLACE,04,C7,1124 CARROLL RLTY ASSOC.,2,1,1
2619,2024880046,BX,1155 GERARD AVENUE,02,C1,MYRADOR MGMT CORP,2,1,1
2620,2030370038,BX,4420 PARK AVENUE,02,C0,VICTOR LANGE,2,1,1
2621,2031020058,BX,2309 PROSPECT AVENUE,01,B1,"PAGAN, GEORGINA",2,1,1
2622,2031240047,BX,861 HORNADAY PLACE,01,B1,SALINAS EMILIO H,2,1,1
2623,2032070029,BX,65 WEST 181 STREET,02,C3,"FORREST , LINDA",2,1,1
2624,2033380051,BX,3317 BAINBRIDGE AVENUE,05,O7,SAMJUST REAL ESTATECORP,2,1,1
2625,2033650079,BX,63 EAST 233 STREET,11,V0,WOODLAWN SENIOR LIVING HOUSING DEVELOPME NT FUND CO,3,2,1
2626,2034460046,BX,145 PUGSLEY AVENUE,11,V0,BENJAMIN CARRASQIULLO,2,1,1
2627,2034760001,BX,1963 O'BRIEN AVENUE,01,B3,NILSA AYALA,2,1,1
2628,2034960009,BX,1823 PATTERSON AVENUE,02,C0,"PIEDRABUENA, JOSE ROBERTO",2,1,1
2629,2036410001,BX,880 LAFAYETTE AVENUE,08,W9,NYC DEPARTMENT OF PARKS AND RECREATION,3,2,1
2630,2040350032,BX,1712 HOLLAND AVENUE,01,B2,US FAMILY REALTY INC,2,1,1
2631,2040370019,BX,1653 HUNT AVENUE,01,B2,"ALI, MOHAMMED ASHAN",2,1,1
2632,2040540062,BX,1843 MATTHEWS AVENUE,02,C3,"LIGNITI, EZIO",2,1,1
2633,2040650025,BX,1067 SACKET AVENUE,02,C0,"FLORES, JOSEPH A JR",3,2,1
2634,2041310015,BX,1849 TOMLINSON AVENUE,01,B2,MILDRED CONTI,2,1,1
2635,2043640021,BX,1066 STELL PLACE,01,B1,"DEJESUS, AMAURIS",2,1,1
2636,2046500031,BX,3760 OLINVILLE AVENUE,01,B1,"VILLALONA, MILTON",2,1,1
2637,2046560010,BX,638 EAST 222 STREET,01,B3,"MOORE, LOTHA J",2,1,1
2638,2046810058,BX,950 EAST 211 STREET,01,Z0,"IGIOZEE, VERONICA",2,1,1
2639,2047620081,BX,1470 KNAPP STREET,02,C1,"PENINSULA PROPERTIES, LLC",2,1,1
2640,2047730017,BX,3033 GUNTHER AVENUE,01,B1,REV R O S BRYANT,2,1,1
2641,2047930043,BX,2828 GUNTHER AVENUE,01,B2,ANASTASIA THOMAS,3,2,1
2642,2048500012,BX,857 EAST 225 STREET,01,B1,ICL REAL PROPERTY HOLDING CORPORATION,2,1,1
2643,2049730002,BX,1625 EAST 233 STREET,05,K1,PRO 233 INC,2,1,1
2644,2050010009,BX,811 EAST 234 STREET,01,A1,SIEUPAUL,2,1,1
2645,2050210039,BX,4170 DE REIMER AVENUE,01,B1,UNAVAILABLE OWNER,2,1,1
2646,2050530032,BX,4364 BRUNER AVENUE,01,A1,"BAH, IBRAHIM",2,1,1
2647,2050740015,BX,4526 BULLARD AVENUE,06,F1,BULLARD AVENUE PROPE,3,2,1
2648,2051220031,BX,4523 HILL AVENUE,01,B2,SHERRIE A HOWARD,2,1,1
2649,2054090084,BX,1208 STADIUM AVENUE,08,M4,PROVIDENCE REST,2,1,1
2650,2054130115,BX,3282 MIDDLETOWN ROAD,01,B1,ARMANDO TELLEZ,2,1,1
2651,2054210039,BX,1007 LOGAN AVENUE,01,A2,"CERINI, CATHERINE",2,1,1
2652,2054320043,BX,749 LOGAN AVENUE,01,A1,"DIAZ, RALPH",2,1,1
2653,2054510030,BX,2970 MILTON PLACE,01,B1,"GOMEZ-MARTELL, ANIELKA",2,1,1
2654,2054640040,BX,1014 WILCOX AVENUE,01,B2,"TORRES , RICARDO",2,1,1
2655,2054970006,BX,3980 THROGS NECK EXPWY,01,B1,"FLORENCIO, VICTOR",2,1,1
2656,2055450111,BX,717 CALHOUN AVENUE,01,B1,"PATRICK FORMATO, TRUSTEE",2,1,1
2657,2056070095,BX,179 ROBINSON AVENUE,01,B1,FOCOLARE MOVEMENT WOMEN'S BRANCH,2,1,1
2658,2056460035,BX,451 MINNIEFORD AVENUE,01,A2,"CROSS, MONIQUE",2,1,1
2659,2058552243,BX,5736 MOSHOLU AVENUE,01,A2,"LOWE, ROOPLALL L",3,2,1
2660,2058680565,BX,360 WEST 260 STREET,01,A1,"BECKER, JOHN",2,1,1
2661,3000200014,BK,64 JOHN STREET,06,E9,VERA REALTY CORP,4,3,1
2662,3003890005,BK,101 3 AVENUE,03,D3,316 BERGEN STREET LLC,2,1,1
2663,3004480029,BK,568 PRESIDENT STREET,02,C1,"MAZOR, IWONA",2,1,1
2664,3004770048,BK,3 9 STREET,05,K1,SHAKER A ZAOKARI,2,1,1
2665,3005770043,BK,32 DIKEMAN STREET,01,B9,"GIL, ROBERTO",2,1,1
2666,3006340061,BK,207 19 STREET,02,C0,"MILLER, JONATHAN",2,1,1
2667,3006450017,BK,138 22 STREET,02,C0,SAVARESE FAMILY PROPERTY TRUST,2,1,1
2668,3008130006,BK,5309 2 AVENUE,06,E2,53RD STREET GROUP LLC,4,3,1
2669,3008260053,BK,761 55 STREET,04,D7,MPH FUNDING LLC,2,1,1
2670,3009580021,BK,614 PRESIDENT STREET,02,C0,"LANZI, LISA/TR",2,1,1
2671,3010290030,BK,330 12 STREET,01,B3,CHARLOTTE G MCIVER AN,2,1,1
2672,3010540009,BK,595 6 AVENUE,02,C0,RICARDO A MAYNARD,2,1,1
2673,3011750019,BK,566 STERLING PLACE,02,C1,566 STERLING PLACE LLC,2,1,1
2674,3011870001,BK,883 CLASSON AVENUE,08,W1,NYC DEPARTMENT OF EDUCATION,2,1,1
2675,3011920046,BK,124 MONTGOMERY STREET,06,F5,HPG ASSOCIATES INC,5,4,1
2676,3012910071,BK,367 CROWN STREET,01,A4,FBB FAMILY TRUST,2,1,1
2677,3012910073,BK,363 CROWN STREET,01,A4,FIFTY CALIFORNIA AVEREALTY CO,2,1,1
2678,3013110057,BK,565 EMPIRE BOULEVARD,04,S2,DUNG THO LA,3,2,1
2679,3013810034,BK,1676 STERLING PLACE,02,C3,"BRINSON, LASHAWNDA",2,1,1
2680,3014120007,BK,1476 CARROLL STREET,01,A5,"JUNIK, MALKA",2,1,1
2681,3014180068,BK,883 MONTGOMERY STREET,01,B1,BRAS RAIZEL,2,1,1
2682,3015097501,BK,,02,R2,BAINBRIDGE MEWS CONDO,11,10,1
2683,3016260030,BK,698 LEXINGTON AVENUE,01,B1,IEHOLDINGS LLC,2,1,1
2684,3018890026,BK,89 WAVERLY AVENUE,02,C0,"GARCIA, OCTAVIA M",2,1,1
2685,3018980057,BK,124 FRANKLIN AVENUE,02,C0,124 REALTY TOV LLC,2,1,1
2686,3023270028,BK,151 NORTH 6 STREET,04,S9,NORTHSIDE PROPERTIES INC.,3,2,1
2687,3023380006,BK,109 ROEBLING STREET,02,C2,109 ROEBLING STREET LLC,2,1,1
2688,3025630029,BK,130 GREENPOINT AVENUE,04,C7,STARPOINT DEVELOPMENT LLC,2,1,1
2689,3027510036,BK,37 CONSELYEA STREET,03,D1,"37 CONSELYEA ST., LLC",2,1,1
2690,3027600008,BK,360 GRAHAM AVENUE,04,S1,GANGONE JOHN,2,1,1
2691,3027760033,BK,145 POWERS STREET,02,C0,"CLEMENTI, ROSEMARY",2,1,1
2692,3028660030,BK,242 FROST STREET,02,C0,"RAGONE, VINCENT V",2,1,1
2693,3030300003,BK,303 STAGG STREET,07,G9,ROMANELLI REALTY LLC,4,3,1
2694,3030890001,BK,98 GRAHAM AVENUE,04,S2,AL-FRANK REALTY CORP,2,1,1
2695,3030960019,BK,83 GRAHAM AVENUE,04,K4,85 GRAHAM REALTY LLC,2,1,1
2696,3031350001,BK,879 BROADWAY,05,K9,REALTY CLUB OF NY LLC,2,1,1
2697,3031760052,BK,371 TROUTMAN STREET,01,B2,GARIK REALTY LLC,2,1,1
2698,3033040024,BK,9 MENAHAN STREET,01,B9,"FINKELSTEIN, YORAM",2,1,1
2699,3033080021,BK,1452 MYRTLE AVENUE,04,S2,DS BROOKLYN PORTFOLIO OWNER LLC,2,1,1
2700,3033760057,BK,197 CORNELIA STREET,02,C0,"GONZALEZ, HERNAN",2,1,1
2701,3033890010,BK,1172 JEFFERSON AVENUE,02,C0,1172 JEFFERSON AVE LLC,2,1,1
2702,3034760060,BK,1676 BUSHWICK AVENUE,06,E7,CS BUSHWICK LLC,4,3,1
2703,3036240021,BK,571 BRISTOL STREET,01,B1,OLADIPO AKINOLA,2,1,1
2704,3036690035,BK,2631 ATLANTIC AVENUE,04,S9,GHANDFOROUSH ENTERPRISES LLC,2,1,1
2705,3036930020,BK,116 LIBERTY AVENUE,07,G9,LETERNEL PROPERTIESCORP,2,1,1
2706,3038390009,BK,603 SHEFFIELD AVENUE,01,B1,"SIERRA, EMILIA",2,1,1
2707,3038500035,BK,596 SNEDIKER AVENUE,01,B1,JOHNSON JOSEPH W,2,1,1
2708,3039180026,BK,87 ARLINGTON AVENUE,02,C0,"PACHECO, DARWIN",3,2,1
2709,3039270031,BK,136 RIDGEWOOD AVENUE,01,A1,"ALVARADO, LUIS",2,1,1
2710,3040220121,BK,183 BERRIMAN STREET,01,A5,"DAVID, SHAWN",2,1,1
2711,3040520028,BK,536 SHEPHERD AVENUE,02,C0,ZM HOLDINGS CORP.,2,1,1
2712,3040670022,BK,998 BLAKE AVENUE,08,N9,BLAKE HOLDINGS LLC,5,4,1
2713,3041030017,BK,17 RICHMOND STREET,01,A9,LOUIS VEGA,2,1,1
2714,3041040010,BK,45 CHESTNUT STREET,01,B2,KHAN  NAZIR A,2,1,1
2715,3041120070,BK,50 ELDERT LANE,01,B1,OSWALDO SALAZAR,2,1,1
2716,3042460025,BK,908 BELMONT AVENUE,01,B2,"ABDUL, HAKIM",2,1,1
2717,3042890021,BK,735 ELDERT LANE,08,M1,GLORY LAND MINISTRY INTERNATIONAL INC.,2,1,1
2718,3043590059,BK,807 ASHFORD STREET,01,A9,"MOODY, MONA",3,2,1
2719,3044560030,BK,442 MILFORD STREET,02,C0,"ESTAVA, GILBERT",2,1,1
2720,3047130033,BK,547 EAST 92 STREET,02,C0,EAST 92ND LLC,2,1,1
2721,3048500012,BK,246 EAST 46 STREET,02,C0,"RED GUERRILLA ENTERTAINMENT, LLC",2,1,1
2722,3048860050,BK,49 EAST 32 STREET,01,A9,THE PEARLEL G. EBANKS REVOCABLE LIVING T RUST,2,1,1
2723,3048940061,BK,187 EAST 40 STREET,01,B9,"FRANCO, IAN",2,1,1
2724,3049070001,BK,3602 SNYDER AVENUE,07,G4,"BLUE HILLS FUELS, LLC",2,1,1
2725,3049500001,BK,3304 CLARENDON ROAD,08,M1,CLARENDON ROAD CHRUCH OF THE CHRISTIAN A ND MISSIONARY ALLIANCE,2,1,1
2726,3049500017,BK,562 EAST 34 STREET,01,B2,"BEGUM, NAHIMA",2,1,1
2727,3049740062,BK,633 EAST 40 STREET,01,B2,GILLARD MICHAEL,2,1,1
2728,3049930041,BK,1440 SCHENECTADY AVENUE,01,B1,WILBUR J JOSEPH,2,1,1
2729,3050560095,BK,119 CLARKSON AVENUE,01,A1,"MCKENNA, EDWARD",2,1,1
2730,3050990039,BK,1800 CHURCH AVENUE,04,S5,CHURCH AVE REALTY CORP,2,1,1
2731,3051140001,BK,545 CONEY ISLAND AVENUE,05,K1,V D VILST INC,2,1,1
2732,3053320057,BK,440 MCDONALD AVENUE,02,C3,ZAMBITO JOHN,2,1,1
2733,3053320058,BK,444 MCDONALD AVENUE,02,C3,"WONG, JOHNNY",2,1,1
2734,3053910035,BK,522 EAST 8 STREET,02,C0,"RAND, SHALOM G",2,1,1
2735,3054330030,BK,1558 45 STREET,01,B2,"KIPUST, PHILIP J",2,1,1
2736,3054660018,BK,1622 51 STREET,01,B2,1622 R LLC,2,1,1
2737,3054660028,BK,1644 51 STREET,01,A1,DAVID GOLDSTEIN,2,1,1
2738,3054910069,BK,1519 57 STREET,01,B2,"SCHEINER, REUVEN&SHOSHANA",2,1,1
2739,3054940059,BK,1878 55 STREET,01,A9,"LEFKOWITZ, ISSAC",2,1,1
2740,3056010040,BK,4310 10 AVENUE,08,W2,"BROCHO, BAIS",2,1,1
2741,3056050015,BK,1320 43 STREET,02,C2,"1320 43RD STREET REALTY, LLC",2,1,1
2742,3056180036,BK,1470 45 STREET,02,C0,"1466 45TH ST., LLC",2,1,1
2743,3056460028,BK,5022 FT HAMILTON PARKWAY,04,S2,REALTY 442 LLC,2,1,1
2744,3056460053,BK,5014 11 AVENUE,01,B1,CONGREGATION BNEI DOVID,2,1,1
2745,3056970031,BK,1264 57 STREET,01,A1,TOBY KAHAN AS TRUSTEE,2,1,1
2746,3057060014,BK,1420 58 STREET,02,C0,"ROBERT SCHACHTER, AS TRUSTEE",2,1,1
2747,3057060059,BK,1441 59 STREET,01,A7,DOROTHY RUBIN,2,1,1
2748,3057170062,BK,1141 61 STREET,06,F4,1141 61 LLC,2,1,1
2749,3058090010,BK,414 63 STREET,08,M1,FAC 6309 FOURTH AVENUE HOUSING DEVELOPME NT FUND CO,2,1,1
2750,3058850016,BK,7005 COLONIAL ROAD,01,B1,BACHMAN JULIA C,2,1,1
2751,3059160054,BK,161 74 STREET,01,B1,"GORANITES, JOYCE",2,1,1
2752,3059470048,BK,7624 COLONIAL ROAD,01,A5,OVIDIO FINA,2,1,1
2753,3060240049,BK,265 85 STREET,01,A3,"AL-JANABI, MOHAMED",2,1,1
2754,3061550061,BK,1243 70 STREET,02,C0,PISCITELLO CARL,2,1,1
2755,3061640023,BK,2138 BAY RIDGE AVENUE,01,B1,HANA HAMDAN,2,1,1
2756,3062080039,BK,7310 BAY PARKWAY,01,B2,"LIN, FENG Y",2,1,1
2757,3062120026,BK,1448 74 STREET,01,A3,"LI, CHO WING",3,2,1
2758,3062160066,BK,1823 BAY RIDGE PARKWAY,02,C0,AHRC NYC NEW PROJECTS IN,2,1,1
2759,3062630001,BK,7821 20 AVENUE,02,C0,"TSANG, DANNY",2,1,1
2760,3062870006,BK,8011 20 AVENUE,01,B3,"TSANG, YING HUA",2,1,1
2761,3063020012,BK,1210 82 STREET,02,C0,PALUMBO DOMINICK,2,1,1
2762,3063320023,BK,1840 84 STREET,02,C0,"ZHAO, MING YU",2,1,1
2763,3063350015,BK,2122 84 STREET,02,C0,"LIN , KAI CHUN",2,1,1
2764,3063980068,BK,156 BAY 14 STREET,02,C0,"IEMMA, DEBORAH A",2,1,1
2765,3064320038,BK,1658 BATH AVENUE,04,S2,1658 BATH AVENUE REALTY INC.,2,1,1
2766,3064960012,BK,726 EAST 9 STREET,01,A5,"QADEER, AHMER",2,1,1
2767,3065240012,BK,1100 EAST 2 STREET,01,B1,SAM KNOPFLER,2,1,1
2768,3065670019,BK,1416 EAST 5 STREET,01,B2,MILTON MOCHON,2,1,1
2769,3065700070,BK,1433 EAST 7 STREET,01,A9,"ACCAD , SOLMI",2,1,1
2770,3065720080,BK,1325 EAST 9 STREET,01,A9,"ZAAFARANI, EDMOND",2,1,1
2771,3065780088,BK,1355 WEST 7 STREET,02,C0,"LAM-MEI, WINGSZE",2,1,1
2772,3065840037,BK,1552 EAST 3 STREET,01,B2,SHAHRBANY EFRAIM,2,1,1
2773,3065880058,BK,1495 OCEAN PARKWAY,02,C0,"ELMANN, LINA",2,1,1
2774,3065900070,BK,1461 EAST 8 STREET,01,A1,"KAIRY, SAMUEL",2,1,1
2775,3065910005,BK,914 AVENUE N,01,B2,ATERET AVOTH LLC,2,1,1
2776,3066090085,BK,1593 EAST 2 STREET,01,A9,ELBAZ STEPHEN K,2,1,1
2777,3066140002,BK,706 AVENUE O,01,A1,JOSEPH TOBIAS,2,1,1
2778,3066150020,BK,1542 EAST 9 STREET,01,A1,EZRA SHABOT,2,1,1
2779,3066150065,BK,1575 EAST 8 STREET,01,B2,DAVID WEIS,2,1,1
2780,3066340017,BK,1718 EAST 3 STREET,01,B1,JACKLYN AMAR,2,1,1
2781,3066630089,BK,1705 OCEAN PARKWAY,01,B1,BENJAMIN COHEN,2,1,1
2782,3066640065,BK,1768 EAST 8 STREET,01,A3,"AZIZO, ESTHER",2,1,1
2783,3067250051,BK,1187 EAST 14 STREET,01,A1,"EINHORN, MOSHE MENACHEM",2,1,1
2784,3067490022,BK,1438 EAST 12 STREET,01,B2,ADAM GINDI,2,1,1
2785,3067490037,BK,1470 EAST 12 STREET,01,B2,"BTESH, ALBERT",2,1,1
2786,3067520016,BK,1422 EAST 15 STREET,01,B3,EAST 15TH STREET REALTY LLC,2,1,1
2787,3067560036,BK,1472 EAST 19 STREET,04,S1,"KOHANTEB, NADER",2,1,1
2788,3067670034,BK,1680 EAST 21 STREET,01,B3,"AZRA, STEPHANE",2,1,1
2789,3068730047,BK,88 BAY 34TH STREET,11,V0,BAY 34 LLC,3,2,1
2790,3069430002,BK,1842 SHORE PARKWAY,09,P6,NYC DEPARTMENT OF PARKS AND RECREATION,4,3,1
2791,3069750014,BK,3916 LAUREL AVENUE,01,B2,"ZISMAN, JIMMY",2,1,1
2792,3070520014,BK,2920 WEST 28 STREET,03,D1,OCEANGATE L.P.,22,21,1
2793,3070640002,BK,1414 MERMAID AVENUE,04,S5,RUSSO LOUIS,2,1,1
2794,3070850112,BK,164 VAN SICKLEN STREET,01,B2,"SHAMIE, STEVEN",3,2,1
2795,3071040087,BK,1962 EAST 1 STREET,01,B1,"DANA , EDWARD",2,1,1
2796,3071040513,BK,2079 EAST 1 STREET,01,B3,"DOUEK, DAVID",2,1,1
2797,3071040519,BK,2061 EAST 1 STREET,01,A1,"BOTTON, SARIT",2,1,1
2798,3071070038,BK,2147 EAST 4 STREET,01,A3,"DWECK, ADELLE RAQUEL",2,1,1
2799,3071310052,BK,2223 EAST 4 STREET,01,A5,SALIM MANN,2,1,1
2800,3071330048,BK,2161 OCEAN PARKWAY,01,A9,"KASSAB, ISAAC",2,1,1
2801,3071600015,BK,2324 WEST 13 STREET,08,M1,BTSAR INC,2,1,1
2802,3071600071,BK,2335 STILLWELL AVENUE,01,A2,2335 STILLWELL AVE DNIB 2018 LLC,2,1,1
2803,3071780004,BK,396 AVENUE W,01,A1,"NAKASH, ALBERT",2,1,1
2804,3072900059,BK,2279 CONEY ISLAND AVENUE,05,O9,JAR REAL ESTATE GROUP LLC,2,1,1
2805,3072960081,BK,1921 EAST 17 STREET,01,B2,CASTRO EZRA,2,1,1
2806,3073170080,BK,2005 HOMECREST AVENUE,02,C0,YAKOUB SAADIA,2,1,1
2807,3073240069,BK,2039 EAST 19 STREET,01,A1,"MORDEKHAIEV, JOSEPH",2,1,1
2808,3073300077,BK,4111 BEDFORD AVENUE,01,B1,ISAAK ZAUROV,2,1,1
2809,3073450070,BK,2119 HOMECREST AVENUE,08,M1,YOUNG ISRAEL OF AVE U,2,1,1
2810,3073940050,BK,1024 LANCASTER AVENUE,01,A9,"HALFON, JENNIFER",2,1,1
2811,3073950013,BK,1030 CRAWFORD AVENUE,01,B1,"ALTHKEFATI, YOUSEF",2,1,1
2812,3074520001,BK,3021 KNAPP STREET,07,U9,NYC DEPARTMENT OF ENVIRONMENTAL PROTECTION,5,4,1
2813,3075920032,BK,931 EAST 28 STREET,01,B2,"KIMMEL, YITZCHOK",2,1,1
2814,3076230067,BK,1152 EAST 24 STREET,01,B2,"STERN, EDWARD",2,1,1
2815,3076240028,BK,1141 EAST 24 STREET,01,B2,KILBERG MORDECAI,2,1,1
2816,3076310033,BK,1129 EAST 31 STREET,01,A9,"LEBOVITS, ALLAN",2,1,1
2817,3076510047,BK,3316 AVENUE L,01,A1,KURLAND ETAH S,2,1,1
2818,3076700007,BK,1527 EAST 34 STREET,01,B1,SOL KESSLER,2,1,1
2819,3077960067,BK,1408 EAST 49 STREET,01,A5,"CONNELL, TYRON",2,1,1
2820,3078790012,BK,1559 EAST 54 STREET,01,B3,"ZOEY PROPERTIES, LLC",2,1,1
2821,3080050036,BK,8412 GLENWOOD ROAD,02,C0,"KELLY, ANGELA",2,1,1
2822,3080550022,BK,8827 STILLWELLS PLACE,01,A1,"AMINAH ELLIS, AN INCAPACITED PERSON",2,1,1
2823,3080610018,BK,1257 EAST 82 STREET,01,B1,LYDIA LAWRENCE M,2,1,1
2824,3081860033,BK,9802 GLENWOOD ROAD,01,B2,"ACOSTA, SYLVIA",2,1,1
2825,3081980036,BK,1217 REMSEN AVENUE,01,B3,"A//K/A GENE LAGUERRE, JEAN LAGUERRE",2,1,1
2826,3082350048,BK,430 LOUISIANA AVENUE,05,K6,SHERADEL ASSOCIATES,3,2,1
2827,3082390043,BK,1340 EAST 94 STREET,01,B2,"FLOYD, GREG",2,1,1
2828,3082440023,BK,1315 EAST 98 STREET,01,A2,"JARRETT, AUGHTON",2,1,1
2829,3082780057,BK,1530 EAST 95 STREET,01,A1,CARMINE MAROTTA,2,1,1
2830,3086530001,BK,6120 EAST 60 PLACE,09,Q2,NYC DEPARTMENT OF PARKS AND RECREATION,2,1,1
2831,3087630029,BK,1122 BLAKE COURT,01,B3,BRICK CASTLE LLC,2,1,1
2832,3088010082,BK,2831 BATCHELDER STREET,01,B2,"WALLIN, LAUREN",2,1,1
2833,3088040101,BK,2797 FORD STREET,01,B2,"LALO , VICTOR",2,1,1
2834,4000330037,QN,5-30 50 AVENUE,02,C2,SERIO HOLDING CORP,3,2,1
2835,4000457501,QN,47-34 11 STREET,03,RD,11 STREET LLC,3,2,1
2836,4002120008,QN,50-35 38 STREET,02,C2,"CHILINGARYAN, GEVORK",2,1,1
2837,4003300039,QN,35-34 11 STREET,06,E9,VERMA PUSHPINDER,2,1,1
2838,4003620008,QN,37-31 12 STREET,05,O2,KENKAY REALTY CORP,2,1,1
2839,4003970026,QN,39-24 28 STREET,01,A9,"KATSIFAS, COSTAS",2,1,1
2840,4006200022,QN,25-20 32 STREET,02,C3,"RAHMAN, FATEMA",2,1,1
2841,4007190015,QN,28-27 45 STREET,02,C2,V KIRSIC LLC,2,1,1
2842,4008080106,QN,21-69 37 STREET,01,B3,"BUSCEMI, JENNIFER",2,1,1
2843,4008740066,QN,24-17 21 STREET,01,A9,"KEREN, YOUAD",2,1,1
2844,4008910067,QN,19-19 23 AVENUE,01,A5,OFELIA C FABELLORE,2,1,1
2845,4010580105,QN,81-10 25 AVENUE,01,B2,"CUELLAR, GREGORIO",2,1,1
2846,4010700049,QN,22-66 94 STREET,01,B3,N Y S  FACILITIES DEV CORP,2,1,1
2847,4010850043,QN,23-68 92 STREET,01,A5,"TUALUMBO, ANGEL  G",2,1,1
2848,4010920001,QN,98-04 23 AVENUE,01,B2,"EADIE, IRVIN",2,1,1
2849,4011240001,QN,75-11 31 AVENUE,05,K6,ALLIED JACKSON HEIGHTS,3,2,1
2850,4011330051,QN,31-13 55 STREET,01,B3,"NEPO, ANNE",2,1,1
2851,4011590025,QN,32-34 58 STREET,02,C0,"DONG, CHANGYING",2,1,1
2852,4012380025,QN,52-30 39 DRIVE,03,D4,BERKELEY COOP TOWERS SEC 2,3,2,1
2853,4013130022,QN,,02,C0,"BAROT, SANJAY N",2,1,1
2854,4013460015,QN,68-06 WOODSIDE AVENUE,05,O2,JTRJ REALTY CORP.,2,1,1
2855,4013560025,QN,25-44 83 STREET,01,B3,"KHANDOKAR, AHMED S",2,1,1
2856,4014010022,QN,31-34 90 STREET,01,A5,"HERRERA, RICARDO",2,1,1
2857,4014350001,QN,87-10 NORTHERN BOULEVARD,04,K4,BARNIK ASSOCIATES LLC,2,1,1
2858,4014520011,QN,34-14 92 STREET,02,C0,"VILLA, MARIA",2,1,1
2859,4014810039,QN,37-52 94 STREET,01,B2,"ROMERO, ALBERTO",2,1,1
2860,4015440061,QN,48-39 POYER STREET,02,C0,"WZ POYER, LLC",2,1,1
2861,4015890096,QN,94-20 ROOSEVELT AVENUE,05,K2,MACPIN LLC,2,1,1
2862,4016160007,QN,41-07 99 STREET,04,S2,C & Q LLC,2,1,1
2863,4016890031,QN,31-46 103 STREET,01,B1,"PEREZ, HECTOR H",2,1,1
2864,4017370039,QN,35-51 JUNCTION BOULEVARD,04,K4,BIASSI ENZO,2,1,1
2865,4017430023,QN,35-38 103 STREET,01,B1,"ZUMBA, CLAUDIA",2,1,1
2866,4017860113,QN,112-32 39 AVENUE,02,C1,WWLC 39 AVE  LLC,2,1,1
2867,4018960027,QN,53-03 96 STREET,01,B3,"YU, LEY CHOI",2,1,1
2868,4019060014,QN,55-23 97 PLACE,01,B2,"ALVAREZ, MARIA",2,1,1
2869,4019300036,QN,50-35 102 STREET,02,C0,"WONG, PAN HONG",2,1,1
2870,4019420110,QN,51-13 103 STREET,02,C0,"ZHENG , LIANGJIN",2,1,1
2871,4019440036,QN,53-21 103 STREET,01,B2,"SU, YOU SHUI",3,2,1
2872,4019590001,QN,105-26 OTIS AVENUE,02,C3,FAJARDO LUIS,3,2,1
2873,4019840050,QN,104-61 41 AVENUE,01,B2,PABLO ANTONIO BRITO,2,1,1
2874,4019860042,QN,42-18 108 STREET,01,B3,ZOILA Y CORDOVA,2,1,1
2875,4020100004,QN,109-22 54 STREET,01,B2,JOSE GARCIA,2,1,1
2876,4023660038,QN,55-02 64 STREET,01,A1,ALEX J ROJOWSKY,2,1,1
2877,4024840080,QN,52-78 73 STREET,01,A5,"YOU, LONG FEI",2,1,1
2878,4027110071,QN,61-56 56 DRIVE,01,B1,"XU, JIN FENG",2,1,1
2879,4027280087,QN,60-19 59 ROAD,01,B2,"ORTIZ, ANTONIO",2,1,1
2880,4027570057,QN,62-63 60 ROAD,01,B2,PAUL NIEWINSKI,2,1,1
2881,4029170051,QN,57-39 81 STREET,01,A1,"MISCICKA, HANNA",2,1,1
2882,4030030021,QN,64-28 78 STREET,01,A5,"HECKEL JR., WALTER A",2,1,1
2883,4030300103,QN,64-28 PLEASANTVIEW STREET,10,G0,"TANTILLO, SALVATORE",2,1,1
2884,4030370021,QN,75-36 65 DRIVE,01,A1,WAWRZONEK ROBERT,2,1,1
2885,4030690025,QN,66-11 79 STREET,01,B3,"DEMARTINO, KIMMARIE",2,1,1
2886,4032230039,QN,94-07 71 AVENUE,01,A5,"IYER, JAYASHREE",2,1,1
2887,4032360035,QN,70-25 YELLOWSTONE BLVD,03,D4,GERARD OWNERS CORP,3,2,1
2888,4032800054,QN,74-05 KESSEL STREET,01,A5,"WYCZOLKOWSKI, BARBARA",2,1,1
2889,4033820036,QN,2032 GREENE AVENUE,02,C0,"LU, HUI QIN",2,1,1
2890,4035380067,QN,71-13 60 LANE,03,D3,NEW RIDGEWOOD LLC,2,1,1
2891,4035520035,QN,1646A GEORGE STREET,10,G1,A & ET REALTY CORP.,3,2,1
2892,4037310017,QN,80-28 59 STREET,01,B2,"GARCIA, EDIVIA",2,1,1
2893,4037330109,QN,80-06 64 LANE,01,B3,ALI KAROUT,2,1,1
2894,4037850026,QN,73-33 69 AVENUE,02,C0,"HOXHA, SABAN",2,1,1
2895,4038170037,QN,79-77 77 ROAD,01,A0,"CAROLE M. PALLADINO, AS TO ONE-HALF SHAR E",2,1,1
2896,4038290094,QN,78-11 79 LANE,02,C0,HOFFMANN ERICH,2,1,1
2897,4038530108,QN,88-23 RUTLEDGE AVENUE,01,A5,CONONICO FAMILY IRREV TRUST UA DATED 10- 11-19,2,1,1
2898,4041630010,QN,20-27 120 STREET,01,B2,"CHEN, SONG",2,1,1
2899,4042240030,QN,23-14 121 STREET,01,B2,PATRICIA J TAYLOR,2,1,1
2900,4044370173,QN,11-10 MALBA DRIVE,01,A1,"LOVISEK, ROBERT",2,1,1
2901,4044670005,QN,148-12 2 AVENUE,01,A3,"SACCO, EMILIA",2,1,1
2902,4045910096,QN,10-01 162 STREET,03,D4,LE HAVRE OWNERS CORP,2,1,1
2903,4046630043,QN,149-46 15 ROAD,01,B1,NICK KOKKINOS,2,1,1
2904,4046970011,QN,14-68 CLINTONVILLE STREET,07,G3,WHITESTONE PLAZA ASSOC,2,1,1
2905,4048340071,QN,151-33 29 AVENUE,01,B1,"QIU, DEVON QIAO",2,1,1
2906,4049420041,QN,34-40 COLLEGE POINT BLVD,06,F1,A.J. PEGNO CONSTRUCTION CORP.,2,1,1
2907,4050160018,QN,147-10 NORTHERN BOULEVARD,07,G4,147TH AND NORTHERN LLC,2,1,1
2908,4051020049,QN,132-29 POPLE AVENUE,01,A2,"168 J, LLC",2,1,1
2909,4052330019,QN,143-48 POPLAR AVENUE,01,A1,"PONCE, CARLOS",2,1,1
2910,4052380019,QN,33-47 153 STREET,01,A1,"HONG, SUNG WOO",2,1,1
2911,4052920017,QN,35-49 168 STREET,01,A2,BOZZOLO RICHARD J,2,1,1
2912,4053770006,QN,42-15 147 STREET,08,M1,TENRIKYO MISSION NY/CNTR,2,1,1
2913,4054600040,QN,46-16 162 STREET,01,B2,UNAVAILABLE OWNER,2,1,1
2914,4055110089,QN,43-57 172 STREET,01,A1,"SKAFIDAS, NICOLAS M",2,1,1
2915,4055150063,QN,189-51 45 AVENUE,01,A1,"CARCAMO, JOSE DANIEL",2,1,1
2916,4056840038,QN,56-12 197 STREET,01,A1,"ZHONG , CLARA  M",3,2,1
2917,4059710026,QN,28-50 200 STREET,01,A1,PILOTTI ERIC,2,1,1
2918,4061710001,QN,36-06 213 STREET,02,C6,UNAVAILABLE OWNER,11,10,1
2919,4062980025,QN,214-16 42 AVENUE,02,C2,CRE REALTY CORP,2,1,1
2920,4062987501,QN,42-28 214 PLACE,02,R2,UNAVAILABLE OWNER,2,1,1
2921,4063600023,QN,135-02 BOOTH MEMORIAL AVE,02,C0,"DONG, SHI YI",2,1,1
2922,4064990045,QN,64-26 137 STREET,01,A5,JACQUELINE TUTEUR,2,1,1
2923,4066320001,QN,141-48 78 ROAD,02,C6,REGENCY GARDENS APARTMENT CORP,20,19,1
2924,4068650395,QN,161-14 GRAND CENTRAL PKWY,01,A5,"GOMEZ, MAGALIS",2,1,1
2925,4075280037,QN,221-58 58 AVENUE,01,B2,"LEE, KUK LAM",2,1,1
2926,4080360010,QN,316 GROSVENOR STREET,01,A3,"MKHITARIAN, ARMOND",2,1,1
2927,4080980075,QN,29 WILLOW STREET,01,A1,FARINA YINFUN WANG REVOCABLE TRUST,2,1,1
2928,4082320375,QN,249-07 RUSHMORE TERRACE,01,A2,"MAROTI, THOMAS J",2,1,1
2929,4082760500,QN,244-51 61 AVENUE,01,A1,MARATHON JEWISH COMMUNITY CENTRE,2,1,1
2930,4085950047,QN,83-43 252 STREET,01,A1,MASSOWD BRENDA,2,1,1
2931,4087000020,QN,79-19 263 STREET,01,A3,"79-19 263RD STREET, LLC",2,1,1
2932,4088830095,QN,95-05 JAMAICA AVENUE,02,C1,PIK KWUN WONG,2,1,1
2933,4089100034,QN,88-33 78 STREET,01,B2,"AYALA, ROBERT",2,1,1
2934,4089340008,QN,93-22 JAMAICA AVENUE,05,O5,"WOODHAVEN ASSOCIATES,",3,2,1
2935,4089440023,QN,90-22 75 STREET,02,C0,"HICIANO, ANNIE M",2,1,1
2936,4090140025,QN,83-07 95 AVENUE,01,B2,EDGAR S MARTINEZ,2,1,1
2937,4090970017,QN,90-09 103 AVENUE,01,B9,LAWRENCE J RUVOLO,2,1,1
2938,4091460015,QN,105-22 86 STREET,01,A9,"GOPEZ, AMELITA BENITA A.",2,1,1
2939,4091530070,QN,105-19 88 STREET,01,A1,"CARPIO, LUIS A",2,1,1
2940,4091670029,QN,106-40 97 STREET,01,B3,"CAROLLO, MARIA CONCETTA",3,2,1
2941,4092160041,QN,85-78 111 STREET,01,A1,EVELYN PLAZA,2,1,1
2942,4092490094,QN,84-57 127 STREET,02,C0,"LIN, SHU HUI",2,1,1
2943,4092830011,QN,86-26 132 STREET,01,B2,"JERONIMO, CARLOS",2,1,1
2944,4093050071,QN,87-29 115 STREET,01,B3,"MOHAMED, LILOWTI",2,1,1
2945,4094270050,QN,101-51 109 STREET,01,B2,LALOO HANSRAJ,2,1,1
2946,4095710066,QN,104-21 117 STREET,01,A1,"PERSAUD, HARRYDIAL",2,1,1
2947,4096040051,QN,124-05 109 AVENUE,01,A1,"RAGBIR, NANDARAM",2,1,1
2948,4096760001,QN,89-01 146 STREET,04,S1,NAREMDRA D PATEL,2,1,1
2949,4096890025,QN,144-34 HILLSIDE AVENUE,04,S4,144-34 HILLSIDE REALTY CORP.,2,1,1
2950,4097760041,QN,161-02 NORMAL ROAD,01,A1,"ALAM, MD ZAHIRUL",2,1,1
2951,4099110019,QN,90-09 187 STREET,01,B1,DRUPATIE GAJADHAR,2,1,1
2952,4099260016,QN,89-09 185 STREET,01,A1,"RAMRATTAN, NORDICA",3,2,1
2953,4100070001,QN,143-02 95 AVENUE,06,E2,"SNAI REALTY, LLC",3,2,1
2954,4101240021,QN,106-38 157 STREET,07,G2,"AMAN REALTY, LLC",2,1,1
2955,4102160013,QN,92-14 177 STREET,01,B3,"KUTUB, SAL",2,1,1
2956,4102450163,QN,107-30 171 STREET,10,G0,KAZI REALTY LTD,2,1,1
2957,4105380100,QN,86-61 DUNTON STREET,01,A2,"ENG, MICHAEL KAT",2,1,1
2958,4108900007,QN,194-14 104 AVENUE,01,B3,"WILLIAMS , MYRTLE  M",2,1,1
2959,4109040041,QN,104-29 204 STREET,01,B2,SANDRA SPENCER,2,1,1
2960,4109050017,QN,202-20 109 AVENUE,01,B2,HOLLIS PARTNERS LLC,2,1,1
2961,4109510084,QN,190-40 111 ROAD,01,A1,"CAMPBELL, NICHOLAS S",2,1,1
2962,4110720032,QN,200-14 116 AVENUE,01,A1,MONIQUE DESULME,3,2,1
2963,4110880029,QN,102-14 215 STREET,01,A2,TOWNSEND  JUANITA,2,1,1
2964,4111500027,QN,108-09 217 PLACE,01,B2,"PINNOCK, DONOVAN",2,1,1
2965,4112690030,QN,114-68 226 STREET,01,A5,"WILSON, JUAN E",2,1,1
2966,4114880001,QN,132-33 CROSS BAY BOULEVARD,04,S3,"DE SENA , INGRA",3,2,1
2967,4116700054,QN,115-25 126 STREET,01,A5,"NOEL, GREGORY",2,1,1
2968,4116870021,QN,116-30 LINCOLN STREET,01,A1,TAT BUILDERS CORP.,2,1,1
2969,4117620009,QN,124-01 133 AVENUE,01,A9,"WILLIAMS, LEWIN",3,2,1
2970,4118200023,QN,149-15 LEFFERTS BOULEVARD,01,B2,"PARKASH, DHARAM",2,1,1
2971,4119450062,QN,107-52 SUTPHIN BOULEVARD,04,S9,GERBERT BONHOMME,3,2,1
2972,4119630062,QN,111-57 146 STREET,01,A1,"ASGAR, NADERA",2,1,1
2973,4119630075,QN,111-25 146 STREET,01,A1,"BRASSE, RABINDRANAUTH",2,1,1
2974,4119650120,QN,111-17 148 STREET,01,A5,"BUSH, DENNIS",2,1,1
2975,4119840031,QN,115-05 140 STREET,01,B3,"BRANNON, ANTHONY",2,1,1
2976,4120380055,QN,142-67 123 AVENUE,01,A1,CARTER CYNTHIA,2,1,1
2977,4120610046,QN,126-11 143 STREET,01,A1,"ROMAN, MARY ANN",2,1,1
2978,4120650166,QN,142-25 129 AVENUE,01,A1,ERNST ARNOUX,2,1,1
2979,4121410013,QN,109-26 153 STREET,02,C0,GLORIA JACK,4,3,1
2980,4121710039,QN,111-36 157 STREET,01,A1,MOBLEY NANCY,2,1,1
2981,4121870020,QN,155-26 114 ROAD,01,B2,"MOORE , LEONARDO",2,1,1
2982,4121950033,QN,158-17 115 ROAD,01,B2,"RAMGOOLAM, DEUENDRA",2,1,1
2983,4122200003,QN,121-15 153 STREET,01,A2,"MCNAUGHTON, ANDREA",2,1,1
2984,4122800048,QN,132-47 155 STREET,01,B3,"PERSAUD, LILWATTIE",2,1,1
2985,4123690018,QN,168-32 118 AVENUE,01,A1,JULIA REED,2,1,1
2986,4124060100,QN,180-20 LINDEN BOULEVARD,08,I1,DASNY,14,13,1
2987,4124060312,QN,179-24 LINDEN BOULEVARD,05,O7,J. FOSTER/P/FUNERALHOME,2,1,1
2988,4124950002,QN,163-15 BAISLEY BOULEVARD,03,D4,ROCHDALE VILLAGE INC,29,28,1
2989,4125460234,QN,176-23 133 AVENUE,01,A5,"PORCH, DANIEL",2,1,1
2990,4125680006,QN,173-07 137 AVENUE,01,A1,TOTTEN MICHAEL W,3,2,1
2991,4128250039,QN,218-26 121 AVENUE,01,A2,ABRAHAM TYLER,2,1,1
2992,4128740023,QN,128-39 233 STREET,01,A1,"GREENE BRYAN, MARILYN",3,2,1
2993,4129560025,QN,217-18 133 ROAD,01,A1,BASTIEN SOEURETTE M,2,1,1
2994,4129700012,QN,133-31 FRANCIS LEWIS BLVD,01,A5,MARGIE GINN,2,1,1
2995,4129710046,QN,133-16 232 STREET,01,A2,LUNO AMBROISE,2,1,1
2996,4130410027,QN,140-40 184 STREET,01,B1,FEDERAL HOME LOAN MORTGAGE CORPORATION,2,1,1
2997,4130430025,QN,185-06 140 AVENUE,01,B3,SANDRA M DEANS,2,1,1
2998,4130430055,QN,140-30 COOMBS STREET,02,C5,"BADAL, MICHAEL",2,1,1
2999,4130740116,QN,179-21 144 AVENUE,01,B2,"WATKINS, ARLEATHIA",2,1,1
3000,4130890038,QN,179-42 144 AVENUE,01,B3,"SNIPLEY, JOSEPH",2,1,1
3001,4131060032,QN,134-27 225 STREET,01,B3,JOEL SPENCER,2,1,1
3002,4131080047,QN,134-34 228 STREET,01,A1,"LAKE, DAVID",2,1,1
3003,4132050025,QN,134-23 241 STREET,01,A1,"FRANK, LINTON",2,1,1
3004,4132510019,QN,236 136 ROAD,01,Z0,UNAVAILABLE OWNER,2,1,1
3005,4132530021,QN,247-32 137 ROAD,01,A1,STATHOPOULOS OURANIA,2,1,1
3006,4132860026,QN,167-39 145 DRIVE,01,B3,"LASHLEY, MONA",2,1,1
3007,4134640029,QN,146-17 230 STREET,01,B2,"CHARLEUS, BERTHA",2,1,1
3008,4134850015,QN,145-31 228 STREET,04,K4,GETHSEMANE SOUL SAV/ST/I,2,1,1
3009,4135890073,QN,257-31 145 AVENUE,01,A1,JOHN PARDOVANI,2,1,1
3010,4141630104,QN,158-35 CROSS BAY BOULEVARD,,Z9,ROSARIO BIORDI RESIDUARY TRUST,2,1,1
3011,4150090019,QN,144-44 157 STREET,01,A1,"RAMNATH, HARRYLAL",2,1,1
3012,4154600015,QN,803 CHURCH ROAD,01,A1,"PANETTA, JOSEPH",2,1,1
3013,4155710022,QN,8-27 CORNAGA AVENUE,08,M1,BEIS MEDRASH ATERES Y,2,1,1
3014,4156640070,QN,23-13 ENRIGHT ROAD,01,B9,"CHAND, TRAVIN D",2,1,1
3015,4157530106,QN,645 GRASSMERE TERRACE,01,B2,"MOHAMED, AFRAZ",2,1,1
3016,4159530009,QN,418 BEACH 37 STREET,01,B3,WHITE RAYMOND F,2,1,1
3017,4160420022,QN,446 BEACH 69 STREET,01,A1,MAYA HOMES LLC,2,1,1
3018,4160500058,QN,69-46 THURSBY AVENUE,01,A2,"WILLIAMS, MARCIA",2,1,1
3019,4162100042,QN,410 BEACH 129 STREET,05,K1,M & G REAL ESTATE CORP.,2,1,1
3020,4162100056,QN,430 BEACH 129 STREET,04,K4,MARONEY LAURA,2,1,1
3021,4162810042,QN,129 BEACH 136 STREET,01,A1,"AUSTIN, KENNETH B",2,1,1
3022,4163130043,QN,2-28 BEACH 149 STREET,01,A1,"KALINA, CECILIE",2,1,1
3023,5000250043,SI,62 SHERMAN AVENUE,02,C0,"CESPEDES, INNA",2,1,1
3024,5000330001,SI,199 VICTORY BOULEVARD,08,M1,UNITED CHRISTIAN CHUR,3,2,1
3025,5000540037,SI,47 HIGHVIEW AVENUE,01,A1,"MALLEN, MICHAEL",2,1,1
3026,5000870067,SI,137 ALDEN PLACE,01,A1,"ROHRIG, JOANN",2,1,1
3027,5001500265,SI,185 BEMENT AVENUE,01,A1,"CERIBELLO, JAMES",3,2,1
3028,5001500440,SI,172 OAKLAND AVENUE,01,A2,"WRIGHT, GEORGE",2,1,1
3029,5001510095,SI,289 PELTON AVENUE,01,A1,MATTHEW RILEY,2,1,1
3030,5001510123,SI,241 PELTON AVENUE,01,A1,F GIORDANO,2,1,1
3031,5001640112,SI,475 BEMENT AVENUE,04,S1,PRIGNOLI ROBERT,2,1,1
3032,5001960023,SI,147 ALASKA STREET,01,A1,"MENDEZ-COLON, LUIS",2,1,1
3033,5002100021,SI,29 ROE STREET,01,A1,"ALVARADO JORDAN, CARLOS ROBERT",2,1,1
3034,5002380141,SI,1163 FOREST AVENUE,05,O2,BELVEDERE  PROPERTIES LLC,2,1,1
3035,5002920089,SI,23 NUTLY PLACE,01,A1,"RUFOLO, SALVATORE A",2,1,1
3036,5003290323,SI,58 LAKELAND ROAD,01,A0,KEVIN P. MARSHALL,2,1,1
3037,5003540047,SI,172 LLEWELLYN PLACE,02,C3,VASILIKE ZOUGRAS,2,1,1
3038,5003600039,SI,181 MAINE AVENUE,01,A1,"PERROTTA, JOSEPH",2,1,1
3039,5003760192,SI,176 KEIBER COURT,01,A1,STEPHEN M JANSKY,2,1,1
3040,5005170030,SI,309 ST PAULS AVENUE,08,M1,TRINITY EVAN LUTH CHURCH,2,1,1
3041,5005190082,SI,387 ST PAULS AVENUE,01,A1,"BROWN, WILLIAM TED",3,2,1
3042,5005210095,SI,104 BEACH STREET,04,S9,"GOFFREDO, MARIE",2,1,1
3043,5006940148,SI,84 WINDSOR ROAD,01,A1,"TESTA-SMITH, MARILYN",2,1,1
3044,5008040011,SI,99 PORTAGE AVENUE,01,A5,ANTONIO LOPICCOLO,2,1,1
3045,5008130014,SI,123 WELLBROOK AVENUE,01,A5,"MIZRAHI, JONATHAN",2,1,1
3046,5008260001,SI,47 TAFT COURT,01,A3,ELLEN DOLLINGER ABRAM,2,1,1
3047,5009390087,SI,8 NIGHTINGALE STREET,01,A2,"COPPOLO JR., JOESPH",3,2,1
3048,5009480014,SI,15 BEACON AVENUE,01,B2,ROBERT REFANO,2,1,1
3049,5010140019,SI,124 JEWETT AVENUE,01,B2,"AIELLO, CYNTHIA",2,1,1
3050,5010440025,SI,469 HEBERTON AVENUE,01,A1,"JACOBS, JENNY",2,1,1
3051,5010840014,SI,115 TREADWELL AVENUE,01,A1,DAVID TACORONTE,2,1,1
3052,5011760018,SI,293 SIMONSON AVENUE,01,B2,WILLIAM P BUTLER,2,1,1
3053,5011860076,SI,20 SIMONSON AVENUE,01,A1,MARGARET F. DIBERARDI,2,1,1
3054,5012550033,SI,25 ARLINGTON PLACE,01,A2,KRISTJU ALEXIEV,2,1,1
3055,5012630103,SI,56 SOUTH AVENUE,01,A1,GUEVARA LUCILA,2,1,1
3056,5014360031,SI,15 PONTIAC STREET,01,A1,ADELE KOSINSKI,2,1,1
3057,5015080127,SI,49 CANTERBURY AVENUE,01,A2,J CAMBRIELLO,2,1,1
3058,5015970202,SI,321D HILLMAN AVENUE,01,A5,"RODRIGUEZ, MAGEN",2,1,1
3059,5021620100,SI,502 GRAHAM AVENUE,01,A2,A MACRI,2,1,1
3060,5022920067,SI,458 ST GEORGE ROAD,01,A2,"ANZALONE, MEGAN",2,1,1
3061,5029700012,SI,8 SMITH STREET,01,A1,"MAGRAS, THERESA R",2,1,1
3062,5029720070,SI,162 ST MARYS AVENUE,04,C7,"AMPP HOLDINGS, LLC",5,4,1
3063,5031110063,SI,74 MILLS AVENUE,01,B1,MILLS SI LLC,2,1,1
3064,5032470035,SI,81 KENSINGTON AVENUE,01,B2,"TERRANOVA, JOSEPH M",2,1,1
3065,5032540028,SI,266 KENSINGTON AVENUE,01,A1,"CHEN, JIANWEN",2,1,1
3066,5033480006,SI,52 LACONIA AVENUE,01,A1,"GABDURAKHMANOVA, SONIA",2,1,1
3067,5033780047,SI,422 CROMWELL AVENUE,01,B9,"SARINA SANFELICE, AS TRUSTEE",2,1,1
3068,5033780098,SI,344 CROMWELL AVENUE,01,B2,RALPH ESPOSITO,2,1,1
3069,5033910016,SI,349 PARKINSON AVENUE,01,A1,MARIO COLANGELO IRREVOCABLE TRUST,2,1,1
3070,5034110096,SI,21 MC LAUGHLIN STREET,01,A2,EDWARD CLARKE,2,1,1
3071,5034120074,SI,61 PEARSALL STREET,01,A2,MIKHAIL BOCHAROV,2,1,1
3072,5035560006,SI,153 JEFFERSON AVENUE,01,B2,"CAMI, MUSTAFA",2,1,1
3073,5035610044,SI,200 HULL AVENUE,01,A2,"LOW, SHEUE WAH",2,1,1
3074,5036140008,SI,2233 HYLAN BOULEVARD,05,K1,"SSJ ASSOCIATES, LLC",2,1,1
3075,5038140014,SI,1094 OLYMPIA BOULEVARD,01,A6,E GARCIA,2,1,1
3076,5038140015,SI,1092 OLYMPIA BOULEVARD,01,A6,E SHEA,3,2,1
3077,5038810024,SI,510 LINCOLN AVENUE,01,A5,"CHEN, WU",2,1,1
3078,5041920010,SI,135 3 STREET,01,B2,RAMIN MOSTAFAVI,2,1,1
3079,5042660034,SI,123 OAK AVENUE,01,A1,ANTHONY M CAROLLO,2,1,1
3080,5044210055,SI,305 AMBER STREET,01,A1,"FRIEDHOFF, JASON A",2,1,1
3081,5052870048,SI,15 PACIFIC AVENUE,01,A1,"15 PACIFIC AVE, LLC",2,1,1
3082,5053080010,SI,131 GOODALL STREET,01,B2,PAUL HORMANN JR,2,1,1
3083,5053100101,SI,49 HEINZ AVENUE,01,A5,"CHOUINARD, RAYMOND JR",2,1,1
3084,5053150034,SI,74 ARMSTRONG AVENUE,01,A6,"ETTLINGER, ANN",2,1,1
3085,5054080005,SI,194 BATHGATE STREET,01,A5,QIONG XIAO XU,2,1,1
3086,5054330006,SI,15 BROWER COURT,04,S9,604 FOUNTAIN AVENUE REALTY CORP,2,1,1
3087,5055070033,SI,89 ELTINGVILLE BLVD,01,A1,JAMES E AMBERGER,2,1,1
3088,5055900037,SI,62 SYLVIA STREET,01,B2,MARROCCO FERRUCCIO,2,1,1
3089,5062270060,SI,924 CARLTON BOULEVARD,01,A1,"DEMARTINO, ANTHONY",2,1,1
3090,5062430018,SI,6 SHERIDAN PLACE,01,A2,"BALK, HELEN A",2,1,1
3091,5065340017,SI,358 ARBUTUS AVENUE,01,A1,"ABOUSHI, AYMEN",2,1,1
3092,5067240004,SI,25 BAYVIEW AVENUE,01,A1,DOLORES V STEIGER,2,1,1
3093,5069010295,SI,5941 AMBOY ROAD,04,O8,AMBOY STEFE LLC,3,2,1
3094,5069750145,SI,6137 AMBOY ROAD,01,A1,EDWARD AND LISA CHILLE,2,1,1
3095,5070720011,SI,2490 ARTHUR KILL ROAD,01,A1,2512 ARTHUR KILL ROAD LLC,2,1,1
3096,5076640001,SI,6581 HYLAN BOULEVARD,08,N2,NYS DEPARTMENT OF ENVIRONMENTAL CONSERVATION,38,37,1
3097,5078600203,SI,399 LORETTO STREET,01,A1,"NISMAN, DIANA R",2,1,1
3098,5078620036,SI,674 ROCKAWAY STREET,01,B2,PETER LUNAROLA,2,1,1
3099,5080250047,SI,5372 ARTHUR KILL ROAD,01,B2,RALPH G PEPE,3,2,1
3100,5080460059,SI,358 CRAIG AVENUE,01,A1,"PAOLUCCIO, JAMES",2,1,1
3101,1000030010,MN,1 SOUTH STREET,05,O2,UNITED STATES AMERICA,2,1,1
3102,1003380001,MN,60 PITT STREET,04,D6,NYC HOUSING AUTHORITY,4,3,1
3103,1004100016,MN,95 RIVINGTON STREET,04,S2,95 RIVINGTON LLC,2,1,1
3104,1006940040,MN,512 WEST 23 STREET,11,V4,NEW YORK CENTRAL LINES,2,1,1
3105,1008260065,MN,40 WEST 25 STREET,05,O6,40 W 25 LLC,2,1,1
3106,1010320063,MN,574 9 AVENUE,04,S5,MOLLANEY LLC C/O SAND,2,1,1
3107,1010460036,MN,939 8 AVENUE,04,K4,EIGHTH & 56TH ASSOCIATES,4,3,1
3108,1010740048,MN,534 WEST 46 STREET,02,C6,534 WEST 46 STREET HO,2,1,1
3109,1011430020,MN,133 WEST 71 STREET,03,D3,"133 WEST,",2,1,1
3110,1013730035,MN,2 WEST LOOP ROAD,08,W6,NYC DEPARTMENT OF CITYWIDE ADMINISTRATIVE SERVICES,2,1,1
3111,1014970034,MN,1020 PARK AVENUE,03,D4,1020 PARK AVE INC-C/O BHS (C10200),2,1,1
3112,1015260025,MN,1551 2 AVENUE,05,K2,A&M REAL ESTATE INC,2,1,1
3113,1016390021,MN,163 EAST 111 STREET,08,M1,FIRST SPANISH ETAL,2,1,1
3114,1021230104,MN,509 WEST 167 STREET,01,B1,509 WEST 167TH STREET LLC,2,1,1
3115,1021260035,MN,514 WEST 170 STREET,08,Y1,FIRE DEPARTMENT OF NEW YORK,2,1,1
3116,2023070017,BX,447 WILLIS AVENUE,05,K2,HEUNG YOP CHUNG,3,2,1
3117,2026570017,BX,772 EAST 161 STREET,04,S9,772 E 161 LLC,2,1,1
3118,2026890015,BX,870 EAST 161 STREET,01,B1,RAFAEL CARRERO,2,1,1
3119,2027080014,BX,721 BECK STREET,02,C0,"WELDON, KERRY",2,1,1
3120,2027190013,BX,905 EAST 169 STREET,01,B2,ARITA MARIO,2,1,1
3121,2028290034,BX,,11,V0,E&G WALTON DEVELOPERS LLC,2,1,1
3122,2028720307,BX,1466 JESUP AVENUE,02,C0,BERTRAM D SQUIRES,2,1,1
3123,2029080020,BX,450 EAST 176 STREET,05,O2,JORGE ANTHONY,2,1,1
3124,2029680033,BX,1282 UNION AVENUE,01,A1,"RICHARDS, LESLIE",2,1,1
3125,2029930039,BX,1222 BRYANT AVENUE,02,C0,"AYALA D., EVELYN",2,1,1
3126,2032140046,BX,2533 GRAND AVENUE,01,A1,2533 GRAND REALTY CORP.,3,2,1
3127,2032730203,BX,2533 CAMBRELENG AVENUE,01,B2,FORDHAM UNIVERSTY,2,1,1
3128,2032790013,BX,392 OLIVER PLACE,02,C1,392 OLIVER ASSOCIATES LLC,2,1,1
3129,2032850045,BX,2973 DECATUR AVENUE,02,C0,"RASOOL, GULSHAN",2,1,1
3130,2033290067,BX,3603 BAINBRIDGE AVENUE,02,C0,MANUEL GARCIA,3,2,1
3131,2033450031,BX,3151 HULL AVENUE,04,S2,"AMPARO, MARINO",2,1,1
3132,2034730015,BX,320 UNDERHILL AVENUE,01,B2,"VALDEZ, MARIO L",2,1,1
3133,2036900031,BX,813 HAVEMEYER AVENUE,01,A1,"GONZALEZ, REYNALDO",2,1,1
3134,2038320059,BX,2351 NEWBOLD AVENUE,08,M1,"BAITUL AMAN ISLAMICCENTER, INC.",2,1,1
3135,2038610145,BX,1353 BRONX RIVER AVENUE,01,B1,"CRUZ, LUIS",2,1,1
3136,2041020039,BX,1728 COLDEN AVENUE,01,A1,"DEEN, RENNY",2,1,1
3137,2041030014,BX,1727 HONE AVENUE,01,A1,"BUETI, ANTONELLA",2,1,1
3138,2041570045,BX,1635 PILGRIM AVENUE,01,B3,"MURFITT, DARLENE",2,1,1
3139,2042960014,BX,2008 BOGART AVENUE,01,B1,"CASTIGLIA, ANNA",2,1,1
3140,2043100030,BX,2100 WILLIAMSBRIDGE ROAD,07,G3,PELHAM BRIDGE REALTIES LLC,2,1,1
3141,2044650010,BX,2414 BOUCK AVENUE,01,B3,"RODRIGUEZ, DAUDI",2,1,1
3142,2046610010,BX,706 EAST 214 STREET,08,M1,MT MORIAH CRIST CHURCH,2,1,1
3143,2046780076,BX,3821 BRONXWOOD AVENUE,08,M9,GOSPEL ASSEMBLEY CHURCH/JESUS CHRIST APO STOLIC.,7,6,1
3144,2047060016,BX,1131 EAST 211 STREET,01,B9,"LEWIS, HELENA",2,1,1
3145,2047600051,BX,3152 SEYMOUR AVENUE,01,B1,"GUTIERREZ, JONATHAN",2,1,1
3146,2047780007,BX,3143 EDSON AVENUE,01,A2,"RICHARDS, HILDA",2,1,1
3147,2048380071,BX,740 EAST 225 STREET,02,C2,"SHLLAKU, SIMON",2,1,1
3148,2050390061,BX,4344 RICHARDSON AVENUE,02,C0,SHIVBACHAN LALJI,2,1,1
3149,2050540051,BX,4369 GRACE AVENUE,01,A2,"LONDON, BRENDA",2,1,1
3150,2051050059,BX,4751 MATILDA AVENUE,01,A1,"RAMPERSAUD, CHANDRAWATEE",3,2,1
3151,2051050076,BX,4723 MATILDA AVENUE,02,C0,"BOYD, CYNTHIA",3,2,1
3152,2053070075,BX,2715 BRUCKNER BOULEVARD,10,G0,"LOPEZ, ESTEBAN JR.",2,1,1
3153,2053920027,BX,1411 CROSBY AVENUE,01,B3,"GRECO, JUDITH",2,1,1
3154,2053960043,BX,1522 GILLESPIE AVENUE,01,B1,"HERNANDEZ, WANDA",2,1,1
3155,2054100247,BX,1455 KENNELLWORTH PLACE,02,C0,SCHULTZ HARRY,2,1,1
3156,2054110106,BX,1478 DWIGHT PLACE,01,B3,"DE PALMA, MICHAEL",2,1,1
3157,2055440025,BX,825 REVERE AVENUE,02,C0,JMOON LLC,2,1,1
3158,2056330144,BX,110 TIER STREET,01,A1,SAMUEL CHERMIN,2,1,1
3159,2056450009,BX,414 CITY ISLAND AVENUE,05,K1,414 CITY ISLAND LLC,2,1,1
3160,2056460056,BX,458 MINNIEFORD AVENUE,01,A1,MATURO FRANCES,2,1,1
3161,2056480024,BX,633 KING AVENUE,01,A2,"PARADISO, PATRICK J",2,1,1
3162,2056530100,BX,2580 FLINT AVENUE,01,A2,"MOHAMMED, IMRAM",2,1,1
3163,2058141191,BX,6155 BROADWAY,04,D6,"STAGG CONSTRUCTION II, LLC",2,1,1
3164,2058512058,BX,5604 POST ROAD,01,A1,DURAN JOHN SOHIGIAN,2,1,1
3165,2058831165,BX,304 WEST 262 STREET,01,A1,"LINDEN, ETHAN I",2,1,1
3166,2059420155,BX,615 WEST 252 STREET,01,A2,ARLINGTON 252 LLC,2,1,1
3167,3004070025,BK,596 BALTIC STREET,02,C3,596 BALTIC LLC,2,1,1
3168,3007940064,BK,737 51 STREET,01,B3,"WU, QI QING",2,1,1
3169,3012370058,BK,1143 PARK PLACE,01,B1,IRVING CALLENDER,2,1,1
3170,3012920020,BK,1346 CARROLL STREET,01,A4,"KRINSKY, LEVI Y",2,1,1
3171,3013610030,BK,1222 ST MARKS AVENUE,02,C2,EL DORADO LP C/O BLAC,2,1,1
3172,3014130050,BK,701 CROWN STREET,01,B1,"BEN-ONI, GOLAN",2,1,1
3173,3014700011,BK,537 RALPH AVENUE,02,C0,NYC HOUSING AUTHORITY,4,3,1
3174,3014910012,BK,892 HANCOCK STREET,02,C1,"DCA 1 APARTMENTS, INC.",3,2,1
3175,3015190157,BK,185 SUMPTER STREET,01,B1,WESLEY HOPE,2,1,1
3176,3016670009,BK,630 HALSEY STREET,04,S2,NELSON MICHAEL,2,1,1
3177,3017120019,BK,884 HERKIMER STREET,01,B3,"ETOH, ALBI BEN",2,1,1
3178,3017750072,BK,695 DEKALB AVENUE,04,S3,"IGLESIA AMOR DE DIOS, INC.",2,1,1
3179,3018290036,BK,372 TOMPKINS AVENUE,04,S2,"COXALL, EON",4,3,1
3180,3018690032,BK,1387-1389 ATLANTIC AVENUE,07,G9,CARLTON A WEEKES,2,1,1
3181,3019780029,BK,506 WASHINGTON AVENUE,04,D7,506 WASHNGTON AVE. OWNERS CORP.,2,1,1
3182,3021350001,BK,520 WYTHE AVENUE,03,D1,W&K PHASE 2 LLC,2,1,1
3183,3021460035,BK,81 SOUTH 10 STREET,02,C0,TOBY GOLDSTEIN,2,1,1
3184,3022180009,BK,643 BEDFORD AVENUE,02,C3,643 BEDFORD AVE LLC,2,1,1
3185,3023420028,BK,93 NORTH 4 STREET,02,C0,"93 N. 4TH STREET, LLC",2,1,1
3186,3025510011,BK,172 JAVA STREET,08,M4,UNITED CEREBRAL PALSY ASSOCIATIONS,2,1,1
3187,3025650001,BK,62 WEST STREET,06,E1,72 WEST LLC,3,2,1
3188,3025810012,BK,308 GREENPOINT AVENUE,06,F5,KAJ LTD,3,2,1
3189,3027610028,BK,574 METROPOLITAN AVENUE,04,S2,574 METRO LLC,2,1,1
3190,3027740010,BK,524 LORIMER STREET,04,S2,"524 LORIMER, LLC",3,2,1
3191,3029190027,BK,21 JUDGE STREET,02,C1,FLATIRON-WILLIAMSBURG PROPERTY GROUP I L LC,2,1,1
3192,3030130023,BK,1077 FLUSHING AVENUE,04,S5,"1077 FLUSHING AVENUE, INC.",2,1,1
3193,3030620030,BK,199 JOHNSON AVENUE,02,C1,HUN LY CORP,2,1,1
3194,3031830079,BK,1211 MYRTLE AVENUE,04,S2,"BROWN, SHATIKWA",2,1,1
3195,3032320076,BK,1249 DEKALB AVENUE,02,C2,1249 DEKALB DEVELOPMENT LLC,2,1,1
3196,3034300050,BK,1255 DECATUR STREET,11,V0,RBM CENTRAL AVE LLC,2,1,1
3197,3034740039,BK,37 CONWAY STREET,05,O5,CONWAY REALTY CORP,3,2,1
3198,3034830036,BK,44 MARGINAL ST WEST,01,A9,"BUSDR PROPERTY GROUP, LLC",2,1,1
3199,3035090022,BK,659 RALPH AVENUE,08,M1,NEW HOPE PENTECOSTAL CHURCH INC,2,1,1
3200,3035520012,BK,189 GRAFTON STREET,01,B1,ROB & CAT JACKSON,2,1,1
3201,3037230006,BK,281 VERMONT STREET,01,B3,"WILLIAMS, TAMEKA",2,1,1
3202,3039470005,BK,230 HENDRIX STREET,08,M1,ST MALACHY RC CHURCH,2,1,1
3203,3039630008,BK,2822 ATLANTIC AVENUE,07,G4,"BOLLA EM REALTY, LLC",2,1,1
3204,3040350121,BK,470 ESSEX STREET,01,A5,MCNEIL JESSIE,2,1,1
3205,3040710002,BK,395 ATKINS AVENUE,01,B1,SMITH LESLEY,2,1,1
3206,3041150001,BK,125 RICHMOND STREET,01,B2,"ALVAREZ, DIANA",2,1,1
3207,3041260023,BK,135 LOGAN STREET,02,C0,"GARIB, EDWIN",2,1,1
3208,3044630001,BK,741 CRESCENT STREET,08,M1,"THE ROMAN CATHOLIC CHURCH OF ST. FORTUNA TA, ETC.",3,2,1
3209,3045930110,BK,1 REMSEN AVENUE,06,E7,CS UTICA & REMSEN LLC,2,1,1
3210,3046390001,BK,878 CLARKSON AVENUE,01,A5,"NELSON, WILFORD A JR",2,1,1
3211,3046760026,BK,386 EAST 51 STREET,02,C2,RAYMOND DUMORNAY,2,1,1
3212,3047790018,BK,820 EAST 49 STREET,01,A9,"HARTLEY, OMAR A",2,1,1
3213,3048050012,BK,640 MIDWOOD STREET,01,A9,GOLDING JAMES W,2,1,1
3214,3048710009,BK,384 LINDEN BOULEVARD,01,A5,"JOSEPH, EARLIN",2,1,1
3215,3048800053,BK,143 EAST 43 STREET,01,A9,"ABRAMSON, AVRAHAM",2,1,1
3216,3049630033,BK,1232 SCHENECTADY AVENUE,01,A9,PRESSLEY LISTER B,2,1,1
3217,3049740049,BK,4007 FOSTER AVENUE,01,B3,BANCROFT JONES,2,1,1
3218,3049770031,BK,1320 TROY AVENUE,01,B3,"WILLIAMS, JOSEPHINE",2,1,1
3219,3050140002,BK,3919 GLENWOOD ROAD,01,A9,"BASAK, PIYALI",2,1,1
3220,3050460017,BK,136 HAWTHORNE STREET,01,A5,"DUDZINSKY, JOHN",2,1,1
3221,3050470050,BK,285 WINTHROP STREET,02,C0,MITTON JEAN LUC,2,1,1
3222,3051970006,BK,1016 DITMAS AVENUE,01,A1,"LEONIDAS, JEAN ROBERT",2,1,1
3223,3052940031,BK,1268 38 STREET,07,G2,PARKAMOUR RLTY INC,2,1,1
3224,3053630022,BK,1532 41 STREET,01,B2,"STEIN, DAVID I",2,1,1
3225,3053660054,BK,1551 39 STREET,02,C3,"MALINAS, JONATHAN",2,1,1
3226,3053800031,BK,1664 42 STREET,01,A1,CHAYA S. KRAMER,2,1,1
3227,3054190050,BK,61 LAWRENCE AVENUE,01,B2,A & A PAZ REALTY LLC,2,1,1
3228,3054490029,BK,1744 48 STREET,01,A1,"DIAMANT, MOSHE",2,1,1
3229,3054540053,BK,4924 17 AVENUE,01,A1,RIEGER RACHEL,2,1,1
3230,3054660012,BK,1610 51 STREET,01,A1,CHAIM FISCHER,2,1,1
3231,3054670062,BK,1739 52 STREET,01,B2,"LESHKOWITZ, LILLIANG",2,1,1
3232,3054740067,BK,1835 53 STREET,01,B2,"WEISZ, CHAIM",2,1,1
3233,3054900052,BK,1761 56 STREET,01,A9,MAXIMO SZKLARZ AS TRUSTEE,2,1,1
3234,3054900056,BK,1751 56 STREET,01,B3,"HOFFMAN, SARA",2,1,1
3235,3055107506,BK,1615 60 STREET,02,R6,UNAVAILABLE OWNER,2,1,1
3236,3056010054,BK,951 44 STREET,02,C0,"WEISS, ABRAHAM",2,1,1
3237,3056810026,BK,1062 55 STREET,02,C0,"BRAUN, BENJAMIN",2,1,1
3238,3056810036,BK,5506 11 AVENUE,01,B1,SHAVY & ISSAC GROSSBERG,2,1,1
3239,3056890053,BK,1169 57 STREET,01,B1,JOSOWITZ DAVID,2,1,1
3240,3057190034,BK,1366 60 STREET,04,K4,THE SPADAFORA FAMILY IRREVOCABLE TRUST,2,1,1
3241,3057470028,BK,1348 64 STREET,02,C0,"LEE, MICHAEL HAOMING",2,1,1
3242,3057740031,BK,1270 68 STREET,01,B1,"1270 OVINGTON AVENUE, LLC",2,1,1
3243,3058020028,BK,656 62 STREET,06,E1,1688 RAY REALTY LLC,2,1,1
3244,3058170018,BK,330 64 STREET,04,S3,"NAPPA, DEBORAH",4,3,1
3245,3058500058,BK,347 SENATOR STREET,01,B9,"SALEH, SALEH",2,1,1
3246,3059580012,BK,116 77 STREET,01,A9,"VOUVOUDAKIS, ELEFTHERIOS",2,1,1
3247,3059710028,BK,548 78 STREET,01,A5,SHABIB MAJDOULIN,2,1,1
3248,3060280006,BK,8411 FT HAMILTON PARKWAY,04,K4,CAROLYN CAPIZZI,2,1,1
3249,3061040035,BK,70 93 STREET,01,A1,"POULIN, GEORGE",2,1,1
3250,3061980033,BK,1166 73 STREET,02,C0,LISENA FELICE,2,1,1
3251,3062180054,BK,2053 BAY RIDGE PARKWAY,01,B2,"LUCA, EDWARD L",2,1,1
3252,3062430016,BK,1226A 77 STREET,01,A5,"SHI, WEN FANG",2,1,1
3253,3062880020,BK,2134 80 STREET,01,A1,"CHEN, TAMMY K",2,1,1
3254,3063230070,BK,1413 85 STREET,01,B1,"DIBENEDETTO, VINCENT",2,1,1
3255,3063300017,BK,2126 83 STREET,02,C0,LILLYAN KIRSCHNER,2,1,1
3256,3063380066,BK,1227 86 STREET,01,A9,"LI, LI JUAN",2,1,1
3257,3063427501,BK,1636 85 STREET,02,R3,UNAVAILABLE OWNER,2,1,1
3258,3063740060,BK,8620 20 AVENUE,02,C0,FRAN E. DANIELS,2,1,1
3259,3064630062,BK,8860 18 AVENUE,01,B1,"CHUNG, HUI LING",3,2,1
3260,3065150071,BK,1035 EAST 2 STREET,01,B2,BRACHA ROSENBERG,2,1,1
3261,3065280057,BK,1169 EAST 7 STREET,11,V0,"LEVY, RONNIE",2,1,1
3262,3065290027,BK,1052 EAST 9 STREET,01,A1,"OVED, MICHAEL",2,1,1
3263,3065840045,BK,1576 EAST 3 STREET,01,A9,EDWARD AZRAK,2,1,1
3264,3065890014,BK,1420 EAST 8 STREET,01,A7,"COHEN, NESS M",2,1,1
3265,3066100067,BK,1661 EAST 3 STREET,01,A9,NEUWIRTH LEAH,2,1,1
3266,3066110007,BK,418 AVENUE O,01,A3,"ARAKANCHI, YOSEF",2,1,1
3267,3066150011,BK,1516 EAST 9 STREET,01,B3,FLORENCE COHEN,2,1,1
3268,3066360023,BK,1736 EAST 5 STREET,01,A3,"KISHK, JACK",2,1,1
3269,3066760077,BK,1819 WEST 5 STREET,01,B1,"JOSEPHINE SCIVOLI, AS TRUSTEE",2,1,1
3270,3066820027,BK,1912 EAST 7 STREET,01,B1,SOLOMON A SUTTON,2,1,1
3271,3066830001,BK,702 AVENUE R,01,B3,RUDY DAVID,2,1,1
3272,3066890067,BK,31 WALDORF COURT,01,A1,"TWERSKI, SHLOMO C",2,1,1
3273,3067100031,BK,956 EAST 18 STREET,01,A1,ELI KARMAN,2,1,1
3274,3067630016,BK,1534 EAST 17 STREET,01,B3,KATZ  AVRUM,2,1,1
3275,3067920050,BK,1671 EAST 29 STREET,01,B3,WEISS JUDY,2,1,1
3276,3068060065,BK,1765 EAST 23 STREET,01,B2,"TAMIR, SHLOMO",2,1,1
3277,3068080034,BK,1776 EAST 26 STREET,01,A1,ELLA WEISS,2,1,1
3278,3068240031,BK,1860 EAST 19 STREET,01,B2,"GEE, SUSAN",3,2,1
3279,3068270019,BK,1870 EAST 22 STREET,01,A1,"ZEITOUNE, ELIE",2,1,1
3280,3070190140,BK,2872 WEST 19 STREET,01,A5,"LI, QIAO LING",2,1,1
3281,3070250007,BK,3844 NAUTILUS AVENUE,01,B3,"ELBOGEN, YOCHEVED",2,1,1
3282,3070880085,BK,1929 OCEAN PARKWAY,01,B2,JANE PARDO,2,1,1
3283,3070910019,BK,933 HUTCHINSON COURT,01,A9,YOSEF FAKS,2,1,1
3284,3070980077,BK,2019 WEST 8 STREET,01,B1,"YANG, ANNA",2,1,1
3285,3071040444,BK,2017 WEST STREET,01,A3,"GINDI, HARRIS",2,1,1
3286,3071300061,BK,2203 EAST 3 STREET,01,A3,JACOB ORFALI,3,2,1
3287,3071330021,BK,2188 EAST 7 STREET,01,B2,"MLABASSATI, FARAJ",2,1,1
3288,3071350050,BK,2177 EAST 8 STREET,01,B1,"GINDI, NISSIM",2,1,1
3289,3071540064,BK,2275 EAST 2 STREET,01,A1,CHAKKALO RAYMOND,2,1,1
3290,3071570007,BK,2206 OCEAN PARKWAY,01,A3,"MASSRY, MARLENE",2,1,1
3291,3071760033,BK,2364 EAST 1 STREET,01,A1,"JAJATI, EDDIE",2,1,1
3292,3071840040,BK,87 LANCASTER AVENUE,01,A1,"CHAKALO, JACK",2,1,1
3293,3071840080,BK,88 LANCASTER AVENUE,01,B1,"MANN, LEON",2,1,1
3294,3072020017,BK,7981 OCEAN COURT,01,B1,REBECCA MADEB 2017 FAMILY TRUST,2,1,1
3295,3072170056,BK,2553 EAST 1 STREET,01,A1,"MIGLIARO, MICHAEL J",2,1,1
3296,3072630111,BK,2790 BRIGHTON 8 STREET,01,B2,"CHAUDHRY, TANVEER A",3,2,1
3297,3072920056,BK,1977 EAST 13 STREET,01,B3,ZAKI SALAME,2,1,1
3298,3072980031,BK,2420 OCEAN AVENUE,04,S1,HARVEY S HOROWITZ DM D,2,1,1
3299,3073030033,BK,4060 BEDFORD AVENUE,01,A1,ALAN B SINGER,2,1,1
3300,3073290016,BK,4112 BEDFORD AVENUE,01,B1,"ROZINOV, LEONID",2,1,1
3301,3073790020,BK,2232 EAST 19 STREET,01,B3,"REVUTSKY, LYUDMILA",2,1,1
3302,3073820077,BK,2221 EAST 23 STREET,01,B1,"SHUM, SUZE",2,1,1
3303,3073980027,BK,2365 EAST 13 STREET,03,D1,ASHLEY APTS CO LLC,2,1,1
3304,3074050329,BK,2370 EAST 24 STREET,01,B1,"LAVALLEY, LOUIS",2,1,1
3305,3074310050,BK,2569 EAST 11 STREET,02,C0,"AKHTAR, NASEEM",3,2,1
3306,3074690074,BK,2607 EAST 24 STREET,02,C0,"LI, TIAN SHI",2,1,1
3307,3075660080,BK,1014 EAST 21 STREET,01,A1,"FINGERER, MOSES",2,1,1
3308,3075920046,BK,2816 AVENUE I,01,B1,GOLDBERGER  LASLO,2,1,1
3309,3076060015,BK,1073 EAST 24 STREET,01,A1,LESLKOWITZ JOSEPH,2,1,1
3310,3076070017,BK,3195 BEDFORD AVENUE,01,A1,LABOWITZ FAMILY RESIDENCE TRUST,2,1,1
3311,3076470026,BK,1247 EAST 29 STREET,01,A1,"HUSS, ELLIOT",2,1,1
3312,3076590042,BK,2306 AVENUE M,01,A1,"BLUMENKRANTZ, ROCHEL",2,1,1
3313,3076620017,BK,1367 EAST 26 STREET,01,B3,"RABINOWITZ, YOSEF",3,2,1
3314,3076660065,BK,1358 EAST 31 STREET,01,A1,KIVELOWITZ STUART,2,1,1
3315,3077720073,BK,1796 SCHENECTADY AVENUE,01,A5,ALWYN WAYNE,2,1,1
3316,3078450015,BK,2055 SCHENECTADY AVENUE,01,A5,CARL EDWARDS,2,1,1
3317,3078970025,BK,1681 EAST 52 STREET,01,B3,"YOUNG ADULT INSTITUTE, INC.",2,1,1
3318,3079030049,BK,1414 EAST 59 STREET,01,A1,BERGMAN 2016 FAMILY TRUST,2,1,1
3319,3079930060,BK,646 EAST 89 STREET,01,B1,"PIERRE, JEAN-MARIE RODNEY",2,1,1
3320,3079940048,BK,1072 REMSEN AVENUE,01,B2,HOLLIS AMEDE,4,3,1
3321,3082570049,BK,1437 EAST 92 STREET,02,C0,NEW YORK CITY INDUSTRIAL DEVELPMENT AGEN CY,2,1,1
3322,3085140020,BK,1845 EAST 53 STREET,01,A1,"AGUIRRE, CHRISTIAN",2,1,1
3323,3086670762,BK,25 BRIGHTON 7 COURT,01,A2,"RODRIGUEZ, RAFAEL",2,1,1
3324,3087150038,BK,3076 BRIGHTON 13 STREET,02,C0,"MAIMAN, LARRY",2,1,1
3325,3087530056,BK,150 KENSINGTON STREET,01,A1,GERSHFELD EDWARD,2,1,1
3326,3088370001,BK,,07,U9,NYC AGENCY PROPERTIES,3,2,1
3327,4000280048,QN,46-36 VERNON BOULEVARD,04,S4,VINCENZO CERBONE REVOCABLE LIVING TRUST,2,1,1
3328,4003260052,QN,34-38 12 STREET,01,B3,"VERMA, VIJAY",2,1,1
3329,4003860002,QN,38-29 27 STREET,02,C0,THEMINH DIEP,2,1,1
3330,4005890010,QN,31-75 30 STREET,01,B1,PETER J ALZAPIEDI,2,1,1
3331,4006030008,QN,35-39 30 STREET,01,B1,"SABATINO, OFELIA",2,1,1
3332,4006920020,QN,31-53 42 STREET,02,C3,31-53 42ND ST ASTORIA LLC,2,1,1
3333,4007290049,QN,30-08 48 STREET,01,A5,GEORGE FOLEY,2,1,1
3334,4007480001,QN,50-35 NORTHERN BOULEVARD,07,G4,"B & J REPAIRS SHOP,INC",2,1,1
3335,4007810040,QN,23-17 SOUND STREET,01,B3,"STAVRAKIS, DIMITRA",4,3,1
3336,4007830111,QN,22-18 43 STREET,01,A5,"PENAFORT, ARMANDO",2,1,1
3337,4007860046,QN,43-15 20 ROAD,01,A1,"DIAMOND, DIANE",2,1,1
3338,4007950039,QN,22-16 41 STREET,02,C3,ASTORIA 22-16 LLC,2,1,1
3339,4008200067,QN,23-70 36 STREET,02,C0,"DOOLEY , ELIZABETH",2,1,1
3340,4009030036,QN,26-12 12 STREET,02,C0,FRIGADES LLC,2,1,1
3341,4010307501,QN,78-19 24 AVENUE,02,R3,UNAVAILABLE OWNER,52,51,1
3342,4013080019,QN,41-13 68 STREET,02,C1,WOODSIDE POINTE LLC,2,1,1
3343,4013080043,QN,41-26 69 STREET,01,B2,"MYAT, AYE AYE",2,1,1
3344,4013090067,QN,41-54 70 STREET,01,B1,G DE TULLIO,2,1,1
3345,4013320012,QN,58-49 43 AVENUE,02,C0,"SZE, HAK CHUN",2,1,1
3346,4013540008,QN,43-07 72 STREET,02,C0,"LIN, GUO YI",2,1,1
3347,4014820040,QN,37-60 95 STREET,01,B1,"CHEN, CHANG GUO",2,1,1
3348,4014870048,QN,40-29 76 STREET,05,O7,"SINGH, NIRMAL",2,1,1
3349,4014910052,QN,40-17 80 STREET,01,A1,MOTILAL BHIM,2,1,1
3350,4016110009,QN,41-25 JUNCTION BOULEVARD,02,C0,"HUANG, XING HUA",2,1,1
3351,4016610004,QN,102-10 27 AVENUE,02,C0,"YUMBLA, CARLOS",2,1,1
3352,4016980061,QN,32-27 103 STREET,01,B9,"CIFUENTES, ROSALBA",2,1,1
3353,4017010088,QN,32-47 106 STREET,01,B2,FLORENTINA REALTY CORP.,2,1,1
3354,4018230007,QN,126-16 35 AVENUE,06,E1,MIN JIAN REALTY LLC,3,2,1
3355,4019420098,QN,103-13 52 AVENUE,02,C3,HUO YIN XIAO,2,1,1
3356,4019840026,QN,104-60 ROOSEVELT AVENUE,02,C0,ALTAVISTA 1 LLC,2,1,1
3357,4019890077,QN,104-17 46 AVENUE,02,C0,"CHAVEZ, ELOINA E",2,1,1
3358,4021090017,QN,99-18 62 DRIVE,01,A1,"ILYABAYEVA,  LILIYA",2,1,1
3359,4022640123,QN,75-54 113 STREET,02,C1,TAMAR D INC,2,1,1
3360,4023430010,QN,51-27 58 PLACE,01,A5,ALAN M. LEVITT,2,1,1
3361,4027280008,QN,59-11 60 STREET,01,A5,"ESPINAL, REYNALDO",2,1,1
3362,4027410044,QN,60-73 59 DRIVE,01,A2,MILLER WILLIAM J,2,1,1
3363,4027580027,QN,62-54 60 ROAD,01,B2,"O'CONNELL, VINCENT",2,1,1
3364,4027590109,QN,64-17 60 AVENUE,01,A5,PIZZONIA KATHLEEN,2,1,1
3365,4028280132,QN,59-15 69 STREET,01,B2,BARON DEVELOPMENT LLC,2,1,1
3366,4029070059,QN,54-61 80 STREET,01,A5,CEZARY TOKARZ,2,1,1
3367,4030410002,QN,65-02 79 PLACE,01,A1,"MIESZKOWSKI, LINDA",2,1,1
3368,4030480028,QN,69-38 JUNIPER VALLEY ROAD,01,A1,"CORINO, KEVIN",2,1,1
3369,4034550006,QN,679-81 SENECA AVENUE,04,S9,679 SENECA LLC,4,3,1
3370,4034680019,QN,1866 GATES AVENUE,02,C3,1866 GATES LLC,2,1,1
3371,4035540019,QN,1622 NORMAN STREET,01,B2,"RABE, IRENE",2,1,1
3372,4036180059,QN,64-53 MADISON STREET,01,B1,JANUSZ PAZDRO,2,1,1
3373,4036930025,QN,71-27 MYRTLE AVENUE,04,S4,MYRTLE HOMES LLC,2,1,1
3374,4038860558,QN,69-46 SYBILLA STREET,07,Y8,NYS DEPARTMENT OF TRANSPORTATION,9,8,1
3375,4039167501,QN,121-39 5 AVENUE,02,R3,NAME NOT ON FILE,27,26,1
3376,4044660004,QN,147-09 2 AVENUE,01,A1,IP JAMES C,2,1,1
3377,4045250034,QN,7-09 151 PLACE,01,A1,"GREGORY, CARLOS ALBERTO",2,1,1
3378,4045850073,QN,160-05 CROSS ISLAND PARKWAY,01,A0,"PICONE, AMBROGIO",2,1,1
3379,4046280035,QN,145-55 18 AVENUE,01,A1,GEORGE POULAKIS,2,1,1
3380,4046380031,QN,22-22 RYAN STREET,01,B1,VINKO NALETILIC,2,1,1
3381,4048160032,QN,30-14 150 STREET,01,B1,EVERBEN LLC,3,2,1
3382,4049340025,QN,29-40 172 STREET,01,B1,XIANZHANG WU,2,1,1
3383,4049990009,QN,3413 149 PLACE,02,C0,"HE, JIN YU",2,1,1
3384,4052110014,QN,46-24 SMART STREET,01,A2,"CORPAS, CYNTHIA",2,1,1
3385,4052680028,QN,154-16 NORTHERN BOULEVARD,04,C7,SABINI PLAZA LLC,4,3,1
3386,4052990049,QN,35-36 172 STREET,01,A1,"DONG, XUE SHONG",2,1,1
3387,4053040021,QN,35-15 UTOPIA PARKWAY,02,C0,THE JING HU 2018 REVOCABLE MANAGEMENT TR UST,2,1,1
3388,4053280001,QN,153-33 SANFORD AVENUE,08,W1,NYC DEPARTMENT OF PARKS AND RECREATION,3,2,1
3389,4053730043,QN,196-08 42 ROAD,01,B2,"LIN, ZHI",2,1,1
3390,4054400048,QN,45-16 162 STREET,04,K4,JCHONS LLC,2,1,1
3391,4054610054,QN,162-60 PIDGEON MEADOW ROAD,02,C0,"SINGH, SUKHVINDER",2,1,1
3392,4057520042,QN,20-30 169 STREET,01,A1,"LEE, LINA",2,1,1
3393,4059380005,QN,18-05 215 STREET,03,D4,18-05 215TH STREET OWNERS INC,13,12,1
3394,4059930057,QN,209-17 28 AVENUE,01,A1,"AHMADI, MOHIDDIN",3,2,1
3395,4059990009,QN,26-29 212 STREET,01,A1,DAGOUNAKIS ANTONIOS,2,1,1
3396,4060590001,QN,29-15 216 STREET,08,I1,ST. MARYS HOSPITAL FOR CHILDREN,3,2,1
3397,4061690017,QN,35-20 BELL BOULEVARD,05,O5,G & G INTERNATIONAL CONSORTIUM LIMITED,2,1,1
3398,4062270051,QN, CORP KENNEDY STREET,07,U8,LIRR,3,2,1
3399,4067520130,QN,61-32 159 STREET,01,A5,"LIANG, SU CHIU",3,2,1
3400,4069600032,QN,70-27 172 STREET,01,A2,ROSE SKIER ASSET MGMT IRRV LIV TR,2,1,1
3401,4071310051,QN,69-55 178 STREET,01,A1,"IRIZARRY, BRETT D",2,1,1
3402,4072030009,QN,75-16 187 STREET,01,A1,"MAEROV, MELS",2,1,1
3403,4072530056,QN,184-31 RADNOR ROAD,01,A1,"YUSHUVAYEV, MURDUKHA",2,1,1
3404,4072740058,QN,81-07 192 STREET,01,A1,JEANNIE YUEN SUPPLEMENTAL NEEDS TRUST,2,1,1
3405,4076130015,QN,64-20 213 STREET,01,A1,"LEE, EVA",2,1,1
3406,4080380069,QN,202 SHORE ROAD,01,A3,"CHAN, ALICE MAN",2,1,1
3407,4080480001,QN,302 MANOR ROAD,01,A1,"PRESSLEY, RYAN",2,1,1
3408,4080620026,QN,30 RIDGE ROAD,01,A3,MEHMET CAVUSOGLU,2,1,1
3409,4082000003,QN,51-19 244 STREET,01,A1,TOM SANTINO,2,1,1
3410,4082330423,QN,249-08 RUSHMORE TERRACE,01,A2,RICHARD W MURPHY,2,1,1
3411,4082330440,QN,50-23 MORENCI LANE,01,A2,"MCGARRY, ROSARIA",2,1,1
3412,4082560089,QN,54-22 LITTLE NECK PARKWAY,01,A1,"WANG, QI",2,1,1
3413,4088680034,QN,89-13 JAMAICA AVENUE,04,S9,OHLERT RUGGIERE INC,2,1,1
3414,4089460033,QN,92-47 75 STREET,01,B2,"SADHU, RAJESHRAM",2,1,1
3415,4090000019,QN,95-26 76 STREET,01,A9,"HOLGUIN, OLIVER",2,1,1
3416,4090120041,QN,95-15 81 STREET,01,B3,VICTOR ROSARIO,2,1,1
3417,4091020009,QN,95-16 101 AVENUE,04,S2,"GEM MANAGEMENT SERVICES, INC.",2,1,1
3418,4091050058,QN,101-25 98 STREET,01,B2,"CARRION, JOHN",2,1,1
3419,4091500037,QN,105-60 88 STREET,01,B3,"PRATAS, DIANE M",2,1,1
3420,4093150007,QN,91-18 109 STREET,01,B3,"TORRES, ROSALBA",2,1,1
3421,4094320017,QN,101-24 115 STREET,01,A1,"SAHOTA, RAHUL",2,1,1
3422,4094390055,QN,94-17 121 STREET,01,B2,"DUMAS, RUBY",2,1,1
3423,4095300069,QN,104-21 107 STREET,01,B2,"MICLE, VASILE",2,1,1
3424,4096010072,QN,107-35 121 STREET,01,A5,"AZHAR, MOHAMMAD Q",2,1,1
3425,4098550020,QN,165-28 CHAPIN COURT,01,B3,SAWCHUK ANNA,2,1,1
3426,4099860061,QN,91-10 146 STREET,08,W9,91-10 146,2,1,1
3427,4099980052,QN, SUTPHIN BOULEVARD,07,U7,LIRR,3,2,1
3428,4100320029,QN,97-23 147 PLACE,01,B2,SHELTON HOLT,2,1,1
3429,4101630077,QN,104-62 165 STREET,01,A1,DWAYNE D. LEE,2,1,1
3430,4101720027,QN,164-10 108 AVENUE,08,M9,AMITY BAPTIST CHURCH,2,1,1
3431,4101920005,QN,163-16 110 ROAD,01,B1,"RAMCHANDREN, MOSES",2,1,1
3432,4102060038,QN,111-18 169 STREET,01,A1,"DOS SANTOS, NIVALDO F",2,1,1
3433,4102730094,QN,110-11 174 STREET,01,A1,"HYATT, NICHOLE",2,1,1
3434,4103330095,QN,177-47 106 AVENUE,01,B1,"ROY, BALOY C",2,1,1
3435,4103680240,QN,102-37 189 STREET,01,A1,"KUMAR, DOJOEDAN",2,1,1
3436,4103700016,QN,104-22 185 STREET,01,A2,BOOTHE MARLON P,2,1,1
3437,4105310051,QN,198-07 HILLSIDE AVENUE,01,B3,"CHURAMAN, VICTOR",2,1,1
3438,4105450078,QN,94-13 211 STREET,01,B3,"MONTOUR, PAULE M",2,1,1
3439,4105890026,QN,206-38 WHITEHALL TERRACE,01,A2,JEANNETTE I. ELDRIDGE,3,2,1
3440,4106800001,QN,219-24 HILLSIDE AVENUE,07,G5,HESS REATAIL STORES LLC,2,1,1
3441,4107010030,QN,92-50 218 PLACE,01,A1,JUDITH ROTH,2,1,1
3442,4107080003,QN,221-06 92 AVENUE,01,A1,"LAL, RANDIP",3,2,1
3443,4107160009,QN,90-06 218 PLACE,01,A1,"PEREZ, TONY",2,1,1
3444,4108140034,QN,94-58 225 STREET,01,A1,"VELAZQUEZ, MILAGROS  V",2,1,1
3445,4108900009,QN,104-04 195 STREET,01,A1,"LAURENT, LORNA",2,1,1
3446,4109040047,QN,104-17 204 STREET,01,B3,"MCMILLAN, CAROLYNN",2,1,1
3447,4109950001,QN,113-01 200 STREET,01,A1,"ROLLINSON-GENYARD, CECILIA M",2,1,1
3448,4110710044,QN,116-28 200 STREET,01,A1,MABRY RUTH,2,1,1
3449,4110990034,QN,104-01 214 STREET,01,A1,"RAMBHAROSE, FRANKY",2,1,1
3450,4111980104,QN,218-30 110 AVENUE,01,A1,"CALDERON, CARMELO",2,1,1
3451,4113200014,QN,116-39 219 STREET,01,A1,BASIL PINNOCK,2,1,1
3452,4113550003,QN,75-06 BLAKE AVENUE,01,A2,C & ELLEN LLC,2,1,1
3453,4115550058,QN,149-57 RALEIGH STREET,01,A1,"PARAG, RYAN",2,1,1
3454,4116570043,QN,114-27 131 STREET,01,B3,JACKSON CHARLES,2,1,1
3455,4116810014,QN,116-14 125 STREET,10,G0,SATTAUR NESHOW,2,1,1
3456,4117400034,QN,133-02 120 STREET,01,A1,"CHINTAMANI, KENNETH",2,1,1
3457,4117580001,QN,123-72 135 STREET,01,A1,"U.S. BANK TRUST, N.A., AS TRUSTEE, ET AL",2,1,1
3458,4119790044,QN,114-43 148 STREET,01,A1,"GIBSON, SHIRLEY",2,1,1
3459,4120030021,QN,116-34 145 STREET,01,B2,"CAVE, ROBERT L",2,1,1
3460,4120070261,QN,147-12 116 AVENUE,01,B3,ROBERT E BUTLER,2,1,1
3461,4120500053,QN,123-22 147 STREET,01,A1,"MANGROO, SUERANIE",2,1,1
3462,4120580195,QN,128-02 142 STREET,01,A5,"TEWARI, GEETABALI",2,1,1
3463,4120600077,QN,142-28 BASCOM AVENUE,01,A1,"RIDER, STEPHAN L",2,1,1
3464,4122400031,QN,161-27 118 AVENUE,01,A1,BAZINIA ACHILLE,2,1,1
3465,4122460031,QN,119-40 LONG STREET,01,B3,"BILLEY, MICHAEL A",2,1,1
3466,4122970044,QN,134-49 158 STREET,01,B2,"PATTERSON , ANDRAE",2,1,1
3467,4123680029,QN,167-56 118 AVENUE,01,B3,"MARSHALL, ROGER",2,1,1
3468,4126200009,QN,199-24 LINDEN BOULEVARD,08,M1,"REHOBOTH HOUSE OF PRAISE CHURCH OF GOD,  INC",2,1,1
3469,4127200097,QN,189-16 WILLIAMSON AVENUE,01,A2,"JONES, ARTHUR L",2,1,1
3470,4128250137,QN,226-02 FRANCIS LEWIS BLVD,08,M9,CONGREGATION OHEL,2,1,1
3471,4129310060,QN,131-55 221 STREET,01,A1,ATKINSON EARL I,2,1,1
3472,4129440036,QN,233-02 233 STREET,02,C6,LAURELTON GARDENS CORP,43,42,1
3473,4130720006,QN,142-33 224 STREET,01,A2,GERALDINE WASHINGTON,2,1,1
3474,4131250028,QN,220-32 137 AVENUE,01,B3,"ISAACS, SIMONE K",2,1,1
3475,4131590051,QN,134-36 232 STREET,01,A1,"PETERSON, COLLINS",2,1,1
3476,4131640005,QN,135-58 FRANCIS LEWIS BLVD,01,A5,"WOMACK, LEONARD C",2,1,1
3477,4134720011,QN,145-89 224 STREET,01,B2,"DUVERT, PIERRE-ANDRE",2,1,1
3478,4134880065,QN,145-54 231 STREET,01,B3,"BECKFORD, ANTON R",2,1,1
3479,4135520046,QN,240-31 CANEY ROAD,01,B2,JOHN MORRISON,3,2,1
3480,4136190026,QN,138-04 250 STREET,01,A2,"ALLEYNE-CHESTER, DONNA",2,1,1
3481,4137330019,QN,236-03 BENTLEY ROAD,01,A2,"MERCURE, ERNST",2,1,1
3482,4154560002,QN,732 CHURCH ROAD,01,A1,KATHLEEN FERCHLAND,2,1,1
3483,4154630002,QN,104 EAST 9 ROAD,01,A1,BENEDETTO MICHAEL,2,1,1
3484,4156140065,QN,314 BEACH 13 STREET,01,A1,"BIAZ-SANTOS , LYDIA",2,1,1
3485,4156650041,QN,13-58 DICKENS STREET,01,B2,"ACEVEDO, ARMANDO",2,1,1
3486,4157100064,QN,11-13 BEACH CHANNEL DRIVE,01,B2,HARRINGTON D JOSEPH,2,1,1
3487,4161170030,QN,330 BEACH 86 STREET,01,A9,"BIESENBACH, KLAUS",2,1,1
3488,4162190057,QN,242 BEACH 124 STREET,01,B3,"SULLIVAN, LORETTA",2,1,1
3489,4162610053,QN,414 BEACH 139 STREET,01,A1,"CAPRIOLA, THOMAS",2,1,1
3490,4163190010,QN,181 BEACH 145 STREET,01,A1,"KLEIN, SAMUEL",2,1,1
3491,4163400020,QN,16932 ROCKAWAY POINT BLVD,08,Y4,NATIONAL PARK SERVICE,8,7,1
3492,5000390081,SI,181 BENZIGER AVENUE,01,B2,181 BENZIGER LLC,2,1,1
3493,5000450044,SI,141 HENDRICKS AVENUE,01,B2,"WU, CUI MEI",2,1,1
3494,5000550072,SI,74 HIGHVIEW AVENUE,01,B2,LOHR FAMILY TRUST,2,1,1
3495,5000560001,SI,77 PROSPECT AVENUE,01,B3,"PERODIN, PAUL",2,1,1
3496,5001090016,SI,44 CASTLETON AVENUE,01,A1,"ALVIN M.SAULONG, AS TRUSTEE",2,1,1
3497,3079240094,BK,323 EAST 87 STREET,06,E1,EAST 87TH STREET LLC,2,1,1
3498,3079680016,BK,8902 BEDELL LANE,01,A5,"ABRIGO, ELAINE  D",2,1,1
3499,3080660013,BK,1265 EAST 87 STREET,10,G0,"SAMSON, ELSIE",2,1,1
3500,3081380001,BK,10502 AVENUE D,07,G9,NYC DEPARTMENT OF SANITATION,2,1,1
3501,3081800029,BK,1125 EAST 92 STREET,01,B1,HERBERT A WILLIAMS,3,2,1
3502,3082040066,BK,1568 ROCKAWAY PARKWAY,01,A1,"LEE, ROANNE S",2,1,1
3503,3082210028,BK,1269 EAST 94 STREET,01,B2,"WILLIAMS, ABENNA",2,1,1
3504,3082440004,BK,9809 AVENUE L,01,A2,"ALMAZA, FORTUNATA",2,1,1
3505,3082980063,BK,1602 EAST 96 STREET,01,A1,"BABB, YVONNE",2,1,1
3506,3085370035,BK,2115 EAST 37 STREET,01,A9,"SINODINOS, DEBRA M",2,1,1
3507,3087520066,BK,136 JAFFRAY STREET,01,A1,SOMMER RUTH,2,1,1
3508,4003300012,QN,35-35 10 STREET,01,B9,"DESOLA, JUSTIN JOSEPH",2,1,1
3509,4003450028,QN,36-10 CRESCENT STREET,01,B1,SEWGOBIND SHRINIVA D,2,1,1
3510,4005560026,QN,21-10 33 AVENUE,01,B3,"LOVERME, VINCENT",2,1,1
3511,4005730060,QN,26-42 28 STREET,02,C1,26-42 28TH ST. LLC,2,1,1
3512,4005890030,QN,31-29 30 STREET,02,C1,3V REALTY LLC,2,1,1
3513,4006030034,QN,35-24 31 STREET,02,C0,"SINGH, JASYIR",2,1,1
3514,4006080041,QN,34-32 32 STREET,01,B1,JINDER SINGH,2,1,1
3515,4006150002,QN,30-85 31 STREET,11,V1,3085 31ST PROPERTY LLC,2,1,1
3516,4006450038,QN,34-20 38 STREET,01,B2,PINTO DOMENICO,2,1,1
3517,4007220034,QN,32-13 46 STREET,01,B3,"SHKRELI, ANTHONY",2,1,1
3518,4007390026,QN,30-49 48 STREET,02,C2,GIUSEPPE GALATI,2,1,1
3519,4007840141,QN,21-20 45 STREET,01,A5,"BLOCKEY, DEAN JOSEPH",2,1,1
3520,4008020067,QN,18-36 42 STREET,06,E2,1836 42 STREET LLC,2,1,1
3521,4008090032,QN,38-12 20 AVENUE,04,S5,38-12 20TH AVENUE LLC,2,1,1
3522,4009420061,QN,19-46 75 STREET,01,B1,"PRENTZAS, CONSTANTINOS",2,1,1
3523,4010830121,QN,88-08 23 AVENUE,10,G1,"23-85 87TH STREET, LLC",4,3,1
3524,4011330031,QN,55-09 32 AVENUE,01,B3,"TSERING, NORBU",2,1,1
3525,4012830042,QN,37-29 72 STREET,05,O7,ALLAMPRABHU S PATIL,2,1,1
3526,4013000022,QN,40-11 68 STREET,02,C3,"WONG, CHEUNG MAN",2,1,1
3527,4013510082,QN,69-19 QUEENS BOULEVARD,04,K4,DOMENIC CRACCO,4,3,1
3528,4013900010,QN,30-08 93 STREET,01,B3,"CAMPOS, RODRIGO",2,1,1
3529,4014080062,QN,31-11 96 STREET,01,B1,"PALOMEQUE, PATRICIO",2,1,1
3530,4014240064,QN,32-07 JUNCTION BOULEVARD,05,K1,26 DEVELOPERS INC,3,2,1
3531,4016090039,QN,100-09 40 ROAD,02,C0,100-09 40TH ROAD REALTY LLC,2,1,1
3532,4016520052,QN,25-13 HUMPHREYS STREET,01,A5,"DELOSRIOS, OMAR",2,1,1
3533,4017390043,QN,35-37 98 STREET,01,B2,"MARTINEZ, LUIS",2,1,1
3534,4017760075,QN,39-07 104 STREET,04,S2,MARIO GONZALEZ,2,1,1
3535,4018780028,QN,96-03 50 AVENUE,01,B1,"CHEN, YU",2,1,1
3536,4019290060,QN,103-06 CORONA AVENUE,02,C0,"GUERRA, MARGUERITE",2,1,1
3537,4019300024,QN,102-19 CHRISTIE AVENUE,01,B3,"CHEN, KONG CHUAN",2,1,1
3538,4019420018,QN,103-40 51 AVENUE,02,C3,"LOO, KING",2,1,1
3539,4019890022,QN,104-46 45 AVENUE,01,B3,"ARIAS , JACINTO",2,1,1
3540,4020050022,QN,108-46 49 AVENUE,02,C0,"RCCJ MANAGEMENT, INC.",2,1,1
3541,4023990036,QN,68-11 JAY AVENUE,02,C0,"VARNELL, KEVIN S",2,1,1
3542,4024820024,QN,52-33 71 STREET,01,B1,"YANG, HEIDI",2,1,1
3543,4024840078,QN,52-74 73 STREET,01,A5,"DAI, LUYI",2,1,1
3544,4026390047,QN,54-42 ARNOLD AVENUE,01,A2,"RYS, STANISLAU",2,1,1
3545,4026450114,QN,61-61 55 STREET,01,B2,"JIMINEZ, NELSON",2,1,1
3546,4027080014,QN,61-20 55 DRIVE,02,C2,JERZY MISZTAL,3,2,1
3547,4027110035,QN,61-03 MASPETH AVENUE,01,B2,61-03 MASPETH AVENUE LLC,3,2,1
3548,4027460114,QN,60-15 61 STREET,01,A5,ANGELO P DRAGO,2,1,1
3549,4027580069,QN,62-49 60 DRIVE,01,B3,"SAUER, JAYNE D",2,1,1
3550,4027600056,QN,64-17 60 ROAD,01,A5,"OTHMAN, MUSTAFA",2,1,1
3551,4027800001,QN,60-66 68 STREET,01,A5,MUZIO MARY D,2,1,1
3552,4028680034,QN,86-15 56 AVENUE,02,C0,AURORA T CHUA,2,1,1
3553,4029720022,QN,62-32 83 PLACE,01,A5,"POMIANEK, ELZBIETA",2,1,1
3554,4030170013,QN,64-72 82 STREET,01,A5,"STECKIEWICZ, ANDRZEJ",2,1,1
3555,4030420004,QN,65-06 80 STREET,01,A1,BARRETT FAMILY WEALTH TRUST,2,1,1
3556,4032220044,QN,70-47 NANSEN STREET,01,A5,LAU PIKWAI,2,1,1
3557,4032820022,QN,151 GREENWAY SOUTH,01,A3,"SIMANTOV, MAYER",2,1,1
3558,4033970028,QN,1892 WILLOUGHBY AVENUE,01,A5,"TRUSZKOWSKI, DANIEL",2,1,1
3559,4035710074,QN,58-13 COOPER AVENUE,01,B3,"SANTOS, JOSE",2,1,1
3560,4035790105,QN,75-10 60 PLACE,01,A9,ALEX D. AGUILAR,2,1,1
3561,4035980041,QN,74-10 64 LANE,01,A1,ANDREW H BOGATS,2,1,1
3562,4036620062,QN,71-07 CENTRAL AVENUE,01,A1,MAHON MARY,2,1,1
3563,4036760022,QN,65-17 MYRTLE AVENUE,05,O7,"CIAFONE , JOHN",2,1,1
3564,4036850032,QN,71-46 70 STREET,01,B2,"MUSCHITIELLO, MARC",2,1,1
3565,4036870060,QN,71-71 71 STREET,01,A2,"D'ELIA, MARIANNA",2,1,1
3566,4037280035,QN,80-10 CYPRESS AVENUE,08,I6,SHAWC II HOUSING DEVELOPMENT FUND,2,1,1
3567,4037300008,QN,57-18 CLOVER PLACE,02,C0,POLIZZI PETER,2,1,1
3568,4037870006,QN,73-09 69 ROAD,01,A1,KENNETH W BATINI,4,3,1
3569,4038430053,QN,78-20 85 STREET,01,A9,"FRKALA, TOMAS",2,1,1
3570,4040920019,QN,15-17 126 STREET,06,E1,15-17 126TH STREET LLC,2,1,1
3571,4042620050,QN,123-15 26 AVENUE,01,B3,"FLYNN, YINDI",2,1,1
3572,4043270001,QN,127-10 28 AVENUE,08,Y2,NYC POLICE DEPARTMENT,2,1,1
3573,4044140094,QN,140-13 32 AVENUE,01,B3,"CHANG , PETER HSIANG",2,1,1
3574,4045130026,QN,150-44 8 AVENUE,01,A1,ANTHONY J. GLAVAN,2,1,1
3575,4045130053,QN,150-15 9 AVENUE,01,A3,JOSEPH A. CVEK,3,2,1
3576,4045650070,QN,14-60 157 STREET,01,B3,"LODICO, WILLIAM",2,1,1
3577,4045820039,QN,160-38 12 ROAD,01,A1,"DIAMANTAKES, STEVE",2,1,1
3578,4046400013,QN,145-16 23 AVENUE,01,B2,ROSE FUSCO,3,2,1
3579,4046450030,QN,148-13 15 AVENUE,01,A1,"ZELAYA, FREDY",2,1,1
3580,4046560022,QN,147-35 22 AVENUE,01,A1,"LIU, BING YING",2,1,1
3581,4047420022,QN,158-06 CROSS ISLAND PARKWAY,02,C6,CLEARVIEW GARDENS SIXTH CORP,7,6,1
3582,4047770023,QN,142-30 32 AVENUE,01,A3,"XING, RONGDI",2,1,1
3583,4048960030,QN,32-04 163 STREET,01,A1,"VARRONE, MARY ANNE",2,1,1
3584,4050120055,QN,143-59 37 AVENUE,04,S3,"36-22 PARSONS BLVD REALTY, INC",2,1,1
3585,4050537501,QN,147-30 BARCLAY AVENUE,02,R3,UNAVAILABLE OWNER,2,1,1
3586,4050550023,QN,41-33 149 STREET,02,C0,"ZHENG, ZHAO FEN",2,1,1
3587,4052420020,QN,33-43 157 STREET,01,A1,RORY P MCCREESH,2,1,1
3588,4052660012,QN,152-28 NORTHERN BOULEVARD,04,S2,NORTHERN 153 LLC.,2,1,1
3589,4053940029,QN,42-16 164 STREET,01,A1,"HARNARAINSINGH, O.S.",2,1,1
3590,4054420062,QN,45-44 164 STREET,01,B1,SHIN FU CORPORATION,2,1,1
3591,4054480053,QN,45-40 170 STREET,01,A1,"SOFIELD, CHRISTOPHERM.",2,1,1
3592,4055860052,QN,173-33 FAIRCHILD AVENUE,01,A1,"KWONG, YERK MU",2,1,1
3593,4060570062,QN,29-42 215 PLACE,01,A1,"HATEM, RADWAN",2,1,1
3594,4063620001,QN,57-35 134 STREET,01,A1,"RAMBARAN, HEMANT K.",2,1,1
3595,4068090056,QN,75-38 PARSONS BOULEVARD,08,W1,SOLOMON SCHECHTER,2,1,1
3596,4068500021,QN,77-44 164 STREET,05,K1,ERIC E. KIRK REVOCABLE TRUST,2,1,1
3597,4068800023,QN,60-04 172 STREET,01,B1,"SHAUGHNESSY, COLM",2,1,1
3598,4069010048,QN,61-28 FRESH MEADOW LANE,07,G2,"MARCHETTI, JAMES",2,1,1
3599,4069460017,QN,70-06 172 STREET,08,P5,JEWISH COMMUNITY CENTER OF HI   REST INC,2,1,1
3600,4069810030,QN,173-06 73 AVENUE,01,B3,"CHEN, YINGJIAO",2,1,1
3601,4070440040,QN,82-74 165 STREET,01,A5,"NG, TSE KIU LO",3,2,1
3602,4071170300,QN,188-00 PECK AVENUE,02,C9,"QUEENS FRESH MEADOWS, LLC",53,52,1
3603,4072130024,QN,75-58 197 STREET,01,B1,"NERI, ARVIN",2,1,1
3604,4072520026,QN,184-34 ABERDEEN ROAD,01,A3,AMINOV LEV,2,1,1
3605,4073680013,QN,48-20 210 STREET,08,M1,THE LOVE OF CHRIST PRESBYTERIAN CHURCH,2,1,1
3606,4074140003,QN,53-03 205 STREET,01,A1,"AGYEMAN, ABRAHAM ABOAGYE",2,1,1
3607,4075310072,QN,223-15 56 ROAD,01,B2,ANN HOM REVOCABLE TRUST,2,1,1
3608,4078320044,QN,224-76 76 AVENUE,01,A2,"SHARIFI, ANAYTULLAH",2,1,1
3609,4080280029,QN,236-28 GROSVENOR STREET,01,A3,"ROMAN, ELIAS V.",2,1,1
3610,4080980008,QN,39-24 240 STREET,01,A1,"KIM,  YONG  HOON",2,1,1
3611,4081160059,QN,40-26 247 STREET,01,A5,"ZHENG, GUO YONG",2,1,1
3612,4082610079,QN,27 VAN NOSTRAND COURT,01,A5,MARY E HALLERMAN,2,1,1
3613,4083060095,QN,246-08 63 AVENUE,01,B1,HAI HU QU,2,1,1
3614,4086670025,QN,250-15 JERICHO TURNPIKE,10,G1,MS. MICKEY BELLEROSE LLC,2,1,1
3615,4086950060,QN,258-15 80 AVENUE,08,M3,ROMAN CATHOLIC CHURCH,2,1,1
3616,4088070001,QN,264-05 85 AVENUE,01,A1,"MADRAY, CHRISTINA",2,1,1
3617,4088450010,QN,76-20 85 ROAD,01,B3,"MOHAN, MONESSAR",2,1,1
3618,4088750034,QN,85-37 91 STREET,02,C0,WENDELL EDWARD,2,1,1
3619,4089600001,QN,91-01 80 STREET,04,S9,"GHANI , MOHD M",2,1,1
3620,4090680002,QN,97-07 94 STREET,01,B3,"HOSSAIN, SARDAR M",2,1,1
3621,4091050001,QN,98-02 101 AVENUE,04,S9,"FIRST SHOP 101 REALTY, LLC",3,2,1
3622,4091540047,QN,105-47 89 STREET,01,B2,"RAMGOOLAM, SRIDHARRAN",2,1,1
3623,4092180033,QN,111-01 86 AVENUE,08,M1,HOLY CHILD JESUS RC C,3,2,1
3624,4092930044,QN,89-01 102 STREET,01,B3,89-01 CORP,2,1,1
3625,4092950059,QN,89-11 104 STREET,01,B3,"PARAY , GANESH",2,1,1
3626,4093290041,QN,87-82 120 STREET,01,B3,87-82 120TH STREET LLC,2,1,1
3627,4094900019,QN,101-28 124 STREET,01,B2,KAUR BALWINDER,2,1,1
3628,4095360079,QN,104-23 113 STREET,01,B2,"LACAYO, CARLOS",2,1,1
3629,4095640028,QN,127-03 103 ROAD,01,A5,"REUBEN, YADICA",3,2,1
3630,4095940036,QN,134-11 107 AVENUE,01,B2,"SAFFIE, FIZAL",2,1,1
3631,4096440021,QN,138-98 QUEENS BOULEVARD,07,G4,"SUNOCO, LLC",2,1,1
3632,4096760053,QN,89-33 146 STREET,01,B3,"DHOR, BIPROJIT",2,1,1
3633,4096760061,QN,89-13 146 STREET,01,B3,EUGENIA MARIA DAVID,2,1,1
3634,4096980017,QN,139-29 HILLSIDE AVENUE,05,K1,"RW 139-29 HILLSIDE, LLC",2,1,1
3635,4097040007,QN,148-16 87 ROAD,08,M1,"DARUS-SALAAM MASJID, NEW YORK, INC.",2,1,1
3636,4097050065,QN,148-03 87 ROAD,01,B2,MIGUEL T. CHITACAPA,2,1,1
3637,4097250027,QN,148-54 86 AVENUE,02,C0,"JAHAN, NASRIN",2,1,1
3638,4097690003,QN,159-09 HILLSIDE AVENUE,04,S1,WHERE EVER HOME LLC,2,1,1
3639,4097880021,QN,159-19 84 DRIVE,01,A1,"BOUKAS, HELEN MARY",2,1,1
3640,4098010013,QN,89-15 168 STREET,01,B2,"HOSEIN, NAZIRAN",2,1,1
3641,4098850001,QN,86-06 EDGERTON BOULEVARD,01,A7,ARUNACHALA ASHRAMA BAGAVAN SRI RAMANA MA HARSHI,2,1,1
3642,4098870038,QN,85-28 ASPEN PLACE,01,A1,"MAHASE, DEW D",2,1,1
3643,4099060069,QN,90-17 184 PLACE,01,A1,"ASADUZZAMAN, MD",2,1,1
3644,4100040052,QN,138-29 97 AVENUE,01,A1,"CARDOSO, DUARTE",2,1,1
3645,4100500007,QN,145-48 105 AVENUE,01,B1,"NATH, DILIP",2,1,1
3646,4101220031,QN,154-13 107 AVENUE,01,B3,"VARGAS, WILLMARIE",2,1,1
3647,4101500049,QN,108-30 GUY R BREWER BLVD,04,S3,BRANDON JOHAN J G,3,2,1
3648,4102440011,QN,169-04 107 AVENUE,01,B1,"CHURAMAN, GYTREE",2,1,1
3649,4102730068,QN,174-13 111 AVENUE,01,A1,PAUL A FIGUERA,2,1,1
3650,4103330091,QN,177-57 106 AVENUE,01,B1,"STANLEY, ARTHUR",2,1,1
3651,4104450042,QN,189-07 JAMAICA AVENUE,04,S1,189 JAMAICA AVENUE C,2,1,1
3652,4104840097,QN,90-19 202 STREET,01,A1,"JAGNARAIN, HARRY N",3,2,1
3653,4104990070,QN,190-17 HILLSIDE AVENUE,01,B3,"COLLINGS, ANNMARIE",2,1,1
3654,4105590032,QN,90-09 209 STREET,01,A1,"ORDONEZ, JESSICA M",2,1,1
3655,4108290067,QN,94-30 199 STREET,02,C0,LOPE A. ORDONEZ,2,1,1
3656,4109430220,QN,109-82 204 STREET,01,A1,"SWEETING,  WINSTON",2,1,1
3657,4109850009,QN,112-29 208 STREET,01,A1,REID VICTOR M,2,1,1
3658,4109960039,QN,113-21 201 STREET,01,A1,"THOMAS, TANISHA N",3,2,1
3659,4110120045,QN,194-43 115 AVENUE,01,A1,"MITCHELL, STACEY",2,1,1
3660,4110160044,QN,114-63 199 STREET,01,A5,"ACQUAH, ERNEST",2,1,1
3661,4110170044,QN,114-63 200 STREET,01,A5,"APARA, BABATOLA",2,1,1
3662,4110410066,QN,115-50 201 STREET,01,A1,DONNA M. BERRY,2,1,1
3663,4111040117,QN,217-14 104 AVENUE,01,A1,"HOMNAUT, PRITTIPAUL",2,1,1
3664,4111400134,QN,214-11 113 AVENUE,01,A1,"HAYE, KIRK",2,1,1
3665,4112680073,QN,114-41 224 STREET,01,A5,"DELIA, RUTH",2,1,1
3666,4112740045,QN,228-44 114 DRIVE,01,A0,"WALTERS, HYACINTH ROSE",4,3,1
3667,4115300027,QN,137-38 95 STREET,01,A1,"MEYER, THOMAS F",2,1,1
3668,4115440019,QN,93-24 ALBERT ROAD,01,B2,SALVATORE CASA,2,1,1
3669,4116080030,QN,109-50 128 STREET,01,A1,"MANROOP, GOONWANTTIE",2,1,1
3670,4116080045,QN,109-49 127 STREET,01,A1,"ALI, ANTHONY",2,1,1
3671,4116250042,QN,111-59 120 STREET,01,B3,"GANGA, ANDREW H",3,2,1
3672,4116610003,QN,135-06 LINDEN BOULEVARD,01,B3,RAJPAUL R,2,1,1
3673,4117070006,QN,114-29 SUTTER AVENUE,01,B3,"BACCHUS, JERRY Z",2,1,1
3674,4117700095,QN,131-24 SUTTER AVENUE,01,A1,"ARCHIBALD, RUTH",2,1,1
3675,4120160258,QN,142-20 119 ROAD,01,A5,"SENAT, NEGMIE",2,1,1
3676,4120390030,QN,142-49 ROCKAWAY BOULEVARD,04,S2,SUKHI ENTERPRISE INC.,2,1,1
3677,4121130044,QN,133-14 147 STREET,01,A1,"BAILEY, TARSHA",3,2,1
3678,4122040151,QN,153-22 FOCH BOULEVARD,01,A9,WILLIE L. JONES,2,1,1
3679,4122470037,QN,119-66 LONG STREET,01,B3,"TERUEL, ERICA G",2,1,1
3680,4122530003,QN,121-15 LONG STREET,01,B3,EDWARD LLOYD DAVID,2,1,1
3681,4123940098,QN,172-20 LINDEN BOULEVARD,04,S1,PARKER HUGH,2,1,1
3682,4126180003,QN,117-09 197 STREET,01,B2,"PARADISE, ERNIE D",3,2,1
3683,4126560013,QN,119-14 201 STREET,01,A1,"EWING CHOW, RYAN C",2,1,1
3684,4126780060,QN,120-47 194 STREET,01,B3,"MAKHANI, JANET",2,1,1
3685,4126790096,QN,121-31 195 STREET,01,A1,MITCHELL SHIRLEY M,2,1,1
3686,4127120039,QN,123-32 NELLIS STREET,01,A1,CLARENCE MCKAY,2,1,1
3687,4128220003,QN,237-07 121 AVENUE,01,A1,GARTH A ALLISON,2,1,1
3688,4129310106,QN,131-40 222 STREET,01,A1,"THOMPSON, MILDRED",2,1,1
3689,4129530210,QN,131-30 HOOK CREEK BOULEVARD,01,B3,"GANPAT, RISHI",2,1,1
3690,4129740023,QN,133-04 LAURELTON PARKWAY,02,C6,LAURELTON GARDENS COEP,33,32,1
3691,4130410003,QN,183-06 141 AVENUE,01,B1,"WILLIAMS, ERROL",2,1,1
3692,4130860043,QN,222-44 143 AVENUE,01,B3,VILLAGE PLAZA HOMES INC.,2,1,1
3693,4131270003,QN,137-15 220 PLACE,01,B3,"NEWBY, SYLVIA",2,1,1
3694,4132340005,QN,240-11 137 AVENUE,01,B3,"NILL, ANDREW",3,2,1
3695,4132540009,QN,138-20 BROOKVILLE BOULEVARD,01,B3,"PANTON, GLORIA",3,2,1
3696,4133590038,QN,146-72 183 STREET,01,A1,ROSE A JACKSON,2,1,1
3697,4134650021,QN,146-21 230 PLACE,01,B3,"OJURONGBE, ABIMBOLA O",2,1,1
3698,4134670065,QN,145-78 220 STREET,01,A1,"OUTRAM, SUSAN",2,1,1
3699,4135090021,QN,143-53 229 STREET,01,B2,"CHANDLER, CHRISTOPHER E",2,1,1
3700,4135120042,QN,231-13 EDGEWOOD AVENUE,01,B2,231-13 EDGEWOOD AVE LLC,2,1,1
3701,4135760030,QN,249-04 MEMPHIS AVENUE,01,B3,"DUESBURY, SHARON",2,1,1
3702,4136050035,QN,141-04 256 STREET,01,A2,EMILIO RIVERA,2,1,1
3703,4154850004,QN,20-24 DEMEREST ROAD,11,V1,126 WILLOUGHBY AVENUE REALTY CORP,2,1,1
3704,4155040034,QN,11-15 BRUNSWICK AVENUE,01,B3,"STONE, STEVEN",2,1,1
3705,4156600014,QN,13-70 CHANDLER STREET,01,B3,"MULLINGS, ANN MARIE",2,1,1
3706,4157340021,QN,25-27 HEALY AVENUE,01,A2,LEWIS STOVELL,2,1,1
3707,4159040025,QN,187 BEACH 61 STREET,01,B9,"PAWAROO, NARAISWAR",2,1,1
3708,4160690024,QN,435 BEACH 72 STREET,01,B2,"B. 72ND ST. - 16069.24, LLC",2,1,1
3709,4161390021,QN,144 BEACH 94 STREET,02,C0,GARRY PATRYLO,4,3,1
3710,4161680040,QN,190 BEACH 96 STREET,02,C0,"CARBONE, RUSSELL",2,1,1
3711,4162280064,QN,162 BEACH 119 STREET,01,B2,MCMORROW JOHN,2,1,1
3712,4163200024,QN,165 BEACH 146 STREET,01,A3,WRIGHT FAMILY TRUST,2,1,1
3713,5000410058,SI,51 TAFT AVENUE,01,B2,"LUCCA , MICHAEL",2,1,1
3714,5000530048,SI,134 HIGHVIEW AVENUE,01,A1,"NATALUCCI , SUSAN",3,2,1
3715,5000850065,SI,151 BRIGHTON AVENUE,01,B2,"MIMIDINOVSKI, SABAN",2,1,1
3716,5001150068,SI,349 VICTORY BOULEVARD,02,C0,"CAO, WU CHENG",2,1,1
3717,5001550090,SI,355 OAKLAND AVENUE,01,A1,RICHARD GRIGOLI,2,1,1
3718,5001610111,SI,185 NORTH BURGHER AVENUE,01,B1,JENSON DEVELOPMENT INC.,2,1,1
3719,5001730046,SI,125 CAMPBELL AVENUE,01,B2,DORETHA HAWKINS,2,1,1
3720,5002450072,SI,112 CHESHIRE PLACE,01,B3,"DECLARA, CHARLES JOHN",2,1,1
3721,5003460024,SI,465 MANOR ROAD,01,A1,SAMUEL T PIROZZOLO,2,1,1
3722,5003550084,SI,140 EGBERT AVENUE,01,B1,"LOFFRENO, DOMENICA",2,1,1
3723,5003710073,SI,75 RAYMOND AVENUE,01,A1,NEBI BALLA,2,1,1
3724,5003900085,SI,65 ELDRIDGE AVENUE,01,A1,JULIO MERCADO,2,1,1
3725,5004050025,SI,454 COLLEGE AVENUE,01,B2,"GUERRA, GERARD",2,1,1
3726,5004480037,SI,287 DICKIE AVENUE,01,A1,KING VIRGINIA,2,1,1
3727,5004670043,SI,368 CHEVES AVENUE,01,A1,JOHN J PODLUCKY,2,1,1
3728,5004900004,SI,533 BAY STREET,03,D1,BAY STREET HOUSING DEVELOPMENT FUND CORP .,2,1,1
3729,5005150036,SI,360 VAN DUZER STREET,04,C7,"VAN DUZER DEVELOPMENT, LLC",2,1,1
3730,5005620054,SI,215 GORDON STREET,01,B2,GRINBERG M&DEV CORP.,3,2,1
3731,5006070040,SI,71 ALPINE AVENUE,01,A1,"BERNARD H. BLOMQUIST, AS TRUSTEE",2,1,1
3732,5006090028,SI,114 GRAND AVENUE,01,A1,"NEVILLE, ROBERT F",2,1,1
3733,5006310210,SI,691 RICHMOND ROAD,10,G1,N.I.C.C.O. INC.,2,1,1
3734,5007630109,SI,292 GANSEVOORT BOULEVARD,01,A0,"ZUGO, TAMIR",2,1,1
3735,5007840022,SI,185 MARTIN AVENUE,01,A5,NORMAN S FASTMAN,2,1,1
3736,5009480012,SI,11 BEACON AVENUE,01,A1,CHARLES FRIZZIOLA,2,1,1
3737,5010440017,SI,483 HEBERTON AVENUE,01,A1,"KOSER, ERIC R",2,1,1
3738,5012250025,SI,42 UNION AVENUE,01,B2,"FRANCIS, MARK",2,1,1
3739,5015040012,SI,171 AUBURN AVENUE,02,C1,AUBURN AVENUE LLC,5,4,1
3740,5027800072,SI,47 CANNON AVENUE,01,B2,"DICKS, DOUGLAS M",2,1,1
3741,5028410143,SI,105 WILLOW AVENUE,06,F5,CAREY REALTY CORP,2,1,1
3742,5028630074,SI,65 EVELYN PLACE,01,B2,ANTONI SKORUPSKI,2,1,1
3743,5029080023,SI,435 BRITTON AVENUE,01,A5,HON MING KWOK,2,1,1
3744,5029720049,SI,208 ST MARYS AVENUE,01,B2,BBTT INC.,2,1,1
3745,5029880056,SI,68 FLETCHER STREET,01,A2,"D'AGOSTO , DONATO JR",2,1,1
3746,5030720001,SI,881 TOMPKINS AVENUE,02,C0,E3K LLC,2,1,1
3747,5031030077,SI,30 PEBBLE LANE,01,B9,KILIN IZABELLA,2,1,1
3748,5031760130,SI,40 COBBLERS LANE,01,A5,"HUNG, PAN XIN",2,1,1
3749,5032780016,SI,163 HICKORY AVENUE,01,A1,"GASHI, DRITAN",2,1,1
3750,5033980021,SI,34 WINFIELD STREET,01,A5,"AMENO, JOSEPH",2,1,1
3751,5035630003,SI,77 HUNTER AVENUE,01,A2,"LANGAN, PAUL",2,1,1
3752,5035630033,SI,15 HUNTER AVENUE,01,B2,"15 HUNTER, LLC",2,1,1
3753,5036490042,SI,182 JACQUES AVENUE,01,B2,"WU, SING XINGGQIANG",2,1,1
3754,5038850031,SI,516 GREELEY AVENUE,01,A5,"MELNYK, OLEH",2,1,1
3755,5040690047,SI,80 MARINE WAY,01,A5,"ZHEN XIE, SHU",2,1,1
3756,5042310125,SI,77 7 STREET,01,B2,"ZHAN, CHUN LIN",2,1,1
3757,5043020021,SI,9 GRACE ROAD,01,A1,ELAINE DI TOMMASO,2,1,1
3758,5044020003,SI,133A ARDSLEY STREET,01,A5,PLUCHINO JOHN,2,1,1
3759,5044680001,SI,216 CLARKE AVENUE,01,A2,ANTHONY T MCALLEN,2,1,1
3760,5044720001,SI,3143 AMBOY ROAD,05,K6,OAKWOOD CENTER LLC,6,5,1
3761,5046160008,SI,147 SAMPSON AVENUE,01,A1,"TRAPANI, KAREN",2,1,1
3762,5052120074,SI,15 MORRIS PLACE,01,A1,PLANET MANAGEMENT GROUP LLC,2,1,1
3763,5052250055,SI,4186 AMBOY ROAD,01,B3,F & O REALTY LLC,2,1,1
3764,5052660016,SI,232 PACIFIC AVENUE,01,B2,"KAZAKEVICH, BORIS",2,1,1
3765,5053480044,SI,4280 RICHMOND AVENUE,01,A2,MAX LEISCHNER,2,1,1
3766,5056210001,SI,1015 ARDEN AVENUE,01,A1,EDWARD GANZER,2,1,1
3767,5056940018,SI,859 CARLTON BOULEVARD,01,A1,"RICHARD A. MAYO, AS TRUSTEE",2,1,1
3768,5063380003,SI,632 RENSSELAER AVENUE,01,A1,"SMITH, JAMES",2,1,1
3769,5067500069,SI,185 WOODVALE AVENUE,01,B2,"FERRANTI, MARIA",2,1,1
3770,5067840020,SI,22 VAIL AVENUE,01,B2,MARIA PARLANTI,2,1,1
3771,5073140021,SI,47 STORER AVENUE,06,E2,"ARTHUR KILL GROUP, LLC",3,2,1
3772,5073150078,SI, STORER AVENUE,06,F5,NOTO SALVATORE,3,2,1
3773,5075330054,SI,107 STATION AVENUE,01,A1,"WIESER, ROBERT",2,1,1
3774,5078860022,SI,496 YETMAN AVENUE,01,A1,PATRICK MC CANN,2,1,1
3775,5078960001,SI,7396 AMBOY ROAD,08,M1,CHUR LADY HELP OF CHR,2,1,1
3776,5079140041,SI,68 CHELSEA STREET,01,A2,"MOOG, AS TRUSTEE, MICHAEL",2,1,1
3777,5080260153,SI,403 CRAIG AVENUE,01,A1,"FOGARTY, DEREK",2,1,1
3778,1003530075,MN,140 DELANCEY STREET,04,K4,DELANCEY SUFFOLK ASSOCIATES,2,1,1
3779,1003970035,MN,8 AVENUE B,04,D7,LOWER EAST SIDE ETC,2,1,1
3780,1006140032,MN,227 WEST 11 STREET,02,C6,227 W 11 ST OWNERS CORP,2,1,1
3781,1006360038,MN,181 CHRISTOPHER STREET,01,B9,"181 CHRISTOPHER STREET, LLC",2,1,1
3782,1006460030,MN,420 WEST 14 STREET,05,O5,EBS LLC,2,1,1
3783,1008830029,MN,137 EAST 27 STREET,04,S2,ROSE HILL REAL ESTATE PARTNERS LLC,2,1,1
3784,1010540034,MN,635 9 AVENUE,04,C7,635 NINTH AVENUE CORP,2,1,1
3785,1012627501,MN,62 WEST 47 STREET,05,RC,DIAMOND &JEWELRY IND COMM CONDO,2,1,1
3786,1013370006,MN,307 EAST 44 STREET,04,D6,BEAUX ARTS II LLC C/O,2,1,1
3787,1013760001,MN,800 5 AVENUE,03,D8,800 FIFTH AVE ASSOCIATES,2,1,1
3788,1013900057,MN,20 EAST 76 STREET,05,H1,SURREY ASSOCIATES,2,1,1
3789,1014290027,MN,1435 2 AVENUE,04,S5,SA 1435 LLC,2,1,1
3790,1014980047,MN,44 EAST 87 STREET,08,M1,PARK AVE SYNAGOGUE,2,1,1
3791,1018550001,MN,865 AMSTERDAM AVENUE,03,D3,NYC HOUSING AUTHORITY,12,11,1
3792,1019100001,MN,163 WEST 125 STREET,05,O6,NYC DEPARTMENT OF SMALL BUSINESS SERVICES,3,2,1
3793,2026920082,BX,851 EAST 167 STREET,01,B2,851-853 EAST 167TH STREET LLC,2,1,1
3794,2028920073,BX,1805 WEBSTER AVENUE,07,G3,1805 WEBSTER LLC,2,1,1
3795,2030040044,BX,1897 LONGFELLOW AVENUE,01,B9,"HAMANI, YACOUBA",2,1,1
3796,2032250009,BX,2262 LORING PLACE NORTH,08,I9,"ASSOCIATION FOR C.R.M.D., INC.",2,1,1
3797,2032530133,BX,2854 KINGSBRIDGE TERRACE,02,C0,2854 KINGSBRIDGE TER LLC,2,1,1
3798,2032890017,BX,2798 POND PLACE,01,B1,IVAN VASQUEZ,2,1,1
3799,2033320070,BX,3065 DECATUR AVENUE,02,C0,"LATIF, TANVIR",2,1,1
3800,2033710004,BX,4298 ONEIDA AVENUE,01,B1,"LAVERTY, MUSSEN",2,1,1
3801,2034530052,BX,1501 HARDING PARK,01,A2,"SOTO, NELLIE",2,1,1
3802,2034710010,BX,312 THIERIOT AVENUE,01,A5,"MONTALVO, RUBEN",2,1,1
3803,2036510046,BX,949 ELDER AVENUE,01,A5,"CENTRO SOCIAL LA ESPERANZA, INC.",2,1,1
3804,2036800013,BX,2010 STORY AVENUE,01,B3,"CAMACHO, ANGEL",2,1,1
3805,2037740034,BX,1256 BOYNTON AVENUE,02,C3,"1256 BOYNTON AVE., LLC",2,1,1
3806,2037850025,BX,1770 EAST 172 STREET,04,C7,1770 EAST 172ND STREET LLC,3,2,1
3807,2038180048,BX,2267 WATSON AVENUE,01,A1,"RAMDIN, KASHO N",2,1,1
3808,2038210053,BX,2273 GLEASON AVENUE,01,B1,"SARKAR, ABUL",2,1,1
3809,2038980083,BX,1790 MERRILL STREET,01,B2,"TALUKDER, GOLAM MAGF",2,1,1
3810,2040260001,BX,600 MEAD STREET,02,C0,BARRINGTON L. ROBINSON,3,2,1
3811,2040780104,BX,1520 LURTING AVENUE,01,B2,SANDRA CASASNOVAS,2,1,1
3812,2041280004,BX,1030 RHINELANDER AVENUE,01,B1,RAHAN UDDIN,2,1,1
3813,2041780050,BX,1744 PARKVIEW AVENUE,01,A1,"SINGH, MOONILAL",2,1,1
3814,2041930034,BX,1863 EDISON AVENUE,01,B2,"PJETROVIC, AMER",2,1,1
3815,2041970008,BX,1822 MAHAN AVENUE,01,B1,GAUDIO ANTONIO,2,1,1
3816,2042490041,BX,2029 BURR AVENUE,01,B1,"DELOVIC, SHPRESA",2,1,1
3817,2044290032,BX,676 ALLERTON AVENUE,05,K1,674 ALLERTON REALTY,2,1,1
3818,2044350037,BX,766 ALLERTON AVENUE,04,K4,W.Z.Z. REALTY LLC,2,1,1
3819,2044450051,BX,2553 RADCLIFF AVENUE,02,C3,"BERISHA, MEJREME",2,1,1
3820,2044460020,BX,2532 RADCLIFF AVENUE,02,C0,HUPPEIN SALAHI,2,1,1
3821,2046650064,BX,716 EAST 218 STREET,01,B3,"JOHN, CRAIG",3,2,1
3822,2046720029,BX,819 EAST 213 STREET,01,B2,"THOMPSON, COLONEL",2,1,1
3823,2047290038,BX,3576 BOSTON ROAD,07,G2,"T.J.C. OPERATIONS, INC.",2,1,1
3824,2048330036,BX,643 EAST 230 STREET,01,A1,"AHMED, JAFFOR",2,1,1
3825,2048500044,BX,3984 BARNES AVENUE,01,A5,"CAMANO, RAFAEL",2,1,1
3826,2048870042,BX,3438 EDSON AVENUE,01,B1,"HARVEY, MYRTLE",2,1,1
3827,2049020003,BX,1185 EAST 223 STREET,04,S2,"JADOO, SOOKLAL R",2,1,1
3828,2050210021,BX,4148 DE REIMER AVENUE,01,B1,"GORDON , MICHAEL",3,2,1
3829,2050710147,BX,4427 BYRON AVENUE,02,C0,FAY GARDENER,2,1,1
3830,2050750084,BX,4533 CARPENTER AVENUE,01,A1,DEMORE ANTHONY,2,1,1
3831,2053850147,BX,2839 ZULETTE AVENUE,01,B1,"MILETO, JOSEPH",2,1,1
3832,2054080215,BX,1356 KEARNEY AVENUE,01,B1,GAETANO D'ANGELO,2,1,1
3833,2054640021,BX,1021 CLARENCE AVENUE,01,B2,ZEOLLA JOSEPH,3,2,1
3834,2054770019,BX,831 CLARENCE AVENUE,01,B1,JOSEPH A CAIOLA,2,1,1
3835,2056110078,BX,515 BRUSH AVENUE,01,A2,"515 BRUSH AVE, LLC",2,1,1
3836,2056260245,BX,11 PELL PLACE,01,A2,"GALVIN, PAMELA",2,1,1
3837,2056330094,BX,90 DITMARS STREET,01,A1,"RICARDO GALBIS, TRUSTEE GALBIS-BELTRAN T RUST",2,1,1
3838,2056370085,BX,174 ROCHELLE STREET,01,A1,AABR REALTY FACILITIES HOLDING CORP,2,1,1
3839,2056460079,BX,481 KING AVENUE,01,A1,SCHLEIN STANLEY K,2,1,1
3840,2059400520,BX,5000 INDEPENDENCE AVENUE,01,A3,"GOLDFEDER, ADRIENNE",2,1,1
3841,3004470054,BK,443 CARROLL STREET,02,C0,FIGUEROA HUGO A,2,1,1
3842,3004480038,BK,252 4 AVENUE,04,S3,"SINGER, HOLLE F",2,1,1
3843,3004700015,BK,124 4 PLACE,02,C0,SUSAN MERRO,3,2,1
3844,3005290031,BK,290 VAN BRUNT STREET,02,C0,"ALGOFI, HAMOOD ALMAS",2,1,1
3845,3006560075,BK,788 3 AVENUE,06,E1,ARISTA REALTY LLC,3,2,1
3846,3008910050,BK,295 21 STREET,01,B2,"MARANGA, DR. ILYCE",2,1,1
3847,3009000014,BK,312 22 STREET,01,B2,22ND STREET VENTURES LLC,2,1,1
3848,3010420021,BK,286 14 STREET,01,B2,"SEVENKO, ELISABETH",2,1,1
3849,3010980051,BK,441 13 STREET,11,V0,SHEILA ROOPCHAND,2,1,1
3850,3012260017,BK,658 ST MARKS AVENUE,01,A4,HARDY ROBERT,2,1,1
3851,3012840040,BK,1340 PRESIDENT STREET,01,A5,AFR WESLEYAN METH EPI,3,2,1
3852,3012860058,BK,1423 CARROLL STREET,01,B9,MORANCIE NEIL D,2,1,1
3853,3012900067,BK,307 CROWN STREET,01,A5,"PRUSS, YITZCHOK",2,1,1
3854,3012920036,BK,1378 CARROLL STREET,01,A4,BISTRITZKY ABRAHAM,2,1,1
3855,3013490077,BK,1605 BERGEN STREET,02,C0,JULIETTE SMITH,2,1,1
3856,3013940031,BK,932 EASTERN PARKWAY,02,C1,"932-938 EASTERN PARKWAY RESIDENCES, LLC",2,1,1
3857,3014140034,BK,1666 CARROLL STREET,02,C0,"MARSOW,  YECHIEL",2,1,1
3858,3014150014,BK,1698 CARROLL STREET,08,M1,UPPER ROOM OF PRAYERINC,2,1,1
3859,3015210066,BK,303 SUMPTER STREET,02,C1,303 SUMPTER LLC,2,1,1
3860,3015350009,BK,312 MAC DOUGAL STREET,02,C2,LOPEZ IVAN L,2,1,1
3861,3015780017,BK,794 BROADWAY,04,K4,794 LINDEN REATLY LLC,3,2,1
3862,3017540052,BK,586 MARCY AVENUE,04,S2,"OLYMPIC SALES, LLC",4,3,1
3863,3017860063,BK,719 LAFAYETTE AVENUE,01,B2,"719 LAFAYETTE, LLC",2,1,1
3864,3017880002,BK,1027 BEDFORD AVENUE,04,S1,FITZ HICKS,3,2,1
3865,3018850075,BK,465 PARK AVENUE,04,S2,"RAMOS, ELIZABETH",2,1,1
3866,3018960004,BK,191A CLASSON AVENUE,01,B3,"MURACO, CARL",2,1,1
3867,3019480042,BK,83 CLIFTON PLACE,03,D1,79 CLIFTON PLACE OWNER LLC,5,4,1
3868,3020120044,BK,546 WASHINGTON AVENUE,08,M1,BEDFORD ZION CH OF NA,2,1,1
3869,3023250033,BK,51 NORTH 6 STREET,11,V1,L3 KENT ASSEMBLAGE LLC,2,1,1
3870,3025100001,BK,179 WEST STREET,,Z9,GREENPOINT LANDING ASSOCS LLC,2,1,1
3871,3025210019,BK,80 GREEN STREET,02,C0,"LUSE, ANDREW",2,1,1
3872,3025220077,BK,103 HURON STREET,01,B9,"ZAMANSKY, MARIA",2,1,1
3873,3026280017,BK,229 RUSSELL STREET,06,E1,JOSEPH PORTMAN,2,1,1
3874,3027430026,BK,365 MANHATTAN AVENUE,01,B1,365  MANHATTAN AVENUE LLC,3,2,1
3875,3027750039,BK,105 POWERS STREET,01,A9,POTIGNANO ANNA,2,1,1
3876,3027910030,BK,439 LORIMER STREET,01,B9,"REICHARDT, SUSAN M",2,1,1
3877,3029180004,BK,978 METROPOLITAN AVENUE,02,C0,"ZUPNICK, ABRAHAM",2,1,1
3878,3032310011,BK,22 CEDAR STREET,01,A2,"GUZMAN, LIDIA",2,1,1
3879,3032380035,BK,1667 DEKALB AVENUE,02,C0,"PANNIZZO, CARLO",2,1,1
3880,3032430122,BK,1266 DEKALB AVENUE,01,B2,NUBIA MORAN,2,1,1
3881,3032490012,BK,1636 DEKALB AVENUE,01,B3,1638 DEKALB LLC,2,1,1
3882,3032830145,BK,1069 GREENE AVENUE,01,B1,"SALTZMAN , LISA  A",2,1,1
3883,3034870030,BK,129 JAMAICA AVENUE,01,A9,"MENDOZA, MARIA C.",2,1,1
3884,3035360038,BK,626 SARATOGA AVENUE,01,B1,"BAH, MOHAMED",2,1,1
3885,3035980042,BK,426 AMBOY STREET,01,B1,"WILLIAMS, KEVIN ANTHONY",2,1,1
3886,3036050116,BK,461 OSBORN STREET,01,A5,ANATASHIA N. SIMON,2,1,1
3887,3036380132,BK,630 WATKINS STREET,01,B2,"BECKFORD , HYACINTH",3,2,1
3888,3039790029,BK,264 SCHENCK AVENUE,01,A1,CLARA BOUTTE,2,1,1
3889,3041640014,BK,58 WELDON STREET,01,A9,MELENDEZ IVAN,2,1,1
3890,3042010007,BK,489 AUTUMN AVENUE,01,B2,"MIA , MOHAMMED  A",2,1,1
3891,3042310001,BK,513 CHESTNUT STREET,01,B9,"PALMER, ALVIN",2,1,1
3892,3045980078,BK,39 EAST 95 STREET,02,C3,PATRICIA JOHN,2,1,1
3893,3046580019,BK,218 EAST 53 STREET,02,C3,BRIDGEWATER CYRIL,3,2,1
3894,3047720012,BK,666 EAST 52 STREET,01,B3,"LEE, NICHOLA",2,1,1
3895,3047780014,BK,812 EAST 48 STREET,01,A5,"MARCELLE, MIGUEL",2,1,1
3896,3048020009,BK,414 MIDWOOD STREET,02,C0,MIDWOOD TOWERS LLC,2,1,1
3897,3048790014,BK,124 EAST 43 STREET,02,C3,"GI 43,",2,1,1
3898,3049060018,BK,1026 BROOKLYN AVENUE,08,M1,EGLISE BAPTISTE BETHESDA DEXPRESSION ETC,3,2,1
3899,3049510051,BK,615 EAST 34 STREET,01,B2,EMILE VILAIRE,2,1,1
3900,3050990116,BK,540 OCEAN AVENUE,02,C1,OCEAN AVENUE ASSOCIAT,2,1,1
3901,3051570032,BK,424 MARLBOROUGH ROAD,01,A1,"ADAMS, JOAN",2,1,1
3902,3053130034,BK,31 CHURCH AVENUE,05,GU,31 CHURCH AVE LLC,3,2,1
3903,3053750012,BK,700 AVENUE C,01,A1,700 AVENUE C LIMITED LIABILITY COMPANY,2,1,1
3904,3054100017,BK,783 EAST 3 STREET,01,A9,"LEV, MORDECHAI",2,1,1
3905,3054530063,BK,1537 50 STREET,02,C0,JOSEPH PERLOW,2,1,1
3906,3054660086,BK,1615 52 STREET,02,C0,"LEBOVITS, AARON",2,1,1
3907,3054710058,BK,1545 53 STREET,01,B9,"FISCHER, CHAYA",2,1,1
3908,3054970084,BK,1615 58 STREET,02,C0,"HOFFMAN, ARI",2,1,1
3909,3055080020,BK,2130 58 STREET,01,A5,"BERKO, DAVID",2,1,1
3910,3055177502,BK,1644 60 STREET,02,R3,UNAVAILABLE OWNER,2,1,1
3911,3056250074,BK,913 48 STREET,01,B1,"NACHMAN LEIFER, AS T",2,1,1
3912,3056450008,BK,906 50 STREET,04,S2,CONGREGATION & YESHIVA BETH HAMEDROSH SH EMIA TOVA,2,1,1
3913,3056530045,BK,5114 11 AVENUE,01,B1,JOSHUA SCHAPIRA,2,1,1
3914,3056650063,BK,839 54 STREET,01,A5,ZI LI MA,2,1,1
3915,3058840019,BK,66 MACKAY PLACE,01,A1,MARIAN RUSSO,2,1,1
3916,3059160009,BK,132 73 STREET,01,A5,"LEPERA, JEFFREY J",2,1,1
3917,3059470046,BK,7618 COLONIAL ROAD,01,A5,"WINTER, TRUSTEE, HARVEY",2,1,1
3918,3061290058,BK,208 MARINE AVENUE,01,B2,"CAMA, DOMINICK A",2,1,1
3919,3061870005,BK,1102 72 STREET,02,C0,"MOSCILLO, TRUSTEE, ROSA",2,1,1
3920,3062880063,BK,2131 81 STREET,01,B2,"PRESTIGIACOMO, LINDA",3,2,1
3921,3063220019,BK,1334 84 STREET,01,A1,"BERARDELLI, GENNARO",2,1,1
3922,3063950031,BK,109 BAY 10 STREET,01,B3,109 BAY 10TH STREET LLC,2,1,1
3923,3064000011,BK,8757 17 AVENUE,02,C0,"NGAN, CHUK YING",2,1,1
3924,3064950026,BK,798 EAST 8 STREET,08,N1,WOMENS LEAGUE COMMUNITY RESIDENCES,2,1,1
3925,3065170064,BK,1069 EAST 4 STREET,08,M9,CONGREGATION BETH ARYE,2,1,1
3926,3065200015,BK,940 EAST 8 STREET,01,A1,"FRANCO, DAVID S",2,1,1
3927,3065200017,BK,944 EAST 8 STREET,01,A1,"FRANCO, MARCELLE",2,1,1
3928,3065200041,BK,1002 EAST 8 STREET,01,A1,"LANIADO, HAGAI",2,1,1
3929,3065210031,BK,964 EAST 9 STREET,01,A1,ROCHELLE LEVY,2,1,1
3930,3065350004,BK,910 AVENUE K,01,A9,"SHAMAH, ABRAHAM",2,1,1
3931,3065360060,BK,1163 EAST 10 STREET,01,B2,HENRY KASZIRER,2,1,1
3932,3065530001,BK,6423 BAY PARKWAY,04,S9,STROFFOLINO RALPH,2,1,1
3933,3065690027,BK,1428 EAST 7 STREET,01,B1,"PAVEL, GEORGE",2,1,1
3934,3066100019,BK,1624 EAST 4 STREET,01,A9,MORRIS SROUR 5777 FAMILY TRUST,2,1,1
3935,3066440075,BK,1743 WEST 13 STREET,01,B3,DIANO ROBERT,2,1,1
3936,3066610031,BK,1844 EAST 5 STREET,01,A1,"SHALOM, JOSEPH N.",2,1,1
3937,3066630079,BK,1735 OCEAN PARKWAY,01,B1,SARDAR JAK,2,1,1
3938,3066820072,BK,1855 OCEAN PARKWAY,01,A3,CONGREGATION EITZ CH,2,1,1
3939,3066930024,BK,789 EAST 18 STREET,01,A1,"BARTLEY, LORIE A",2,1,1
3940,3067040011,BK,912 EAST 12 STREET,01,B1,"GURWITZ, SHARON",2,1,1
3941,3067110013,BK,1011 EAST 18 STREET,01,A1,JOSEPH MUSS,2,1,1
3942,3067120048,BK,941 EAST 19 STREET,01,A9,ZAGELBAUM ARIELLA,2,1,1
3943,3067230037,BK,1172 EAST 13 STREET,01,A9,GROSS KAREN,2,1,1
3944,3067380019,BK,1248 EAST 19 STREET,01,B2,EREZ NATHAN,2,1,1
3945,3067440082,BK,1317 EAST 15 STREET,08,W9,"PRIMAK, ALEXANDER",2,1,1
3946,3067640020,BK,1560 EAST 18 STREET,03,D4,ANSHEL HOUSE INC,2,1,1
3947,3067770015,BK,1622 EAST 15 STREET,11,V0,"WONG, CHIU",2,1,1
3948,3068080022,BK,1750 EAST 26 STREET,01,A1,"ALEKSANDR , NAGDIMOV",2,1,1
3949,3068090024,BK,1734 EAST 27 STREET,01,A1,STAVRACH ISAAC,2,1,1
3950,3068260011,BK,2024 AVENUE R,01,A1,"SHREM, AREZ",2,1,1
3951,3068780021,BK,145 BAY 38 STREET,01,B1,"CHOI , SHUET YING",2,1,1
3952,3070380016,BK,4504 BEACH 45 STREET,02,C0,"GOLDSTEIN, LORETTA M",2,1,1
3953,3070440028,BK, ATLANTIC AVENUE,09,Q7,SEA GATE ASSN,2,1,1
3954,3070730101,BK,1904 SURF AVENUE,09,Q6,NYC DEPARTMENT OF PARKS AND RECREATION,12,11,1
3955,3070910041,BK,2288 CONEY ISLAND AVENUE,01,B9,"MALEK, DIANA",2,1,1
3956,3071040428,BK,2059 WEST STREET,01,A1,"BEDA, STEVEN",2,1,1
3957,3071040490,BK,2122 EAST 2 STREET,01,A1,JACK DWECK,2,1,1
3958,3071080027,BK,2050 OCEAN PARKWAY,01,B1,"ADJMI, HARRY",2,1,1
3959,3071310050,BK,2229 EAST 4 STREET,01,B1,"HABERT, LEAH",2,1,1
3960,3071320058,BK,2211 EAST 5 STREET,01,A9,FOUERTI ELIE,2,1,1
3961,3071460044,BK,2364 MCDONALD AVENUE,05,K1,WALKER GLENN LLC,2,1,1
3962,3071660043,BK,2370 BOYNTON PLACE,02,C0,"MAUCERI, STEVEN J",2,1,1
3963,3071680019,BK,2889 86 STREET,02,C0,"JOANNE PRESTIA, AS TRUSTEE",3,2,1
3964,3071840085,BK,2624 CONEY ISLAND AVENUE,07,G3,SPARTAN PETROLEUM CORP,2,1,1
3965,3072630036,BK,2824 BRIGHTON 7 STREET,01,B2,"CHADURY, KHALIL  AHMED",2,1,1
3966,3072920078,BK,1923 EAST 13 STREET,01,A1,"SCABA, JACK",2,1,1
3967,3073000012,BK,1944 EAST 22 STREET,01,A1,"ESCAVA, NATHAN",2,1,1
3968,3073030037,BK,4072 BEDFORD AVENUE,01,A1,"DANIEL, ELLIOT",2,1,1
3969,3073230013,BK,2018 EAST 19 STREET,02,C0,"CHIN, WEI CHEE",3,2,1
3970,3073590062,BK,2141 EAST 26 STREET,02,C0,"LINDENBAUM, KENNETH J",2,1,1
3971,3073660061,BK,2137 BATCHELDER STREET,01,A5,"WAH CHAN, CHUN",2,1,1
3972,3073990059,BK,2347 EAST 14 STREET,01,B1,"SROUR, JAK",2,1,1
3973,3074250002,BK,3000 AVENUE X,08,W1,NYC DEPARTMENT OF EDUCATION,3,2,1
3974,3074410094,BK,2509 EAST 24 STREET,01,B1,"ALI, ROBERTO R",2,1,1
3975,3074687501,BK,2629 EAST 23 STREET,02,R3,QUEENS VILLAGE DENTAL ASSOCIAT,2,1,1
3976,3075740003,BK,2815 AVENUE I,01,B2,2815 AVENUE I LLC,2,1,1
3977,3075960053,BK,1790 NEW YORK AVENUE,02,C0,"LERNER, ELIYAHU",2,1,1
3978,3076070085,BK,1082 EAST 26 STREET,01,A1,"ZAGELBAUM, YECHIEL",2,1,1
3979,3076270075,BK,1172 EAST 28 STREET,01,B2,STEVEN M DACHS,2,1,1
3980,3076330056,BK,1284 EAST 34 STREET,01,A1,CHAIM STANIESKI,2,1,1
3981,3076570072,BK,1424 EAST 22 STREET,01,A1,"FREIFELD, DEBORAH",2,1,1
3982,3076770029,BK,1430 EAST 24 STREET,01,A1,AARON M BIDERMAN,2,1,1
3983,3077460062,BK,970 EAST 43 STREET,01,A9,"ROBERTS, BRIAN",2,1,1
3984,3078240016,BK,1975 TROY AVENUE,01,A5,"BUBB, DEIAN",2,1,1
3985,3078520004,BK,5415 AVENUE M,01,A9,JOSE ROSADO,2,1,1
3986,3078650023,BK,1639 COLEMAN STREET,01,A1,YOUNGSTEIN LARRY,2,1,1
3987,3078830057,BK,1330 EAST 59 STREET,01,A9,"PARRIS, MYRTLE I",2,1,1
3988,3079240178,BK,804 REMSEN AVENUE,07,G4,AMERICAN OIL CO/FKA,2,1,1
3989,3082070060,BK,936 EAST 100 STREET,02,C0,DAIL ORRIDGE,2,1,1
3990,3082440010,BK,1341 EAST 98 STREET,04,S1,"COTTLE, PATRICIA J",2,1,1
3991,3082630023,BK,1419 EAST 98 STREET,01,B2,DIFANZO FAMILY IRREVOCABLE TRUAT,2,1,1
3992,3083930076,BK,1444 ROYCE STREET,01,B1,"NOEL-JEUNE, INNES",2,1,1
3993,3084030050,BK,2012 EAST 61 STREET,01,B3,MAURICE ROLO,2,1,1
3994,3086570001,BK,302 SEA BREEZE AVENUE,09,Q1,NYC DEPARTMENT OF PARKS AND RECREATION,6,5,1
3995,3087820117,BK,2721 EAST 23 STREET,01,B2,"BABAEV, DAVID",2,1,1
3996,4001980036,QN,40-20 47 AVENUE,08,M1,SUNNYSIDE JEWISH CENTER,2,1,1
3997,4003200016,QN,33-27 9 STREET,04,S1,35 AVE YANG LLC,2,1,1
3998,4003860012,QN,38-07 27 STREET,01,B9,"BATALIAS, ANTONIA",2,1,1
3999,4004720637,QN,38-55 12 STREET,08,N9,ST.CHRISTOPHERS'S HOME,2,1,1
4000,4005160028,QN,30-51 12 STREET,02,C2,"GUARANGO, JUANA",2,1,1
4001,4005390013,QN,14-24 ASTORIA BOULEVARD,02,C3,UNAVAILABLE OWNER,2,1,1
4002,4006160074,QN,32-13 31 AVENUE,02,C1,STAVROULAKIS GEORGE S,2,1,1
4003,4006360031,QN,36-12 36 AVENUE,01,B2,"GIRALDO, OMAIRA",2,1,1
4004,4006570017,QN,31-61 37 STREET,04,D7,3161 LLC,2,1,1
4005,4007840004,QN,43-09 DITMARS BOULEVARD,02,C2,ANASTASIOS SKENDROS,2,1,1
4006,4008010018,QN,19-39 STEINWAY STREET,10,G1,MARIC 1867 LLC,2,1,1
4007,4008490046,QN,20-09 28 STREET,01,A5,"CHOWDHURY, TAMANNA",2,1,1
4008,4008780033,QN,21-02 DITMARS BOULEVARD,01,A5,"PARTHENIS, GUS",2,1,1
4009,4008910035,QN,19-20 DITMARS BOULEVARD,02,C0,"DITS-KONTONICOLAOU, NATALYA",2,1,1
4010,4010010005,QN,69-14 DITMARS BOULEVARD,02,C0,"IADOVITO, CARMINE",2,1,1
4011,4010900034,QN,23-58 97 STREET,01,B2,"MUNESHAR, HAIMLALL",2,1,1
4012,4011900063,QN,34-43 62 STREET,01,A5,"GAO, LIANG",2,1,1
4013,4013500085,QN,69-15 44 AVENUE,11,V0,MELODIA HOLDING INC,2,1,1
4014,4014140009,QN,32-08 85 STREET,01,A5,"JUNNARKAR, SANDEEP",2,1,1
4015,4014140052,QN,32-47 84 STREET,01,B3,EFRAIN ALLER,2,1,1
4016,4014800017,QN,37-24 93 STREET,02,C0,"HWANG, KEN",2,1,1
4017,4014910051,QN,40-19 80 STREET,01,A1,"MOTILAL, BHIM",2,1,1
4018,4015260039,QN,42-50 81 STREET,02,C0,"LEE, EDWARD S",2,1,1
4019,4015640015,QN,41-20 BENHAM STREET,02,C0,CARLOS CHACON,2,1,1
4020,4015920025,QN,94-52 42 AVENUE,02,C0,ELIVA SCHOPPE,2,1,1
4021,4016040052,QN,94-65 CORONA AVENUE,04,S4,CARLOS & ELISABETH GIMENEZ,2,1,1
4022,4016150010,QN,42-01 97 PLACE,02,C0,"POON, CHAU WAN",2,1,1
4023,4016690049,QN,29-33 GILLMORE STREET,01,B1,TURNER DOROTHY,3,2,1
4024,4016940001,QN,107-10 ASTORIA BOULEVARD,07,G5,AMERICAN OIL CO,2,1,1
4025,4016990048,QN,32-47 104 STREET,01,B1,"MYRICK, CATHERINE",2,1,1
4026,4017020090,QN,32-17 107 STREET,02,C0,WILLIAM A CRISOSTOMO,2,1,1
4027,4017670020,QN,37-24 102 STREET,02,C0,"PUMA, ELSA",3,2,1
4028,4017700015,QN,101-04 39 AVENUE,01,B3,"NG, XIAOYUN HONG",2,1,1
4029,4017800034,QN,108-70 39 AVENUE,01,B1,"RUPANSINGH, KARRAN",2,1,1
4030,4018690064,QN,53-05 92 STREET,01,B3,PC WAW LLC,2,1,1
4031,4018700004,QN,92-18 54 AVENUE,01,B2,"YOU, TIAN XI",2,1,1
4032,4018850006,QN,94-18 51 AVENUE,01,B1,"CHEN, HUI ZHEN",2,1,1
4033,4018930020,QN,53-18 JUNCTION BOULEVARD,01,A1,"JIMENEZ, ANGELICA JESUS",2,1,1
4034,4019410062,QN,53-04 103 STREET,02,C3,"QU, GUO",2,1,1
4035,4019510049,QN,57-32 PENROD STREET,02,C2,"LIU, XIN XIAO",2,1,1
4036,4019600039,QN,57-17 WALDRON STREET,02,C0,"MEJIA, BEATRIZ",2,1,1
4037,4019840073,QN,104-13 41 AVENUE,01,B3,JASMIN MELGAR,2,1,1
4038,4020010021,QN,108-46 45 AVENUE,01,B3,"VEGA, BLANCA G",2,1,1
4039,4021680039,QN,108-41 63 DRIVE,01,B1,"KIETDURIYAKUL, CHAWALEE",2,1,1
4040,4022430016,QN,112-26 69 ROAD,01,A3,"KAYKOVA, SVETLANA",2,1,1
4041,4023870016,QN,50-15 65 PLACE,01,B1,"MEMON, IQBAL",3,2,1
4042,4024730079,QN,51-51 CODWISE PLACE,01,B2,"FLYNN, PATRICK",2,1,1
4043,4025350023,QN,53-04 46 STREET,02,C0,"DTZ PROPERTIES, LLC",2,1,1
4044,4026370038,QN,60-91 54 STREET,04,S3,ALPHA VITA REALTY LLC,2,1,1
4045,4026410051,QN,60-78 56 STREET,01,B2,WANDER GLORIA,2,1,1
4046,4026670010,QN,56-57 58 STREET,,Z9,ENJAY EQUIPMENT SALES CORP,2,1,1
4047,4026940060,QN,59-87 GRAND AVENUE,01,A1,LUCIANO CARLOS CEPEDA,2,1,1
4048,4027280081,QN,60-27 59 ROAD,01,B2,RADY MARION,2,1,1
4049,4027290003,QN,59-41 60 STREET,01,A5,JOAN ORLOWSKI,2,1,1
4050,4027400021,QN,59-12 61 STREET,01,B1,"J.M. DISTINCTIVE REALTY, LLC",4,3,1
4051,4028080066,QN,72-18 57 AVENUE,01,B1,"LI, XING",2,1,1
4052,4028170063,QN,57-53 78 STREET,02,C0,"ATWI, HIASSAM",2,1,1
4053,4028330017,QN,59-28 71 STREET,01,A5,IGNAZIO AZZARA,2,1,1
4054,4029220006,QN,69-08 ELIOT AVENUE,07,G4,69-08 ELIOT AVE LLC,3,2,1
4055,4029550032,QN,62-52 70 STREET,01,A5,"SZYMANSKI, ANTONI",2,1,1
4056,4029950010,QN,83-20 63 AVENUE,01,A1,"WANG, JIAN HUA",2,1,1
4057,4030590066,QN,66-68 75 STREET,01,B3,"JAMESON, HARRY",2,1,1
4058,4030920068,QN,62-68 WETHEROLE STREET,01,A1,"MORALES, MARIA",2,1,1
4059,4031320069,QN,64-44 DIETERLE CRESCENT,01,B1,"64-44 DIETERLE REALTY, LLC",2,1,1
4060,4033460020,QN,117-16 QUEENS BOULEVARD,05,K2,"YORKSHIRE REALTY,",2,1,1
4061,4033910037,QN,9 ST JOHNS ROAD,01,B3,"GRILLO, MARC",2,1,1
4062,4035300013,QN,60-18 MADISON STREET,01,B1,"COHEN, NIMROD",2,1,1
4063,4035530032,QN,16-42 STEPHEN STREET,01,A2,"CRIOLLO, ROBERTO O",2,1,1
4064,4036000022,QN,65-30 MYRTLE AVENUE,04,S3,GANGI LEONARD,2,1,1
4065,4038340004,QN,83-13 MYRTLE AVENUE,01,A1,"WARD, JR, KENNETH J",2,1,1
4066,4040100001,QN,130-15 14 AVENUE,07,G4,DOUBLE K REALTY CORP,2,1,1
4067,4040560016,QN,14-22 COLLEGE POINT BLVD,04,S1,CAMCO GROUP LLC,2,1,1
4068,4040860009,QN,15-27 123 STREET,01,B2,NEW YORK MISSION CHURCH OF C&MA,2,1,1
4069,4045010013,QN,149-24 9 AVENUE,01,A1,PEKARIK EDWARD,2,1,1
4070,4045120036,QN,150-49 8 AVENUE,01,A1,"FARACI, MADDALENA",2,1,1
4071,4045440014,QN,154-43 9 AVENUE,01,A1,"YIP, SHING SAI",2,1,1
4072,4045770001,QN,160-39 9 AVENUE,01,A1,"HSU, CHIA-HSUN",2,1,1
4073,4046850012,QN,150-19 17 ROAD,01,A1,"GEORGIADIS, LUKAS",2,1,1
4074,4049460077,QN,134-01 NORTHERN BOULEVARD,06,E9,NORTHERN COLLINS CORP,3,2,1
4075,4050390021,QN,132-38 41 AVENUE,04,S4,YAN SEN GROUP LLC,2,1,1
4076,4051740001,QN,146-01 BOOTH MEMORIAL AVE,01,A1,HSIN-TAI HU,2,1,1
4077,4052090041,QN,46-19 UNION STREET,01,B2,"LEGUIZAMON, EGIDIO",2,1,1
4078,4052880023,QN,36-02 166 STREET,01,A5,"CHEN, CAREN",2,1,1
4079,4052950008,QN,36-16 169 STREET,02,C2,36-16 DEVELOPMENT LLC,2,1,1
4080,4053040004,QN,189-11 CROCHERON AVENUE,04,S9,"RANDAZZO, GISELA",2,1,1
4081,4053770064,QN,147-15 ASH AVENUE,01,B1,CHAN YUK YING CHIU,2,1,1
4082,4054390037,QN,45-25 160 STREET,01,B2,FRANCESCO GIAMBRONE,2,1,1
4083,4054610030,QN,162-06 46 AVENUE,05,K1,FLUSHING CEMETARY,2,1,1
4084,4057500057,QN,166-51 20 AVENUE,01,A1,"VALDES, RICKEY N",2,1,1
4085,4061840017,QN,36-22 217 STREET,01,A1,"GUMB, DANA F JR",2,1,1
4086,4062320032,QN,38-12 212 STREET,01,B3,"TOM, EMILY",2,1,1
4087,4064040012,QN,140-26 58 ROAD,01,A5,YANGRONG LIN,2,1,1
4088,4066060061,QN,138-46 76 AVENUE,01,A5,ZELDA LEE BRAUN,2,1,1
4089,4069630049,QN,175-10 JEWEL AVENUE,01,A5,"LIN, LING",2,1,1
4090,4072140063,QN,75-37 197 STREET,01,B1,"JIANG, SHIQUAN",2,1,1
4091,4072410029,QN,181-30 TUDOR ROAD,01,A3,"BABAEV, ALBERT",2,1,1
4092,4074240011,QN,53-26 BELL BOULEVARD,01,A1,"SAYED, MICHAEL H.",2,1,1
4093,4076670046,QN,232-07 67 AVENUE,01,B1,"XIE, CAI  QIN",2,1,1
4094,4080070124,QN,242-09 JAMAICA AVENUE,01,B1,CAMEO HOMES INC.,2,1,1
4095,4080470004,QN,206 HOLLYWOOD AVENUE,01,A1,JAMES NIHAN,2,1,1
4096,4081410036,QN,41-45 WESTMORELAND STREET,01,A1,TOSCANO PHILIP,2,1,1
4097,4082330411,QN,249-32 RUSHMORE TERRACE,01,A2,JAMILE PERESS,2,1,1
4098,4086350019,QN,86-09 253 STREET,01,A1,CHRISTINE BARONE,2,1,1
4099,4086520031,QN,244-50 88 DRIVE,01,A1,DIFOLCO ROBERT,2,1,1
4100,4086540059,QN,247-13 89 AVENUE,01,A9,"SAHA, BISWA",2,1,1
4101,4088940081,QN,88-75 ELDERT LANE,01,B2,"KHAN, ZAMEER",2,1,1
4102,4089000066,QN,88-15 75 STREET,01,B2,"BUDHU, PURNIMA",2,1,1
4103,4089460034,QN,92-45 75 STREET,01,B3,"CHENG, HENRY HOI YIN",2,1,1
4104,4089600023,QN,91-28A 81 STREET,01,B1,LILY REN PROPERTY LLC,2,1,1
4105,4089630014,QN,80-44 90 ROAD,01,B9,REYES RUDY,2,1,1
4106,4089800021,QN,91-36 87 STREET,01,B2,"PEREZ, RAFAEL",2,1,1
4107,4090430063,QN,94-33 97 STREET,01,B2,ARGENTO LORRAINE,2,1,1
4108,4091030014,QN,101-22 97 STREET,01,B1,"GUO, YONG HE",2,1,1
4109,4091470037,QN,86-17 SUTTER AVENUE,04,S3,"CUI, ZHI JIE",2,1,1
4110,4092470032,QN,84-50 126 STREET,01,B1,"MALPIEDI, CHARLES",2,1,1
4111,4092600001,QN,117-04 85 AVENUE,02,C0,"ALSAEIDI, NABIL H",2,1,1
4112,4092990064,QN,87-29 109 STREET,01,B3,"CHAN, DEORAJ",2,1,1
4113,4093960047,QN,94-15 110 STREET,02,C0,"CHEN, XING ZHOU",2,1,1
4114,4094120038,QN,95-76 111 STREET,01,B2,AMALGAM HOLDINGS LLC,2,1,1
4115,4094230054,QN,101-59 105 STREET,01,B2,"MENNA, RICHARD",3,2,1
4116,4095020042,QN,134-09 LIBERTY AVENUE,04,K4,HARPREET SETHI,2,1,1
4117,4095060019,QN,103-30 103 STREET,01,B2,"MARTIN, RICARDO R",2,1,1
4118,4095370009,QN,114-20 LIBERTY AVENUE,04,S2,LIBERTY REALTY ASSOCIATES LCC,2,1,1
4119,4095490059,QN,107-45 111 STREET,01,A9,MIGUEL LARA,2,1,1
4120,4095580028,QN,103-44 121 STREET,05,K2,"ESSEX MANAGEMENT GROUP, INC.",2,1,1
4121,4096030045,QN,107-55 123 STREET,01,B3,"SINGH , DENNIS C",2,1,1
4122,4098040024,QN,90-25 170 STREET,03,D1,EAST ELMHURST DEVELOPMENT CORP,2,1,1
4123,4099190049,QN,88-34 183 STREET,02,C0,"ABDULLAH, MOHIUDDIN",2,1,1
4124,4099450017,QN,181-12 DALNY ROAD,01,A3,"BAJNAUTH, JOAN P",2,1,1
4125,4099740038,QN,89-11 138 STREET,02,C0,"RAZA, MUHAMMAD",2,1,1
4126,4101810065,QN,109-45 GUY R BREWER BLVD,02,C2,MAZAL HOLDING CROP,2,1,1
4127,4102110271,QN,92-53 168 PLACE,01,A5,"GOBIN, SHRIMATEE",2,1,1
4128,4102250001,QN,104-19 MERRICK BOULEVARD,10,G1,CASAGRANDE REALTY CORP,2,1,1
4129,4104130004,QN,183-09 FONDA AVENUE,01,B3,SHILENDRA SINGH,3,2,1
4130,4104950071,QN,88-34 202 STREET,01,A1,NANDLAL ADESH,2,1,1
4131,4105200005,QN,196-14 MC LAUGHLIN AVENUE,01,A2,DYE LUTHER V,2,1,1
4132,4105470064,QN,93-24 207 STREET,01,A1,"PRICE, MAGDELEAN T",2,1,1
4133,4105610013,QN,91-08 210 PLACE,01,A1,"UMADAS, HARIS C",2,1,1
4134,4105720043,QN,89-41 207 STREET,01,A1,"DUPITON, MAUD",2,1,1
4135,4105790003,QN,89-38 HOLLIS COURT BLVD,01,A1,"MOJICA, MARIA",2,1,1
4136,4106300070,QN,92-50 215 STREET,01,A1,"HERNANDEZ, LUIS",2,1,1
4137,4106620066,QN,89-18 218 PLACE,01,A1,"SANTOS, MARIA CHRISTINE",2,1,1
4138,4107210037,QN,221-09 91 ROAD,01,A1,"THOMAS, INDEIRA",2,1,1
4139,4107470022,QN,224-34 FAIRBURY AVENUE,01,B3,FAIRBURY REALTY CORP,2,1,1
4140,4109800024,QN,112-13 204 STREET,01,A5,CAINES MICHAEL A,2,1,1
4141,4109900053,QN,194-23 MURDOCK AVENUE,01,A1,"BEDELL, BENEDICT",2,1,1
4142,4110710013,QN,116-39 199 STREET,01,A2,"FIDLER, MONICA",2,1,1
4143,4110720045,QN,116-30 201 STREET,01,B3,OWENS ADA,2,1,1
4144,4110740052,QN,202-02 116 AVENUE,01,B3,"LACRETE, CLAUDE",2,1,1
4145,4110850043,QN,99-28 213 STREET,01,A2,GIBBS GERARD,2,1,1
4146,4111080005,QN,218-25 105 AVENUE,01,A1,ARMAND HENRY C,3,2,1
4147,4111320027,QN,210-30 113 AVENUE,01,A1,"TOMALA, ALEXIS",2,1,1
4148,4113680012,QN,133-39 88 STREET,01,B2,"SALEH, FUAD A",2,1,1
4149,4114210007,QN,89-14 SOUTH CONDUIT AVENUE,02,C2,S CONDUIT LLC,2,1,1
4150,4116160007,QN,111-06 112 STREET,01,B2,ALVARO CERON,2,1,1
4151,4116190034,QN,114-21 LINDEN BOULEVARD,01,A1,"SOBRIAN, GLORIA",2,1,1
4152,4116260038,QN,121-09 LINDEN BOULEVARD,01,B1,"SERRANO, CARLOS",2,1,1
4153,4116580032,QN,114-48 133 STREET,01,A1,"SAHADEO, DUDHNATH",2,1,1
4154,4116980061,QN,117-11 134 STREET,01,B3,JUANITA GALLOWAY,2,1,1
4155,4118060017,QN,135-35 LEFFERTS BOULEVARD,04,K4,VEE'S PROPERTY MANAGEMENT LLC,3,2,1
4156,4118590020,QN,135-31 125 STREET,01,B3,"RAMKAY, AMIT",3,2,1
4157,4119520054,QN,147-32 110 ROAD,01,B3,"LAVILLE, YOHAN",2,1,1
4158,4119930047,QN,115-21 148 STREET,01,B3,"TALUKDER, BISWAJIT",2,1,1
4159,4120080059,QN,116-27 148 STREET,01,A1,"MARECHEAU, ERIC",2,1,1
4160,4120250064,QN,119-18 INWOOD STREET,01,A5,119INWOOD GROUP CORP.,2,1,1
4161,4121010065,QN,146-19 SUTTER AVENUE,01,B2,"ANDERSON, MORTIMER C",2,1,1
4162,4121750014,QN,111-67 157 STREET,01,B2,ROY A FORBES,2,1,1
4163,4121750037,QN,111-17 157 STREET,01,A1,"BISWAS, MOHAMMMED M",2,1,1
4164,4121920064,QN,150-53 116 AVENUE,01,A1,"EDWARDS, NEVILLE S",2,1,1
4165,4122130006,QN,153-11 119 ROAD,01,A2,"DOWERY, JUNE",2,1,1
4166,4123130033,QN,140-12 158 STREET,01,B2,ULYSSES BELCHER,2,1,1
4167,4123300049,QN,114-34 167 STREET,01,B3,"114-34 167TH STREET, LLC",2,1,1
4168,4123430256,QN,115-15 168 STREET,01,A5,COWDEN MARY,3,2,1
4169,4125220108,QN,174-36 126 AVENUE,01,A1,NYC HOUSING AUTHORITY,2,1,1
4170,4126470053,QN,119-39 191 STREET,01,A1,"DUPREE, DIANE",2,1,1
4171,4129270028,QN,218-02 132 AVENUE,08,W1,NYC DEPARTMENT OF EDUCATION,2,1,1
4172,4131280027,QN,137-46 223 STREET,01,A1,"BUCHANAN, NUNES GEORGE",2,1,1
4173,4132540014,QN,138-26 BROOKVILLE BOULEVARD,01,B3,"BENNETT, ERNEST",2,1,1
4174,4136520017,QN,253-42 148 AVENUE,01,B2,"SACKO, ABRAHAM",2,1,1
4175,4137330037,QN,235-14 148 ROAD,01,A5,"FRASER, NORMA",2,1,1
4176,4140750089,QN,163-49 91 STREET,01,A2,"AHMED, SAYED",2,1,1
4177,4150130014,QN,144-21 158 STREET,01,A1,"MAUGHN, HARIOTT",2,1,1
4178,4153150031,QN,16 WEST 10 ROAD,01,A1,"GLADE, ROBERT",2,1,1
4179,4154600007,QN,806 CROSS BAY BOULEVARD,01,A1,R GOETKE,2,1,1
4180,4154650006,QN,210 EAST 9 ROAD,01,A2,"MYERS, DENISE",2,1,1
4181,4155030091,QN,11-52 BRUNSWICK AVENUE,01,B2,CHAIM MAJEROVIC,2,1,1
4182,4157220009,QN,27-13 COLD SPRING ROAD,11,V0,RALPH RICHARDSON,2,1,1
4183,4157340011,QN,25-47 HEALY AVENUE,01,A3,ABRAHAM MUNK,2,1,1
4184,4158390058,QN,325 BEACH 47 STREET,01,B3,"BARRIOS DE RIVERA, ELSA NAOMI",3,2,1
4185,4159610076,QN,534 BEACH 43 STREET,01,A2,"JAMES, JOSEPH B",2,1,1
4186,4162780001,QN,133-15 ROCKAWAY BEACH BLVD,02,C0,MULLEN BRIAN M,2,1,1
4187,4163050041,QN,303 BEACH 148 STREET,01,A1,HOFFMAN MARTIN L,2,1,1
4188,4163140001,QN,2-39 BEACH 149 STREET,01,A1,"GORDEEV, MIKHAIL",2,1,1
4189,5001150044,SI,32 OXFORD PLACE,02,C0,"REXHAJ, AVDI",2,1,1
4190,5001190093,SI,249 CASTLETON AVENUE,01,B2,"AHMETAJ, OLIMBI",2,1,1
4191,5001830052,SI,741 FOREST AVENUE,07,G4,CHRYSTAL FOREST REALTY LLC,2,1,1
4192,5002260022,SI,19 LYCEUM COURT,01,A5,CHURCH OF OUR LADY OF MT. CARMEL WEST NE W BRIGHTON,2,1,1
4193,5002370042,SI,123 FLOYD STREET,01,A1,THOMAS FARINA,2,1,1
4194,5002380278,SI,23 LLEWELLYN PLACE,01,A5,"SUN, GARY KWONG YUEN",2,1,1
4195,5002490046,SI,35 UNIVERSITY PLACE,01,B9,JOHN A ODDO,2,1,1
4196,5002770098,SI,672 BARD AVENUE,01,A1,JAMES D MACALUSO,2,1,1
4197,5003320187,SI,177 DRAKE AVENUE,01,A1,"HORAI, EDWARD C",2,1,1
4198,5003440021,SI,88 SANFORD PLACE,01,A1,FRANK A BOCCIA,2,1,1
4199,5003490028,SI,5 WINTHROP PLACE,01,B1,THE HANS R. NYBRO LIVING TRUST,2,1,1
4200,5003550107,SI,98 EGBERT AVENUE,01,A1,MAZZA THALIA M,2,1,1
4201,5003740302,SI,76 ELMIRA AVENUE,01,B2,VINCENT J SERVIDIO,2,1,1
4202,5004150019,SI,140 DICKIE AVENUE,01,A1,"KELLY, PAUL M",2,1,1
4203,5004460005,SI,305 DEMOREST AVENUE,01,A2,MOMKGALLO LLC,2,1,1
4204,5005310023,SI,54 HARRISON STREET,01,B2,RAY POSE,3,2,1
4205,5006030083,SI,53 GLENWOOD AVENUE,01,A1,"HUANG, AI AN",2,1,1
4206,5006950001,SI,41 TODT HILL ROAD,01,A1,"WENDY A. HELLMANN-SPECIALE, TRUSTEE",2,1,1
4207,5007090067,SI,57 JOSEPHINE STREET,01,A1,CHRISTINE ALBANO,2,1,1
4208,5007260065,SI,120 PERRY AVENUE,01,A2,"YANDOLI, PATRICIA",2,1,1
4209,5008690442,SI,86 FOREST ROAD,01,A3,MITCHELL FEINMEL,2,1,1
4210,5010120035,SI,7 COTTAGE PLACE,01,A1,"IMPROTA, NANCY",2,1,1
4211,5010170035,SI,81 BOND STREET,01,A1,US BANK TRUST NA AS TRUSTEE,2,1,1
4212,5010390213,SI,374 JEWETT AVENUE,01,A5,MIRIAM TURNER,2,1,1
4213,5010500199,SI,44 CATHERINE STREET,02,C0,"RIZZO, MICHAEL",5,4,1
4214,5010790006,SI,61 HARRISON AVENUE,01,B2,MAXIE CT VENTURES LLC,2,1,1
4215,5010920050,SI,256 SHARPE AVENUE,01,B2,DESCAR JOHN Z,2,1,1
4216,5010970028,SI,230 CHARLES AVENUE,01,A1,F ROCK       PENS,2,1,1
4217,5011940031,SI,235 VAN NAME AVENUE,01,A2,MARTIN KYLE L,2,1,1
4218,5012130030,SI,97 UNION AVENUE,01,B2,"VICTORIA, KENDRICK",2,1,1
4219,5012460099,SI,284 HARBOR ROAD,01,A1,"KHACHMANIAN, JOHN",2,1,1
4220,5021020106,SI,2094 RICHMOND AVENUE,11,V1,"WALDMAN DEVELOPMENT OF NY, LLC",4,3,1
4221,5022420075,SI,3179 RICHMOND ROAD,01,B2,RITA PARKS,3,2,1
4222,5024000210,SI,140 MARSH AVENUE,05,K3,"GGP STATEN ISLAND MALL, LLC",2,1,1
4223,5026200385,SI,61 SIMMONS LOOP,01,A5,"LOUISA, STEVEN",2,1,1
4224,5026610036,SI,4324 VICTORY BOULEVARD,01,A2,TRAVIS HOLDING GROUP LLC,2,1,1
4225,5027050066,SI, WILD AVENUE,11,V1,JAMES E BRAHN,4,3,1
4226,5027760081,SI,40 MEREDITH AVENUE,01,A1,BARRETT JOHN,2,1,1
4227,5028340012,SI,80D NAUTILUS STREET,01,A5,"RIVERA, RUBEN",2,1,1
4228,5028450005,SI,27 ORMOND PLACE,01,A1,VIRGINIA PEPE,2,1,1
4229,5028650084,SI,93 FINGERBOARD ROAD,01,B3,"GRIFFO, DANIELLE",2,1,1
4230,5028670382,SI,39 PARK HILL COURT,01,A1,"MEI, JIMMY YF",2,1,1
4231,5028770139,SI,11 NUNLEY COURT,01,A1,"ROBINSON, KIRK",2,1,1
4232,5030060019,SI,26 WAGNER STREET,01,B9,"26 WAGNER STREET, INC.",2,1,1
4233,5030500044,SI,482 STEUBEN STREET,01,A2,"KIM, JUNG SOO",2,1,1
4234,5031030081,SI,26 PEBBLE LANE,01,B9,MGKG IRREVOCABLE TRUST,2,1,1
4235,5035920112,SI,33 FREMONT AVENUE,01,A1,MATTHEW GIAMBRONE,2,1,1
4236,5037450018,SI,310 POULTNEY STREET,01,A2,"GIURICI, MICHAEL A",2,1,1
4237,5038100008,SI,65 HEMPSTEAD AVENUE,01,A2,66 HEMPSTEAD AVENUE LLC,2,1,1
4238,5038610104,SI,665 HUNTER AVENUE,01,A6,"DORSEY, STEPHEN J",2,1,1
4239,5040230034,SI,411 RIGA STREET,01,A2,ANNMARIE ANTENUCCI,2,1,1
4240,5040310055,SI,19 INA STREET,01,A2,SAM GULISANO,2,1,1
4241,5040660034,SI,51 HETT AVENUE,01,A1,"HOLLAND, JR., MICHAEL",2,1,1
4242,5042240031,SI,310 ROSS AVENUE,01,A1,ALFONSE J. CALATO,2,1,1
4243,5042310014,SI,134 BEACH AVENUE,01,A1,"VARGAS, EDWIN",2,1,1
4244,5042320014,SI,18 ALLISON AVENUE,01,A2,"SPRIZZO, MATTHEW",2,1,1
4245,5044380016,SI,189 WEST CEDARVIEW AVE,01,A1,TESORIERO FAMILY IRREVOCABLE TRUST,2,1,1
4246,5053060108,SI,73 GOODALL STREET,01,A1,"PAVLOVSKY, STEPHANIE",2,1,1
4247,5053160057,SI,366 TENNYSON DRIVE,01,A1,ROSE LEON,2,1,1
4248,5053220054,SI,84 OCEANIC AVENUE,01,A2,SCHOPPMANN CY,2,1,1
4249,5054080007,SI,192 BATHGATE STREET,01,A2,"MCADAM, ALANNA C",2,1,1
4250,5054410087,SI,64 WOODLAND AVENUE,01,B2,DONALD VITALE,2,1,1
4251,5054630050,SI,10 ESCANABA AVENUE,01,B2,"MOLFETTA, MICHAEL",2,1,1
4252,5062490021,SI,5113 AMBOY ROAD,01,A1,EUGENE ROCLE,2,1,1
4253,5066800019,SI,40 HERBERT STREET,01,B2,"LAM, SO M",2,1,1
4254,5067240093,SI,97 WATERBURY AVENUE,01,B2,"LUCIDO, CESARE",2,1,1
4255,5067400018,SI,308 BAYVIEW AVENUE,01,B2,COSIMO BRUZZESE,2,1,1
4256,5067490131,SI,5 CRESTON STREET,01,A1,THE SPITALIERI FAMILY SUPPLEMENTAL NEEDS  TRUST,2,1,1
4257,5070540501,SI,20 BARRY STREET,01,A1,CELESTINE QUINN ASSET MANAGEMENT TRUST,2,1,1
4258,5078650027,SI,564 ROCKAWAY STREET,01,B2,"WEINER, JEFF M",2,1,1
4259,5078860079,SI,281 MANHATTAN STREET,01,A2,ROSANNE BURRELL IRREVOCABLE TRUST,2,1,1
4260,5078900038,SI,442 YETMAN AVENUE,01,A1,"ARMILLA, RAUL",2,1,1
4261,5078930007,SI,368 SLEIGHT AVENUE,01,A1,"BRENNER, DONNA L",3,2,1
4262,5080030105,SI,44 MAIN STREET,05,K5,MELINDA MALERBA LLC,2,1,1
4263,5080190012,SI,171 BARNARD AVENUE,01,A1,KENNETH J MILLER,2,1,1
4264,5080250095,SI,170 YETMAN AVENUE,01,A1,MICHAEL O. SLEIGHT,2,1,1
4265,5080470039,SI,209 MAIN STREET,04,K4,MAR-TAY MGMT. LLC,4,3,1
4266,1001810016,MN,181 FRANKLIN STREET,05,O5,FANTIS TRANSFER CORPINC,2,1,1
4267,1003230001,MN,288 DELANCEY STREET,03,D3,NYC HOUSING AUTHORITY,21,20,1
4268,1004060058,MN,513 EAST 12 STREET,04,C7,NYC HOUSING PRESERVATION AND DEVELOPMENT,2,1,1
4269,1004810021,MN,50 SPRING STREET,05,K2,BRANNON REALTY  LLC,2,1,1
4270,1005820050,MN,2 7 AVENUE,09,P6,NYC DEPARTMENT OF PARKS AND RECREATION,2,1,1
4271,1006100069,MN,19 CHRISTOPHER STREET,04,C7,"DAVIT REALTY,",2,1,1
4272,1008280001,MN,776 AVENUE OF THE AMER,03,D8,CHELSEA NEW YORK REALTY COMPANY LLC,3,2,1
4273,1010600121,MN,421 WEST 50 STREET,01,B9,421 WEST 50TH STREET LLC,2,1,1
4274,1011140061,MN,44 WEST 62 STREET,03,D4,LINCOLN PLAZA TENANTS CORP,2,1,1
4275,1017090007,MN,415 EAST 115 STREET,02,C1,HOPE EAST OF FIFTH HOUSING DEVELOPMENT F UND CO INC,2,1,1
4276,1017240105,MN,77 WEST 126 STREET,03,D3,W 126 ST. OPERATING LLC,2,1,1
4277,1018410003,MN,925 COLUMBUS AVENUE,04,C7,M BROTHERS INC,2,1,1
4278,1019600029,MN,26 EDGECOMBE AVENUE,08,I7,THE NORTH-EASTERN CONFERENCE CORPORATION,2,1,1
4279,1021140052,MN,509 WEST 155 STREET,03,D1,509 REALTY CO. LLC,2,1,1
4280,2023140067,BX,297 ALEXANDER AVENUE,02,C0,"GOOD FAITH PARTNERS, LLC",2,1,1
4281,2024940001,BX,1015 RIVER AVENUE,09,Q1,NYC DEPARTMENT OF PARKS AND RECREATION,7,6,1
4282,2025620031,BX,714 EAST 134 STREET,01,B2,"CAINES, III, CHARLES  F",2,1,1
4283,2026170014,BX,660 ST ANNS AVENUE,04,C7,QUADRANT PROPERTIES HOUSING DEVELOPMENT  FUND COMPA,2,1,1
4284,2028040031,BX,1855 ANTHONY AVENUE,08,W1,NYC DEPARTMENT OF EDUCATION,2,1,1
4285,2028120021,BX,206 BUSH STREET,08,M9,FIRST BIBLE CHURCH OF THE LORDS MISSION,2,1,1
4286,2029400026,BX,1724 CROTONA PARK EAST,02,C1,CROTONA VIII HOUSINGDEVELOPMENT FUND COR P,2,1,1
4287,2030950035,BX,712 EAST 180 STREET,11,V1,DJ EAST 180 LLC,2,1,1
4288,2031220035,BX,2066 HONEYWELL AVENUE,01,B3,D.K. HONEYWELL LLC,4,3,1
4289,2031220037,BX,2070 HONEYWELL AVENUE,02,C0,D.K. HONEYWELL LLC,2,1,1
4290,2032520378,BX,3961 ORLOFF AVENUE,02,C0,SABAHATE DEDUSHI,2,1,1
4291,2033840012,BX,310 EAST 236 STREET,01,B1,"FLYNN, THOMAS",2,1,1
4292,2033870003,BX,4334 KATONAH AVENUE,04,K4,DEBAR REALTY CORP.,2,1,1
4293,2035000054,BX,459 WHITE PLAINS ROAD,01,B3,"MUSLEH, FANHRIYA",2,1,1
4294,2036850057,BX,2145 TURNBULL AVENUE,01,B1,"ARIAS, DORCAS",2,1,1
4295,2037100055,BX,1071 COLGATE AVENUE,01,B1,"JUAREZ, CHRISTOPHER",2,1,1
4296,2038200076,BX,2229 POWELL AVENUE,02,C0,"DASS, PITAMBER",2,1,1
4297,2038300003,BX,1208 HAVEMEYER AVENUE,08,M1,"IGLESIA CHRISTANA FUENTE ETERNA, INC.",2,1,1
4298,2039360006,BX,1378 WHITE PLAINS ROAD,01,A1,1378 WHITE PLAINS ROAD CORP.,2,1,1
4299,2040050001,BX,1129 EAST 179 STREET,06,E9,TRANSAMERICA HOLDINGS LLC,2,1,1
4300,2040340041,BX,1734 HUNT AVENUE,10,G7,AAF REALTY LLC,2,1,1
4301,2040640007,BX,1038 PIERCE AVENUE,01,A1,"LOPEZ, LYDIA",2,1,1
4302,2041650046,BX,1615 PLYMOUTH AVENUE,01,A1,"MARTIRE, MICHAEL",2,1,1
4303,2042700052,BX,1932 HONE AVENUE,01,A1,"CUTIGNOLA, GINA",2,1,1
4304,2044350039,BX,770 ALLERTON AVENUE,05,O5,"A.A. REALTY,",2,1,1
4305,2045930015,BX,3236 BRONX BOULEVARD,01,B2,HUDSON R WALDRON,2,1,1
4306,2046660077,BX,758 EAST 219 STREET,02,C1,758 EAST 219 LLC,2,1,1
4307,2046760009,BX,861 EAST 217 STREET,02,C3,"WANZER, DWIGHT",2,1,1
4308,2046770025,BX,827 EAST 218 STREET,02,C1,"218 REALTY, LLC",2,1,1
4309,2047410026,BX,3213 FENTON AVENUE,01,A5,"SUTHERLAND, VETA B",2,1,1
4310,2047580020,BX,3221 EDSON AVENUE,06,E1,RICA LTD,2,1,1
4311,2047660058,BX,3052 EASTCHESTER ROAD,04,S1,"3052 EASTCHESTER ROAD, LLC",2,1,1
4312,2048210042,BX,4026 BRONX BOULEVARD,01,A1,KRISHNA INVESTMENTS LLC,2,1,1
4313,2048440007,BX,763 EAST 230 STREET,01,B3,"MCLEOD, LEONARD",2,1,1
4314,2049530044,BX,1660 EAST 233 STREET,10,G1,"PAUL'S WELDING SPRING WORKS , INC.",2,1,1
4315,2049690014,BX,4013 DYRE AVENUE,04,S4,SKY PARTNERS NYS LLC,2,1,1
4316,2050530021,BX,4346 BRUNER AVENUE,01,A1,LAIRD BARBARA,2,1,1
4317,2053310034,BX,1237 PURITAN AVENUE,01,A2,"WOOD, KENNETH P",2,1,1
4318,2053980037,BX,3043 CODDINGTON AVENUE,01,A1,"BAILEY, ERIK J",2,1,1
4319,2054100038,BX,1422 ROBERTSON PLACE,01,B3,"HARRY CELENTANO, TRUSTEE",2,1,1
4320,2054130042,BX,1620 KENNELLWORTH PLACE,01,B3,"ABBATIELLO, SALVATORE",2,1,1
4321,2054190009,BX,3481 EAST TREMONT AVENUE,05,O2,"MONTEMURRO ENTERPRISES, LLC",2,1,1
4322,2054450011,BX,2912 GERBER PLACE,01,A1,"SANCHEZ, DENNIS JR",2,1,1
4323,2055450108,BX,723 CALHOUN AVENUE,01,B1,"TORRES, DIANA MARIE",2,1,1
4324,2055450138,BX,752 QUINCY AVENUE,02,C0,"GUZMAN, RAFAEL",2,1,1
4325,2055990047,BX,2634 MILES AVENUE,01,B2,2632 MILES AVE LLC,2,1,1
4326,2056310022,BX,40 BAY STREET,01,A9,O'DONNELL STEVEN P,2,1,1
4327,2056310057,BX,17 FORDHAM STREET,01,A2,"O'KEEFE, JOYCE",2,1,1
4328,2056370134,BX,161 BELDEN STREET,01,B2,THEODORE KARIKAS,2,1,1
4329,2057647501,BX,460 WEST 236 STREET,04,RM,LATITUDE RIVERDALE CONDO,3,2,1
4330,3000870005,BK,175 PEARL STREET,05,O6,MAPLE 3P KRL 175 PEARL OWNER LLC,2,1,1
4331,3001810030,BK,269 PACIFIC STREET,05,K1,63 MONTAGUE REALTY LLC,2,1,1
4332,3002990014,BK,82 CONGRESS STREET,02,C3,82 CONGRESS STREET LLC,2,1,1
4333,3004790022,BK,500 SMITH STREET,04,S2,"HANOVIC, SILVIO",2,1,1
4334,3005300019,BK,75 VERONA STREET,01,B9,"SCHLOSS, ANTHONY",2,1,1
4335,3007220001,BK,4223 2 AVENUE,04,K4,ZADRIMA PROPERTY CORP,2,1,1
4336,3007780009,BK,4803 8 AVENUE,04,S2,WALLACE YU,2,1,1
4337,3007780023,BK,842 48 STREET,08,W1,NYC DEPARTMENT OF EDUCATION,2,1,1
4338,3008100024,BK,746 52 STREET,02,C0,"MAHARAJ, SAVATREE",3,2,1
4339,3008450005,BK,5705 2 AVENUE,07,G4,"57TH AT 2ND SERVICE,INC.",2,1,1
4340,3008860017,BK,318 19 STREET,02,C0,"MAYNARD, ADAM",2,1,1
4341,3011060040,BK,1512 10 AVENUE,01,B1,"ABLEMAN, ADAM",2,1,1
4342,3011380001,BK,601 VANDERBILT AVENUE,04,S2,"FOREMAN, ERVINE",2,1,1
4343,3011400056,BK,751 BERGEN STREET,04,S2,WASHINGTON BERGEN REALTY CORP,2,1,1
4344,3012950027,BK,170 CROWN STREET,01,A4,"HALL, IVY",2,1,1
4345,3012990024,BK,444 CROWN STREET,01,A7,GOPIN TSEIVA,2,1,1
4346,3012990026,BK,446 CROWN STREET,01,A1,NECHAMA DINA ZARCHI AS TRUSTEE,2,1,1
4347,3013180077,BK,79 LEFFERTS AVENUE,01,A4,"SAEMAI, RUMLADA",2,1,1
4348,3013850072,BK,1407 LINCOLN PLACE,01,B1,1407 HOLDING CORP.,2,1,1
4349,3014030007,BK,1722 UNION STREET,04,C7,51722 REALTY LLC,2,1,1
4350,3014070066,BK,1545 CARROLL STREET,01,B1,CARL ROTHMAN,2,1,1
4351,3014260069,BK,661 LEFFERTS AVENUE,01,B1,KOLODNY FAMILY IRREVOCABLE TRUST,2,1,1
4352,3014810003,BK,65 RALPH AVENUE,02,C0,"PETTY, SHARON",2,1,1
4353,3018040006,BK,757 MARCY AVENUE,01,B3,MARCY BROWN 757 LLC,2,1,1
4354,3018857507,BK,54 SKILLMAN STREET,04,RM,UNAVAILABLE OWNER,3,2,1
4355,3020450037,BK,67 ADELPHI STREET,01,B2,STEVEN PREGIATO AS CO-TRUSTEE,2,1,1
4356,3022407503,BK,31 LORIMER STREET,02,R1,UNAVAILABLE OWNER,2,1,1
4357,3025230052,BK,187 HURON STREET,01,B1,"KABATA, CECYLIA",2,1,1
4358,3025230057,BK,177 HURON STREET,02,C2,SLEVIN MARY,2,1,1
4359,3026600001,BK,121 HAUSMAN STREET,06,E1,MNH REALTY LLC,4,3,1
4360,3027040009,BK,94 NORTH HENRY STREET,01,B9,"ZEDZIAN, JANUSZ",2,1,1
4361,3027310038,BK,23 FROST STREET,11,V2,"UZZO, YOLANDA",2,1,1
4362,3027400024,BK,449 HUMBOLDT STREET,02,C1,449 HUMBOLDT LLC,2,1,1
4363,3027550006,BK,376 GRAHAM AVENUE,04,S9,376 GRAHAM REALTY LLC,2,1,1
4364,3027680017,BK,82 DEVOE STREET,02,C1,4 LIKA LLC,2,1,1
4365,3029160070,BK,217 DEVOE STREET,01,B2,ANDREWS CAROLINE R,2,1,1
4366,3029940105,BK,28 VARICK AVENUE,06,E1,28 VARICK AVENUE LLC,2,1,1
4367,3030700001,BK,100 MANHATTAN AVENUE,04,S2,"100 REALTY HOLDINGS, LLC",2,1,1
4368,3031310042,BK,19 FAYETTE STREET,02,C2,SUMNER PLACE LLC,2,1,1
4369,3031700018,BK,18 JEFFERSON STREET,02,C3,38 BEHATZLAHA 1 LLC,2,1,1
4370,3031960019,BK,26 STARR STREET,02,C1,STARR TWO SIX LLC,2,1,1
4371,3032610017,BK,412 STOCKHOLM STREET,02,C0,"SNEAD, BENJAMIN PARKE",2,1,1
4372,3035260327,BK,345 SUTTER AVENUE,07,G5,460 STONE AVENUE GAS,2,1,1
4373,3035550033,BK,226 HERZL STREET,01,B1,"CUPIDORE, JEAN S",2,1,1
4374,3035860040,BK,166 LIVONIA AVENUE,11,V0,"LINDO, IAN",2,1,1
4375,3038850199,BK,38 CROSBY AVENUE,01,A1,"BASILIO, ERNESTO",2,1,1
4376,3039330034,BK,126 HENDRIX STREET,01,B2,"ALMONTE, MARIA",2,1,1
4377,3039340034,BK,92 SCHENCK AVENUE,02,C0,"PETERS, CHARLES",2,1,1
4378,3039530052,BK,2935 ATLANTIC AVENUE,04,S4,EZ GROW LLC,2,1,1
4379,3039670038,BK,647 LIBERTY AVENUE,01,A1,LIBERTY 647 LLC,2,1,1
4380,3040200008,BK,419 ESSEX STREET,02,C0,"ORTIZ, CARLOS",2,1,1
4381,3040540011,BK,303 BERRIMAN STREET,01,B1,"BROWN, SAFIYA S",2,1,1
4382,3041160055,BK,377 RIDGEWOOD AVENUE,02,C0,"FARIAS, JEANINE V",2,1,1
4383,3041450001,BK,3329 ATLANTIC AVENUE,06,E7,SP HHF SUB B LLC,2,1,1
4384,3041530034,BK,3170 ATLANTIC AVENUE,07,G3,3170 ATLANTIC AVE CORP,3,2,1
4385,3041720032,BK,327 AUTUMN AVENUE,01,B1,SAMUEL OYOLA,2,1,1
4386,3043020027,BK,676 BRADFORD STREET,02,C0,ISAAC KINGSLEY,2,1,1
4387,3043420021,BK,190 MALTA STREET,01,B1,EUGENIA MELENDEZ,2,1,1
4388,3044220006,BK,936 JEROME STREET,01,B1,"HENRY, DERICK",2,1,1
4389,3045470055,BK,889 PINE STREET,01,A9,LISA SHAW,2,1,1
4390,3046030005,BK,530 UTICA AVENUE,07,G5,HESS RETAIL STORES LLC,2,1,1
4391,3046220020,BK,104 EAST 53 STREET,01,B1,EAST 53 BK LLC,2,1,1
4392,3047160056,BK,530 EAST 96 STREET,02,C3,"APHANORD, SUZE",2,1,1
4393,3047340032,BK,1080 UTICA AVENUE,08,W3,1080 UTICA OWNER LLC,2,1,1
4394,3047510037,BK,9104 AVENUE A,01,B3,"BYNES, LEE HUGH",2,1,1
4395,3047610058,BK,1111 UTICA AVENUE,05,K1,TOP DEVELOPMENT CORPORATION,2,1,1
4396,3047930057,BK,511 MAPLE STREET,01,B9,"FRIEDMAN, SHNEUR Z",2,1,1
4397,3048740045,BK,223 EAST 37 STREET,01,A5,"JDRMDBPP, SM, SKP & JD IRA LLC C/O JEREM Y DOPPELT",2,1,1
4398,3048890050,BK,215 EAST 35 STREET,01,B2,"WILSON, JOAN",2,1,1
4399,3049530064,BK,1267 BROOKLYN AVENUE,02,C0,HINDS GWENDOLYN,2,1,1
4400,3052370095,BK,1610 FOSTER AVENUE,01,A1,"BERNSTEIN, A",2,1,1
4401,3052370246,BK,1415 GLENWOOD ROAD,01,A1,"RAND, MARK",2,1,1
4402,3052520029,BK,619 EAST 29 STREET,01,B2,"KARIM, TARIQ",2,1,1
4403,3052940060,BK,1235 39 STREET,04,S2,"LESER, JACOB/TRUSTEE",2,1,1
4404,3053320036,BK,141 DAHILL ROAD,01,B1,"JOHNSON, ROSINA",2,1,1
4405,3053860067,BK,593 EAST 2 STREET,01,B2,"PASHA, JOSNA A",2,1,1
4406,3054280003,BK,745 OCEAN PARKWAY,04,O8,STRONG VALUE ESTATE FAMILY LIMITED PARTN ERSHIP,2,1,1
4407,3054320044,BK,4408 17 AVENUE,01,B1,"ZOBERMAN, ESTHER",2,1,1
4408,3054370034,BK,1666 46 STREET,01,B3,"HEILBRUN, ESTHER",2,1,1
4409,3054580054,BK,1559 51 STREET,01,B3,"WEINGARTEN, PESSIE",2,1,1
4410,3054660071,BK,1647 52 STREET,01,A3,ES 52ND STREET CORP.,2,1,1
4411,3054680006,BK,5107 18 AVENUE,01,B2,"WEISZ, MEIER",2,1,1
4412,3054720051,BK,1677 53 STREET,01,B3,"LEITMAN, JACK",2,1,1
4413,3054870027,BK,1854 54 STREET,01,A9,"GOLDBERGER, JOEL",2,1,1
4414,3054900069,BK,1715 56 STREET,01,A9,SOLOMON DEUTSCH,3,2,1
4415,3054987501,BK,1714 57 STREET,02,R3,NAME NOT ON FILE,2,1,1
4416,3055340003,BK,6219 19 AVENUE,01,B3,"TOGATI, BENEDETTO",2,1,1
4417,3055670028,BK,1661 68 STREET,01,A5,CYNTHIA JIE LIN,2,1,1
4418,3055950066,BK,929 43 STREET,04,C7,929 43 ST REALTY LLC,2,1,1
4419,3056000031,BK,1462 42 STREET,,Z9,1462 BYBZ LLC,2,1,1
4420,3056040052,BK,1247 44 STREET,02,C0,MINA HOROWITZ TRUST,2,1,1
4421,3056990029,BK,1466 57 STREET,08,M3,CONGREGATION BETH AARON,2,1,1
4422,3057060073,BK,1415 59 STREET,01,B1,"WIESNER, SAMUEL",2,1,1
4423,3058600110,BK,6802 COLONIAL ROAD,02,C0,"BHUTTA, SHAUKAT ALI",2,1,1
4424,3058850013,BK,7011 COLONIAL ROAD,01,B1,"LEE, TZE KAU",2,1,1
4425,3059660018,BK,70 78 STREET,01,A1,PATRICK WHELAN,2,1,1
4426,3059740068,BK,1025 79 STREET,01,A5,"LECHNER, ROBERT",2,1,1
4427,3060150050,BK,165 84 STREET,01,A1,"GANIM, CHRISTOPHER",2,1,1
4428,3060480058,BK,217 88 STREET,01,B2,"CASTELLO, STEVEN JASON",2,1,1
4429,3061640040,BK,6906 BAY PARKWAY,05,K1,ZEKI KANTAR,2,1,1
4430,3062390055,BK,1955 77 STREET,01,B3,"DONG, LI WEI",2,1,1
4431,3062617501,BK,1820 78 STREET,02,R3,UNAVAILABLE OWNER,3,2,1
4432,3062770030,BK,2258 79 STREET,01,B1,"DECKMAN, TRUSTEE, MARY",2,1,1
4433,3062970050,BK,1969 82 STREET,01,B3,"LEE, MEEI LIAN",2,1,1
4434,3065110067,BK,867 EAST 8 STREET,01,A1,THE ERIC ADJMI 2015 IRREVOCABLE TRUST,2,1,1
4435,3065120027,BK,852 EAST 10 STREET,01,A1,"CHALOUH, LEAH",2,1,1
4436,3065160030,BK,1080 EAST 4 STREET,01,A1,MORRIS BECHER,2,1,1
4437,3065670033,BK,1448 EAST 5 STREET,01,B2,"ESSES, DAVID",2,1,1
4438,3065700021,BK,1334 EAST 8 STREET,01,B2,SHELDON WINDERBAUM,2,1,1
4439,3065780065,BK,1409 WEST 7 STREET,04,S9,1409 WEST 7TH STREET LLC,2,1,1
4440,3065900062,BK,1481 EAST 8 STREET,01,B3,"KAMEO, VICTOR",2,1,1
4441,3065900076,BK,1449 EAST 8 STREET,01,A1,"SHALOM, MORRIS",2,1,1
4442,3065970005,BK,44 AVENUE O,04,S1,GIORGIO CATAUDELLA,2,1,1
4443,3066080038,BK,1642 EAST 2 STREET,02,C3,GIUSEPPE TORTORELLI,2,1,1
4444,3066100074,BK,1651 EAST 3 STREET,01,B2,"1651 ASSOCIATES, LLC",2,1,1
4445,3066140043,BK,1580 EAST 8 STREET,01,B2,DWECK YOEL,2,1,1
4446,3066280014,BK,1618 WEST 3 STREET,01,A9,"KRIVOGORSKIY , ALEKSANDR",2,1,1
4447,3066280052,BK,1661 WEST 4 STREET,02,C0,"LI, ZHUOZHAN",2,1,1
4448,3066390052,BK,1765 EAST 7 STREET,01,A3,"HARARI-RAFUL, AHARON",2,1,1
4449,3066610033,BK,1850 EAST 5 STREET,01,A9,"DWECK, ALBERT",2,1,1
4450,3066610050,BK,1859 EAST 4 STREET,01,A1,"ORFALI, JACOB",2,1,1
4451,3066630082,BK,1727 OCEAN PARKWAY,01,A7,"1727 OP, LLC",3,2,1
4452,3066710003,BK,104 HIGHLAWN AVENUE,02,C0,"CORSO, ANTHONY",3,2,1
4453,3066810263,BK,1960 EAST 4 STREET,01,A1,"CHAYA LANIADO FALAH, TRUSTEE",2,1,1
4454,3066810273,BK,427 AVENUE S,01,A9,ELLIOT BETESH,2,1,1
4455,3067470022,BK,1336 EAST 19 STREET,01,A9,ABRAHAM SEIF,2,1,1
4456,3067490035,BK,1464 EAST 12 STREET,01,B3,"RABINOWITZ, MENACHEM",2,1,1
4457,3067910048,BK,1655 EAST 28 STREET,01,A1,"MANN, AKIVA",2,1,1
4458,3068010006,BK,1820 QUENTIN ROAD,01,A1,"BOUSKILA, GABRIEL",2,1,1
4459,3068100040,BK,1782 EAST 28 STREET,08,M1,CONGREGATION KOZOVER-ZICHRON CHAIM SHLOI ME,2,1,1
4460,3068190061,BK,1871 EAST 13 STREET,01,B1,"HARRY I. BRAMS, AS TRUSTEE",2,1,1
4461,3068300050,BK,2401 AVENUE S,01,A1,"COHEN, MIRIAM",2,1,1
4462,3068780040,BK,99 BAY 38 STREET,02,C0,"CHEN, FEI WU",2,1,1
4463,3069120051,BK,192 27 AVENUE,11,V0,UNIVERSAL ACTIONS LLC,2,1,1
4464,3069430163,BK,1900 SHORE PARKWAY,09,Q9,1900 ACQUISITION LLC,2,1,1
4465,3070290072,BK,3727 MERMAID AVENUE,01,B9,"CAPUTO, MERRIE STARR",2,1,1
4466,3070850033,BK,1964 WEST 3 STREET,01,A5,"COHEN, ISAAC",2,1,1
4467,3070860085,BK,137 VAN SICKLEN STREET,01,A1,"DOUEK, ISAAC",2,1,1
4468,3070880086,BK,1925 OCEAN PARKWAY,01,A3,"JESSE SUTTON, TRUSTEE",2,1,1
4469,3071040344,BK,348 AVENUE T,01,A1,"GINDI, RALPH RANDY",2,1,1
4470,3071040379,BK,384 AVENUE T,01,A1,SABBAGH FAMILY LLC,2,1,1
4471,3071060174,BK,2014 EAST 4 STREET,01,A3,HMM NEVADA TRUST,2,1,1
4472,3071320066,BK,2191 EAST 5 STREET,01,A9,RACHIL CHAMAA SARADAR,2,1,1
4473,3071320070,BK,2181 EAST 5 STREET,01,A9,HENRY NAFTALI,2,1,1
4474,3071560037,BK,2318 EAST 5 STREET,01,B3,"JAJATI, BERTA",2,1,1
4475,3071980027,BK,2472 EAST 3 STREET,01,A1,SAMMY MANN,2,1,1
4476,3072170036,BK,2568 EAST 2 STREET,01,B2,"PINKHASOV, GALINA",2,1,1
4477,3073280053,BK,2073 EAST 23 STREET,01,B1,"CHEN, NANWEI",2,1,1
4478,3073710020,BK,2226 EAST 12 STREET,01,B2,2226 EAST 12 STREET LLC,2,1,1
4479,3074410450,BK,2567 EAST 22 STREET,01,B2,"DORODNY, LEONID",2,1,1
4480,3075720080,BK,882 EAST 27 STREET,01,A9,"KATZ, KREINDY",2,1,1
4481,3075870026,BK,945 EAST 23 STREET,01,A1,"SNYDER, ESTHER",2,1,1
4482,3075910057,BK,930 EAST 28 STREET,01,A9,CHANOCH 2 HOROWITZ,2,1,1
4483,3075920055,BK,924 EAST 29 STREET,01,B2,"HEILBRUN, TUVIA",2,1,1
4484,3076160125,BK,1213 EAST 34 STREET,01,A5,"FINGERER, ISAAC",2,1,1
4485,3076250035,BK,3245 BEDFORD AVENUE,01,B2,"HASC CENTER, INC.",2,1,1
4486,3076430033,BK,3343 BEDFORD AVENUE,01,B2,"COHEN, GIZELLE",2,1,1
4487,3076570012,BK,1497 EAST 21 STREET,01,A3,"FRIEDLAND, MANCI",2,1,1
4488,3076800080,BK,1462 EAST 27 STREET,01,B3,"TREFF, MORDECHAI",2,1,1
4489,3076990002,BK,3717 AVENUE P,01,A5,"SCHONBRUN, SAMUEL",2,1,1
4490,3077290219,BK,4525 AVENUE H,01,A9,"ELLIS, SYBLE S",2,1,1
4491,3077470022,BK,983 EAST 43 STREET,01,A1,"AHSAN, MUHAMMAD Q",2,1,1
4492,3077730034,BK,1751 SCHENECTADY AVENUE,01,A1,"BROWN, BRITTANY V",2,1,1
4493,3078130027,BK,1235 EAST 40 STREET,01,A9,"NRI, MONIQUE NGOZI",2,1,1
4494,3078240008,BK,4407 AVENUE L,01,A5,"BEKOE, SHERMA",2,1,1
4495,3078330002,BK,5321 AVENUE L,01,A9,"NELSON, JOHN",2,1,1
4496,3078490001,BK,5105 AVENUE M,08,W1,NYC DEPARTMENT OF EDUCATION,2,1,1
4497,3078530063,BK,1336 EAST 56 STREET,01,A9,CAROLYN D. KING,2,1,1
4498,3078730064,BK,1664 EAST 49 STREET,01,A9,"BECKER, BARBARA",2,1,1
4499,3078770081,BK,1602 EAST 53 STREET,04,S3,GE LIN,2,1,1
4500,3078800035,BK,1459 EAST 55 STREET,01,A9,"ZULFIQAR, MUHAMMAD",2,1,1
4501,3078800054,BK,1408 EAST 56 STREET,01,A9,"JOSEPH, SHARLIN",2,1,1
4502,3079460040,BK,914 REMSEN AVENUE,07,G5,PUPPY LLC,2,1,1
4503,3080260048,BK,1220 REMSEN AVENUE,01,B2,"JAMES, MOSEKA",2,1,1
4504,3081260037,BK,854 EAST 94 STREET,01,A1,MAUDER GEORGE C JR,3,2,1
4505,3081630061,BK,1056 EAST 95 STREET,01,A1,"JOSEPH, MARIE F",2,1,1
4506,3084070049,BK,2065 EAST 64 STREET,01,A9,"LU, JIAJIE",2,1,1
4507,3085270050,BK,2016 HENDRICKSON STREET,01,A1,"NANIA, JAMES",2,1,1
4508,3086610072,BK,2965 OCEAN PARKWAY,05,O7,OPD ASSOCIATES INC.,2,1,1
4509,3086940005,BK,1228 SURF AVENUE,11,V1,RAMIN CONEY LLC,2,1,1
4510,3088451992,BK,9 ABBEY COURT,01,A1,"HUFFMAN, ROBERT",3,2,1
4511,4001550008,QN,44-05 SKILLMAN AVENUE,02,C0,"WILSON, BRENDA",2,1,1
4512,4001860026,QN,39-46 SKILLMAN AVENUE,05,K1,"MCGOWAN, JOHN",2,1,1
4513,4003240023,QN,34-09 9 STREET,02,C2,"34-09 9TH ST, INC.",2,1,1
4514,4005150038,QN,30-10 14 STREET,01,B1,"SINGH, ULDITEEN",2,1,1
4515,4005170002,QN,30-76 14 STREET,02,C2,30-76 REALTY CORP,2,1,1
4516,4005360055,QN,30-28 21 STREET,02,C0,"FORERO, LUIS C",3,2,1
4517,4005400026,QN,14-19 ASTORIA BOULEVARD,01,B2,"AHMED, IMITAZ",2,1,1
4518,4005980010,QN,26-59 30 STREET,02,C0,NASSEIF MARIA,2,1,1
4519,4005980076,QN,30-03 NEWTOWN AVENUE,04,C7,30-03 NEWTOWN REALTY LLC,2,1,1
4520,4006150063,QN,30-66 32 STREET,02,C2,VERNALEO LLC,2,1,1
4521,4006190101,QN,31-33 28 ROAD,01,B3,"QUINTAS-VALENTE, RITA",2,1,1
4522,4006300033,QN,28-32 37 STREET,02,C2,2832 37TH STREET PROPERTY LLC,2,1,1
4523,4006380037,QN,35-38 35 STREET,08,P5,NYC DEPARTMENT OF PARKS AND RECREATION,2,1,1
4524,4007560077,QN,20-68 HAZEN STREET,01,B2,"DZIAK, MARIOLA",2,1,1
4525,4008080156,QN,21-60 38 STREET,01,A5,"MIR, RAHILA",2,1,1
4526,4008740042,QN,24-32 23 STREET,02,C0,"MASCETTI, DOMINICK A",2,1,1
4527,4008750036,QN,23-17 23 STREET,01,A5,"KYPRIANIDES, EFTHIMIA",2,1,1
4528,4009140033,QN,26-38 3 STREET,01,B9,KOS REALTY LLC,2,1,1
4529,4010430003,QN,79-08 24 AVENUE,02,C0,"BAWALAN, LILIBETH Z",3,2,1
4530,4011550060,QN,32-41 53 PLACE,01,A5,"CEPEDA, JAIME",2,1,1
4531,4011710001,QN,32-01 75 STREET,04,S2,NAMAN MERAL,2,1,1
4532,4011830010,QN,60-20 NORTHERN BOULEVARD,,Z9,MOSHAKEY INC.,2,1,1
4533,4013090070,QN,41-62 70 STREET,02,C0,"WONG, SHU PING",2,1,1
4534,4013280032,QN,57-04 ROOSEVELT AVENUE,08,M1,SEH MOON KOREAN BPTST/CH,2,1,1
4535,4013740150,QN,26-33 94 STREET,01,A1,DONNA KOBRYN,2,1,1
4536,4013760042,QN,26-33 96 STREET,02,C3,CAROLYN E RUFFIN,2,1,1
4537,4013860042,QN,30-59 88 STREET,01,A5,ACEVEDO IRIS,2,1,1
4538,4015410010,QN,82-39 51 AVENUE,05,O7,"CHANG, HUI  I",2,1,1
4539,4015890105,QN,94-17 40 ROAD,02,C0,CHOUDHURY HADI H,2,1,1
4540,4016770003,QN,107-08 31 AVENUE,01,B3,"GARCIA, GABRIELA",2,1,1
4541,4017040164,QN,32-33 110 STREET,02,C3,"DIAZ, JAIME",2,1,1
4542,4017190012,QN,33-12 105 STREET,01,B1,"XIA, CHONG HUA",2,1,1
4543,4017470081,QN,35-09 105 STREET,02,C3,"LIN, YI XING",2,1,1
4544,4017720037,QN,104-17 37 DRIVE,02,C3,"ZHENG, SHIJIAN",2,1,1
4545,4019380016,QN,53-08 102 STREET,11,V0,"SARA & LILY ASSETS, INC.",2,1,1
4546,4019850064,QN,104-43 42 AVENUE,02,C0,"LIN, CHUN",2,1,1
4547,4020090055,QN,109-31 54 AVENUE,02,C2,"WANG, YU",2,1,1
4548,4020150058,QN,111-47 43 AVENUE,01,B1,XIU BING LU,2,1,1
4549,4022210047,QN,108-43 70 AVENUE,01,A3,"JUSUPOV, NISSAN",2,1,1
4550,4022360012,QN,110-16 72 AVENUE,03,D1,"KALIKOW FAMILY PARTNERSHIP, L P",2,1,1
4551,4023690045,QN,54-36 64 STREET,01,A1,"WELSH, AIDEN",2,1,1
4552,4023890132,QN,48-22 66 STREET,02,C0,"CHEN, KONG FU",2,1,1
4553,4024850004,QN,51-67 72 PLACE,01,A1,MARY ROCHFORD,3,2,1
4554,4024970010,QN,53-47 69 STREET,01,B3,"NAPOLITANO AS TENT IN COMMON, DINO S",2,1,1
4555,4025050073,QN,54-40 72 STREET,01,B2,5440 72ND ST INC,2,1,1
4556,4027260014,QN,60-34 FLUSHING AVENUE,01,B2,"CHAMBERS, KORI",2,1,1
4557,4027490047,QN,57-48 64 STREET,01,B2,"AVILA, LEONARDO",2,1,1
4558,4027570068,QN,62-37 60 ROAD,01,B2,"CONNOLLY, PETER",2,1,1
4559,4028150065,QN,57-36 78 STREET,01,B3,"BAMONTE, NICHOLAS",2,1,1
4560,4028340071,QN,59-03 71 STREET,01,A1,ADOLPH HOEGLER,2,1,1
4561,4028700039,QN,86-03 57 ROAD,01,B2,BADAMI TERESA,2,1,1
4562,4030540029,QN,66-54 71 STREET,01,B2,"MALONE, JOANNE",2,1,1
4563,4030570055,QN,66-57 PLEASANTVIEW STREET,01,A1,"JOANN, QUINLAN M",2,1,1
4564,4030920066,QN,62-64 WETHEROLE STREET,01,A1,"TANG, GILLEY",2,1,1
4565,4031220016,QN,63-13 DIETERLE CRESCENT,01,A1,OUR SAVIOUR LUTH CHURCH,2,1,1
4566,4032080002,QN,89-04 69 AVENUE,01,A1,"CHUNG, VIRGINIA",2,1,1
4567,4032430056,QN,71-21 LOUBET STREET,01,B3,71-21 LOUBET LLC,2,1,1
4568,4034920045,QN,60-04 METROPOLITAN AVENUE,07,G4,BILL WOLF PETROLEUM CORP,2,1,1
4569,4036000024,QN,65-34 MYRTLE AVENUE,04,S4,MAPLACE LLC,2,1,1
4570,4036350011,QN,69-12 65 STREET,01,B2,LUPO SALVATORE,2,1,1
4571,4036610042,QN,70-12 71 STREET,01,B2,"GOMEZ, JOSE",2,1,1
4572,4038030034,QN,70-20 COOPER AVENUE,06,F1,70-20 COOPER AVENUE LLC,3,2,1
4573,4038270012,QN,78-04 79 STREET,01,B3,RAFAL PYCIOR,2,1,1
4574,4041630009,QN,20-29 120 STREET,01,B2,CYNTHIA SANCHEZ,2,1,1
4575,4041690017,QN,20-05 124 STREET,08,M1,MACEDONIAN ORTHODOXCHURCH OF ST CLEMENT  OF OHRID,2,1,1
4576,4042240032,QN,23-18 120 STREET,01,B2,"ARIAS, PORFIRIO",2,1,1
4577,4042320039,QN,23-12 129 STREET,01,B1,"CHI, XIAXIU",2,1,1
4578,4042560108,QN,120-05 GRAHAM COURT,01,B3,CP DEVELOPMENT PROPERTY LLC,2,1,1
4579,4043740035,QN,31-50 140 STREET,03,D4,LINDEN TOWERS COOP SEC 1 INC,3,2,1
4580,4046830007,QN,150-44 15 DRIVE,01,B3,ALAN S. LERNER,2,1,1
4581,4046880027,QN,19-08 MURRAY STREET,01,A1,"TATTA, SALVATORE",3,2,1
4582,4046920013,QN,150-11 23 AVENUE,01,B3,"WU, CHING TAT",2,1,1
4583,4047070025,QN,151-55 20 ROAD,02,C0,FRANKOLA FAMILY TRUST,2,1,1
4584,4047660010,QN,163-04 16 AVENUE,01,A2,"WEI, MERU",2,1,1
4585,4048440046,QN,154-59 24 AVENUE,01,A1,"JOHN LORDI, TRUSTEE",2,1,1
4586,4049680011,QN,133-16 KING ROAD,05,K1,"133-16 KING ROAD,    .",2,1,1
4587,4049870001,QN,147-45 34 AVENUE,01,A1,"YEUN, DUL JA",2,1,1
4588,4050540037,QN,41-16 149 PLACE,02,C0,"ZHANG, HONGTU",2,1,1
4589,4051810017,QN,42-15 UNION STREET,08,M1,"FIRST BAPTIST CHURCH OF FLUSHING, L.I.",3,2,1
4590,4051840035,QN,143-63 ASH AVENUE,04,S3,HOLY SPIR/ASSOC/UNIF/W/C,2,1,1
4591,4053840025,QN,42-12 155 STREET,01,A1,LY HOA K,2,1,1
4592,4057500006,QN,166-02 17 ROAD,02,C6,CLEARVIEW GARDNS 3RD CORP,101,100,1
4593,4057620024,QN,166-42 22 AVENUE,01,A1,WEITZMAN JOEL,2,1,1
4594,4059960016,QN,26-21 210 STREET,01,B3,SCHAEFER RAYMOND P,2,1,1
4595,4060220003,QN,29-03 JORDAN STREET,01,B1,"LIN, HONG XIN",2,1,1
4596,4060330012,QN,32-14 204 STREET,01,B3,"XU, LINJUN",2,1,1
4597,4061800038,QN,35-11 215 PLACE,01,A1,BOEHME KATHLEEN M,2,1,1
4598,4067920600,QN,161-25 JEWEL AVENUE,03,D4,SECOND HOUSING CO INC,31,30,1
4599,4068250005,QN,158-06 76 AVENUE,02,C9,158-06/10 REALTY LLC,3,2,1
4600,4068560044,QN,80-14 162 STREET,01,A1,"DOMINGUEZ GARCIA, DIVINA",3,2,1
4601,4069660001,QN,75-03 164 STREET,04,S2,FULL HOUSE CHEN LLC,3,2,1
4602,4070030036,QN,77-41 167 STREET,01,A1,YURI SHAMSIEV,2,1,1
4603,4072140049,QN,75-65 197 STREET,01,B1,"AHA HOLDINGS, LLC",2,1,1
4604,4072730050,QN,81-21 190 STREET,01,A1,MICHAEL S. FASSLER,2,1,1
4605,4077320150,QN,210-11 75 AVENUE,03,D4,WP OWNERS CORP,8,7,1
4606,4079700162,QN,88-26 MOLINE STREET,01,B1,"CORTEZ, STEPHANIE",2,1,1
4607,4080930001,QN,38-73 DOUGLASTON PARKWAY,01,B3,"CHANG, YOUNG",2,1,1
4608,4081290071,QN,252-01 NORTHERN BOULEVARD,05,K2,ML REALTY 252-01 NORTHERN LLC,2,1,1
4609,4081380065,QN,43-12 MORGAN STREET,01,A2,"LEE, SUN HEE",2,1,1
4610,4082510004,QN,252-36 BRATTLE AVENUE,01,A1,"GRIGOLI, ANTHONY",2,1,1
4611,4082600011,QN,253-26 NORTHERN BOULEVARD,11,V1,253-26 NORTHERN LLC,2,1,1
4612,4082600024,QN,254-18 NORTHERN BOULEVARD,05,K2,KIWI CONCEPT LLC,2,1,1
4613,4082867504,QN,65-09 242 STREET,02,R3,BOARD OF MANAGERS COLONIAL TOWNHOUSES CO NDOMINIUM,43,42,1
4614,4085720138,QN,249-04 81 AVENUE,01,A2,"PATEL, TASVIR G",3,2,1
4615,4086390003,QN,88-17 COMMONWEALTH BLVD,01,A1,TUFANO SUSAN,2,1,1
4616,4086600028,QN,91-10 247 STREET,01,A1,"DALLA, MOHINDER S.",2,1,1
4617,4088020029,QN,85-11 259 STREET,01,B3,ANNMARIE CHAKIRY,2,1,1
4618,4089550001,QN,91-03 78 STREET,01,B2,"MANON, ELIZABEL",2,1,1
4619,4089630049,QN,90-25 80 STREET,01,B2,"ANDRADE, HAYDEE",2,1,1
4620,4091000037,QN,101-68 94 STREET,01,B2,THALITA VIRUET,2,1,1
4621,4091040028,QN,101-52 98 STREET,01,B2,"AHMED, FOYSAL",2,1,1
4622,4091740078,QN,109-31 96 STREET,01,B2,"LALL, DEODAT",2,1,1
4623,4091810037,QN,101-21 JAMAICA AVENUE,04,S9,"ZARETSKY, ELLIOT",3,2,1
4624,4092290029,QN,86-19 115 STREET,01,A1,"GONZALEZ, THOMAS PETER",2,1,1
4625,4092490096,QN,84-53 127 STREET,01,B1,"YAU, DAVID",2,1,1
4626,4092960009,QN,104-30 90 AVENUE,01,B2,"AVILA, BELLA R",2,1,1
4627,4092990110,QN,87-68 110 STREET,01,A1,LOERBS THOMASINE,2,1,1
4628,4094300034,QN,112-19 103 AVENUE,01,B3,"HARILAL, HARDAI",3,2,1
4629,4094300039,QN,112-09A 103 AVENUE,01,A1,SINGH MOHINDER,2,1,1
4630,4094460033,QN,94-12 131 STREET,01,A1,MOHAMED FAMILY 2016 TRUST,3,2,1
4631,4095060028,QN,103-54 103 STREET,02,C0,"LEXINSNY, L.L.C",2,1,1
4632,4095580003,QN,120-04 103 AVENUE,02,C0,DAVID BUTTON,2,1,1
4633,4095710010,QN,104-10 118 STREET,01,B3,"ALI, BIBI",2,1,1
4634,4095920133,QN,104-40 133 STREET,01,A1,"CARRION, FANNY",2,1,1
4635,4095930025,QN,105-48 134 STREET,01,A5,"GOMEZ, YAJAIRA",2,1,1
4636,4095990033,QN,107-40 120 STREET,01,A1,"DAVIS, MARILYN J.",2,1,1
4637,4096110034,QN,107-58 132 STREET,01,B2,"SINGH, GURWINDER",2,1,1
4638,4097030025,QN,144-38 87 AVENUE,01,A1,"MOHAMMODALLY, HASEENA",2,1,1
4639,4097130144,QN,141-43 84 DRIVE,02,C0,"GOMES, DAVID",2,1,1
4640,4097330003,QN,150-06 85 AVENUE,01,B1,ALVIN E. KOERBER,2,1,1
4641,4098097501,QN,91-14 175 STREET,04,RM,UNAVAILABLE OWNER,2,1,1
4642,4098110001,QN,175-31 JAMAICA AVENUE,04,K4,175-31 JAMAICA AVENUE LLC,5,4,1
4643,4098280037,QN,173-02 89 AVENUE,02,C0,"MAZUMDER, ABDUL H",2,1,1
4644,4098520001,QN,168-45 HIGHLAND AVENUE,01,A1,"MAHASE, NARDEO",2,1,1
4645,4099220041,QN,89-22 183 STREET,01,A1,JOSE VALLE,2,1,1
4646,4101220045,QN,106-15 154 STREET,08,M1,BETHEL MISSION STATION CHURCH,2,1,1
4647,4101640089,QN,105-22 MERRICK BOULEVARD,04,S4,H.P LEWIS AND GROUP INC,2,1,1
4648,4102220033,QN,168-35 104 AVENUE,01,B2,VIVIAN JAGESHAR,2,1,1
4649,4102470103,QN,171-41 108 AVENUE,01,B3,"WILLIAMS, OTTO",2,1,1
4650,4104170007,QN,186-14 ILION AVENUE,01,A1,AYO O OLANIPEKUN,2,1,1
4651,4104380015,QN,188-30 JORDAN AVENUE,01,B3,"FIELDS, RETA",2,1,1
4652,4104540014,QN,88-11 189 STREET,01,A1,LUIS FERNANDEZ,2,1,1
4653,4105320014,QN,197-29 FOOTHILL AVENUE,01,A1,JACKSON HEIDI,2,1,1
4654,4105650037,QN,91-38 211 PLACE,01,A1,"DEOPERSAUD, PAUL",3,2,1
4655,4105710021,QN,89-28 207 STREET,01,A1,R C CHURCH OF INCARNA,2,1,1
4656,4107170028,QN,90-30 219 STREET,01,B2,"QUIGLEY, MARIA",2,1,1
4657,4108930013,QN,104-16 198 STREET,01,A1,"CLARKE , BRYAN",2,1,1
4658,4109040035,QN,104-41 204 STREET,01,A1,DORETHLEE MALAHOO,2,1,1
4659,4109790021,QN,112-05 203 STREET,01,B3,"WASHINGTON , CHRISTINE",2,1,1
4660,4110030150,QN,113-05 207 STREET,01,A1,EMMANUEL L NELSON,2,1,1
4661,4111170060,QN,109-56 215 STREET,02,C3,"MCKENZIE, BERESFORD",2,1,1
4662,4111640077,QN,105-24 220 STREET,01,A1,"WYCLIFFE L. WALCOTT, JR., AS TRUSTEE",2,1,1
4663,4113470037,QN,84-09 133 AVENUE,01,A5,"GUAN, ZHUO WU",2,1,1
4664,4115320053,QN,137-11 96 STREET,01,B3,"GONZALEZ, CARLOS J.",3,2,1
4665,4117120025,QN,115-57 LEFFERTS BOULEVARD,01,B2,"MAHADEO, JAINARINE",2,1,1
4666,4117540038,QN,119-39 130 STREET,01,A1,"RASUL, RASHAD",2,1,1
4667,4117810264,QN,130-09 135 PLACE,01,A1,BRENDA LEWIS,2,1,1
4668,4117960042,QN,133-19 135 PLACE,01,A1,HICKS CHERYL,2,1,1
4669,4119270039,QN,109-32 142 STREET,01,A1,"YEASMAN, FAIZAH N",2,1,1
4670,4119740009,QN,144-26 LINDEN BOULEVARD,01,A5,"DANIELS , VALERIE",2,1,1
4671,4119780042,QN,114-47 147 STREET,01,A1,"SHARMA, KISHORIE",2,1,1
4672,4120610037,QN,127-07 143 STREET,01,A1,NIDIA M CASTRO,2,1,1
4673,4122020019,QN,150-36 116 ROAD,01,A1,NYC HOUSING AUTHORITY,2,1,1
4674,4122020022,QN,150-42 116 ROAD,01,A1,"BUIUM, RITA",2,1,1
4675,4122160042,QN,150-37 122 STREET,01,A2,"JAVIER, LINCOLN",2,1,1
4676,4122170015,QN,150-22 122 AVENUE,01,B3,"SHABUDIN, RENITA",2,1,1
4677,4122170021,QN,150-38 122 AVENUE,01,A1,"MAYANCELA MAYANCELA, PABLO",2,1,1
4678,4122530005,QN,121-11 LONG STREET,01,B3,"FAMILY RESIDENCES AND ESSENTIAL ENTERPRI SES, INC.",2,1,1
4679,4123520490,QN,170-17 FOCH BOULEVARD,01,A5,KAI GRANT,2,1,1
4680,4123560051,QN,165-15 119 AVENUE,01,B3,"O'MEALLY, SANDRA",2,1,1
4681,4124500010,QN,118-83 RIVERTON STREET,02,C0,"RICHARDSON, ADRIENNE",3,2,1
4682,4125390022,QN,177-10 130 AVENUE,01,A1,STEFANEE LEVEY WILSON,2,1,1
4683,4126030032,QN,118-50 189 STREET,01,A1,"LUNDI, DAVID J",2,1,1
4684,4126910044,QN,120-11 201 STREET,01,B1,GRIER GLENVILLE,2,1,1
4685,4128660039,QN,121-40 HOOK CREEK BOULEVARD,01,A1,VASSALL MAVIS M,2,1,1
4686,4129550020,QN,217-10 133 AVENUE,01,A1,HAZEL G SMITH,2,1,1
4687,4129990196,QN,185-22 MERRICK BOULEVARD,07,G2,211-02 JAMAICA AVENUE CORP,2,1,1
4688,4130360045,QN,218-57 139 AVENUE,01,A5,"DAVIS, WINSOME",2,1,1
4689,4130990018,QN,220-35 135 AVENUE,01,A1,CYNTHIA TEXIDOR,2,1,1
4690,4131620040,QN,228-16 135 AVENUE,01,B3,"SARDINE, BRANON",2,1,1
4691,4131820023,QN,138-23 233 STREET,01,A1,"PEREZ, MINERVA",2,1,1
4692,4132250056,QN,244-03 136 AVENUE,01,A2,"REID, JORY",2,1,1
4693,4132650275,QN,246-10 NORTH CONDUIT AVENUE,02,C0,"MICHAEL FALCO, AS JOINT LIFE TENANTS",2,1,1
4694,4132740174,QN,168-15 144 DRIVE,01,B1,HAROLD WILSON,2,1,1
4695,4132990030,QN,145-52 175 STREET,01,A1,KURLENE H GRIFFITH,2,1,1
4696,4135610001,QN,241-36 MEMPHIS AVENUE,01,A1,GERMAIN CAROLE,2,1,1
4697,4136600033,QN,253-12 CRAFT AVENUE,02,C0,OWEN C JONES,2,1,1
4698,4137500126,QN,148-59 EDGEWOOD STREET,01,B3,MACEY FAMILY TRUST,2,1,1
4699,4141690003,QN,99-04 158 AVENUE,01,A1,RICHARD LATWAITIS,2,1,1
4700,4141800055,QN,159-17 100 STREET,01,A9,"BARBERA, SARA",2,1,1
4701,4142070128,QN,164-01 CROSS BAY BOULEVARD,05,G8,FWS REALTY LLC,2,1,1
4702,4154000016,QN,105 6 ROAD,01,A1,"CARDOZA, ROBERT R",2,1,1
4703,4154550018,QN,121 NOEL ROAD,01,A1,DAVID EASTZER,2,1,1
4704,4155030100,QN,11-66 BRUNSWICK AVENUE,01,B3,"ROSENBACH, CHAIM",2,1,1
4705,4156540005,QN,22-60 NAMEOKE AVENUE,01,B2,"FLETCHER , ALECIA  G",2,1,1
4706,4156850039,QN,15-28 DUNBAR STREET,01,B2,BIBI A. ALI,2,1,1
4707,4160400034,QN,470 BEACH 67 STREET,01,B2,"LAWRENCE, ELIESE",2,1,1
4708,4161220012,QN,324 BEACH 89 STREET,01,A6,"DAILEY, NANONTE",2,1,1
4709,4161330030,QN,171 BEACH 90 STREET,02,C0,"FERRAN-PEREZ, OSMIN",2,1,1
4710,4162340015,QN,183 BEACH 124 STREET,01,B9,BOZIDAR STATEV,2,1,1
4711,4162770037,QN,141 BEACH 132 STREET,01,A3,"NICCHITTA, PETER",2,1,1
4712,5001480029,SI,525 FOREST AVENUE,07,G4,NISSIM KALEV,2,1,1
4713,5001800035,SI,394 CARY AVENUE,01,B2,RONALD WILLIAMS,2,1,1
4714,5001810019,SI,58 SENECA STREET,01,B9,"MACHADO, RICKY",2,1,1
4715,5001810025,SI,48 SENECA STREET,01,B2,"DUARTE-CRUZ, JOHNNY W",2,1,1
4716,5001980085,SI,36 BARKER STREET,10,G0,36 BARKER ST VENTURES LLC,2,1,1
4717,5002050039,SI,182 CLOVE ROAD,08,M9,UNAVAILABLE OWNER,2,1,1
4718,5002050118,SI,79 RECTOR STREET,07,G9,RECTOR REALTY LLC,2,1,1
4719,5002090030,SI,33 ELIZABETH STREET,01,A1,RODDY RICHARDSON,2,1,1
4720,5002270082,SI,360 CLOVE ROAD,02,C0,"HERNANDEZ, CARLOS",2,1,1
4721,5002460078,SI,126 BEVERLY AVENUE,01,B1,"GIORDANO, MICHAEL",3,2,1
4722,5002770050,SI,111 LAWRENCE AVENUE,01,A2,"FISCHER, TIMOTHY R",2,1,1
4723,5004000032,SI,116 WILLARD AVENUE,01,A1,"GRANDSTAFF, III, NORMAN L",2,1,1
4724,5004080007,SI,139 DICKIE AVENUE,01,A2,JOSEPH LAGAMBINA-MARI,2,1,1
4725,5004780069,SI,332 STEWART AVENUE,01,B2,ANASTASIOS FIKIAS & HELEN FIKIAS,3,2,1
4726,5006060060,SI,129 VAN CORTLANDT AVENUE,01,A1,GREGORY J CAPTAIN,2,1,1
4727,5006220060,SI,90 PLEASANT VALLEY AVE,01,B3,"BONACCI, PAUL",2,1,1
4728,5007000075,SI,11 LINCOLN STREET,01,A5,"APEDO, ASHREFE",2,1,1
4729,5007110014,SI,638 MANOR ROAD,01,B3,ANTHONY CALI,2,1,1
4730,5007400053,SI,27 ARDMORE AVENUE,01,A2,EDWARD C. THOMPSON,2,1,1
4731,5007540010,SI,371 FANNING STREET,01,B2,ERAEL BENJAMIN,2,1,1
4732,5008690853,SI,132 OVERLOOK AVENUE,01,A3,"RUBIN, ROMAN",3,2,1
4733,5010390017,SI,95 CORTLANDT STREET,01,B2,LUIS GUTTEREZ,2,1,1
4734,5010580058,SI,252 DECKER AVENUE,01,A1,"WIJESURIYA, SAUMYA C",3,2,1
4735,5010590035,SI,12 RILEY PLACE,01,A1,"JAFFAL, NASSER A",2,1,1
4736,5011320030,SI,495 VILLA AVENUE,01,A1,"WUERFL, JENNY",2,1,1
4737,5011860060,SI,15 MARINERS LANE,01,B9,JIMMY MANGUM,2,1,1
4738,5011920023,SI,117 VAN PELT AVENUE,01,B2,ABN HOME INVESTMENT LLC,2,1,1
4739,5012360145,SI,85 LOCKMAN AVENUE,01,B3,OLAJIDE KOLAWOLE,2,1,1
4740,5012600153,SI,4 DOWNEY PLACE,01,A5,"OLIVA, SALVATORE",2,1,1
4741,5012630012,SI,95 ARLINGTON AVENUE,01,B2,"TITUS, JACKIE",2,1,1
4742,5012630121,SI,88 SOUTH AVENUE,01,B9,"RAJA, SAIRA B",2,1,1
4743,5012770195,SI,26 MACORMAC PLACE,01,A2,BURNEY A BROWN,3,2,1
4744,5015080192,SI,20 CAMBRIDGE AVENUE,01,B9,"NG, KWOK KEUNG",2,1,1
4745,5015080216,SI,68 CAMBRIDGE AVENUE,01,A2,DOREEN VALENZIANO,2,1,1
4746,5016517501,SI,701 SOUTH AVENUE,02,R3,REGALWALK HOMEOWNERS ASSN INC,123,122,1
4747,5021490047,SI,526 ARLENE STREET,01,B2,THE CARMINE F. GERMANO SUPPLEMENTAL NEED S TRUST,2,1,1
4748,5022880117,SI,407 EDINBORO ROAD,01,A1,JAMES TARATUNIO,2,1,1
4749,5027830053,SI,3953 VICTORY BOULEVARD,05,K1,WEST SHORE INN RESTAURANT INC,3,2,1
4750,5029110034,SI,505 BRITTON AVENUE,01,A1,"TORRES, MELINDA",2,1,1
4751,5029710020,SI,40 BELL STREET,01,B2,"QIN DONG, JIAN",3,2,1
4752,5029880027,SI,47 REYNOLDS STREET,01,A5,"SIEMIENIUK, JERZY",2,1,1
4753,5030380022,SI,15 RODERICK AVENUE,01,A2,ALBERT G WARDI,2,1,1
4754,5030400183,SI,651 WEST FINGERBOARD RD,01,A2,PECORARO JOHN H,2,1,1
4755,5030710004,SI,81 LYMAN AVENUE,01,A5,ROCCO JAMES GALLICCHIO,2,1,1
4756,5030710076,SI,11 JUDITH COURT,01,A5,"ZHAO, YAN FANG",2,1,1
4757,5031680004,SI,1050 TARGEE STREET,08,W1,NYC SCA,2,1,1
4758,5032940016,SI,16 RARITAN AVENUE,01,A5,"LU, MING YAO",2,1,1
4759,5032990010,SI,1476 RICHMOND ROAD,08,P7,SI HISTORICAL SOC INC,2,1,1
4760,5033230001,SI,1361 HYLAN BOULEVARD,05,K1,1361 HYLAN BOULEVARD ASSOCIATES LLC,2,1,1
4761,5034110020,SI,22 ANDREWS STREET,01,A0,"LUGO, DAVID",2,1,1
4762,5034110099,SI,15 MC LAUGHLIN STREET,01,B2,"SHAHOOT, MOHAMMAD",2,1,1
4763,5034810001,SI,578 QUINCY AVENUE,10,G0,HOUSING RUST FUND CORPORATION,2,1,1
4764,5036270037,SI,31 NEW DORP LANE,05,O7,LILLIAN H ASSOCIATES,2,1,1
4765,5037260015,SI,395 HAMDEN AVENUE,01,A1,395 HAMDEN AVE LLC,3,2,1
4766,5037400013,SI,226 KISWICK STREET,01,A5,"DUBINKIN, NATALYA",2,1,1
4767,5037400035,SI,869 NUGENT AVENUE,01,A6,FRANK ASTUTO,2,1,1
4768,5038140029,SI,291 COLONY AVENUE,01,A1,SHTEIMAN RENTALS LLC,2,1,1
4769,5038937501,SI,1215 FATHER CAPODANNO BL,02,R3,NAME NOT ON FILE,100,99,1
4770,5040370067,SI,143 TITUS AVENUE,01,A5,"KRASNER, , MARIYA",2,1,1
4771,5040860010,SI,152 MARINE WAY,01,A1,CAMERADA DOMENICK,2,1,1
4772,5040920001,SI,173 CEDAR GROVE AVENUE,01,A1,"CARVALHO, EDWARD",2,1,1
4773,5041300647,SI,872 TYSENS LANE,01,A9,THIRUVALLA BABY,2,1,1
4774,5044260004,SI,155 CENTER STREET,01,A0,"TALIERCIO, STEPHEN",2,1,1
4775,5046020067,SI,115 BARLOW AVENUE,01,A1,"RAKHMINOV, DAVID",2,1,1
4776,5051190066,SI,9 HIGHLAND ROAD,01,B2,CIMAGLIA ANTHONY M,2,1,1
4777,5051400017,SI,34 OCEAN ROAD,01,A1,A APPEL,2,1,1
4778,5052030054,SI,149 WHITMAN AVENUE,01,B2,MANSION AVENUE LLC,2,1,1
4779,5054390081,SI,312 DEWEY AVENUE,01,A2,JODI LYNN RUPELLI,2,1,1
4780,5065290050,SI,40 YEOMALT AVENUE,01,A1,GEORGE F FINGER,2,1,1
4781,5066650121,SI,474 HOLTEN AVENUE,01,A3,CAPANI MEMET,2,1,1
4782,5066680008,SI,433 SEGUINE AVENUE,01,B2,"GEISER, FRANK",2,1,1
4783,5069300060,SI,950 SINCLAIR AVENUE,01,A1,"COCHRAN, COLLEEN",2,1,1
4784,5070910582,SI,1562 WOODROW ROAD,01,B9,"GIORDANO, CARL J JR",2,1,1
4785,5071050503,SI,2810 ARTHUR KILL ROAD,07,G2,LAKSODY JOHN,2,1,1
4786,5073130042,SI,99 NIELSEN AVENUE,01,A2,NYS DIV OF LANDS AND FORESTS,2,1,1
4787,5074950007,SI,9 PLEASANT PLAINS AVE,01,A1,"LAWLER, WALTER JR",2,1,1
4788,5077930175,SI,117 BEDELL AVENUE,01,B2,KENNETH R MCINTYRE,3,2,1
4789,5078600226,SI,355 LORETTO STREET,01,A5,"FESTA, JOESPH",2,1,1
4790,5078860030,SI,512 YETMAN AVENUE,01,A1,GERARD MIGLIONICO REVOCABLE TRUST,2,1,1
4791,5079950075,SI,135 ELLIS STREET,,Z9,GARPO MARINE SERVICES,9,8,1
4792,5080030042,SI,62 MAIN STREET,01,B3,FREDERICK SCHAMING,2,1,1
4793,5080340013,SI,7085 AMBOY ROAD,01,B3,MARY TRIANO,2,1,1
4794,5080420048,SI,213 FISHER AVENUE,01,B2,CHARLES BONELLI,2,1,1
4795,1000730008,MN,PIER-16 SOUTH STREET,07,T2,NYC DEPARTMENT OF SMALL BUSINESS SERVICES,4,3,1
4796,1003490033,MN,156 RIVINGTON STREET,11,V1,"ABC NO RIO, INC.",2,1,1
4797,1006130062,MN,173 7 AVENUE SOUTH,05,K2,"173 7TH AVE SO., LLC",2,1,1
4798,1007370036,MN,533 9 AVENUE,04,S3,"GONZALEZ, BLANCA",2,1,1
4799,1011410048,MN,142 WEST 70 STREET,02,C5,140-142 WEST SEVENTIETH STREET,3,2,1
4800,1012370029,MN,600 AMSTERDAM AVENUE,03,D4,201 W 89 ST OWNRS INC,2,1,1
4801,1013890065,MN,4 EAST 75 STREET,01,A4,SUGAR SHACK LLC,2,1,1
4802,1014500039,MN,348 EAST 76 STREET,02,C5,LOZYNSKYJ ASKOLD S,3,2,1
4803,1015300026,MN,1629 2 AVENUE,04,S5,1629 SECOND AVENUE LLC,2,1,1
4804,1018400064,MN,82 WEST 105 STREET,04,C7,"82 WEST 105TH STREET, LLC",2,1,1
4805,1019540011,MN,400 WEST 128 STREET,02,C4,ARYEH FAMILY HOLDINGS LLC,2,1,1
4806,1020130050,MN,150 WEST 145 STREET,07,G4,150 WEST 145 LLC,2,1,1
4807,1020700012,MN,35 HAMILTON PLACE,04,D7,35 LLC,2,1,1
4808,1022150827,MN,409 WEST 219 STREET,08,W1,CEE GEE INWOOD LLC,3,2,1
4809,2027520009,BX,1144 HOE AVENUE,08,W2,R C CH ST JOHN CHRYSO,2,1,1
4810,2027620294,BX,845 EDGEWATER ROAD,06,E1,EDGEWATER REALTY LLC,2,1,1
4811,2028020033,BX,258 MT HOPE PLACE,01,A1,"MALDONADO, JOSE",2,1,1
4812,2029390023,BX,1525 BOSTON ROAD,04,S1,ROSARIO CARLOS,3,2,1
4813,2029700052,BX,1370 LYMAN PLACE,01,B2,DON L.W. HOUSING DEVELOPMENT FUND CORPOR ATION,2,1,1
4814,2031020065,BX,737 EAST 183 STREET,01,B1,WILLIAMS PROSPECT CORP,2,1,1
4815,2032630128,BX,3811 ORLOFF AVENUE,01,B2,SIDER SANDRA,2,1,1
4816,2034290041,BX,313 HARDING PARK,01,A2,"AYALA, EVELYN",2,1,1
4817,2035100025,BX,470 HOWE AVENUE,01,B1,"ROUSE-BEY, SHIRLEY",2,1,1
4818,2037650006,BX,1829 GLEASON AVENUE,01,B1,HAQUE MOHAMMED S,2,1,1
4819,2037710061,BX,1237 WHEELER AVENUE,02,C0,JEANNETH P PERSAUD IRREVOCABLE TRUST,2,1,1
4820,2037730050,BX,1255 BOYNTON AVENUE,01,B1,JOSE D GINER,2,1,1
4821,2038770063,BX,1321 TAYLOR AVENUE,02,C0,"DAS, BIDHAN C",2,1,1
4822,2039000069,BX,1831 WOOD AVENUE,04,S2,"KELIAN, MARY",2,1,1
4823,2039140005,BX,1468 ROSEDALE AVENUE,01,B3,"BOODHOO, JOEL H",2,1,1
4824,2039160022,BX,1495 BEACH AVENUE,02,C0,DEUTSCHE BANK NATIONAL TRUST COMPANY,2,1,1
4825,2039960013,BX,2422 FULLER STREET,02,C0,"GALARZA, YVETTE",2,1,1
4826,2039970023,BX,2430 LYVERE STREET,02,C1,RED SEA REALTY LLC,2,1,1
4827,2040200038,BX,1714 MELVILLE STREET,02,C0,SYLVESTER OGUGUO,2,1,1
4828,2040260002,BX,606 MEAD STREET,02,C0,"PLLUMBI, DAVID",2,1,1
4829,2040520041,BX,1871 WALLACE AVENUE,01,B2,DALILA CAY,2,1,1
4830,2040520056,BX,1833 WALLACE AVENUE,01,B2,"MARTINEZ, JENNIFER ANGELA",2,1,1
4831,2040530037,BX,776 RHINELANDER AVENUE,01,A5,FRANK J BOMMARITO,2,1,1
4832,2042660010,BX,1922 BOGART AVENUE,01,B2,NETTIE ZULLO IRREVOCABLE TRUST,2,1,1
4833,2043140022,BX,1208 PELHAM PARKWAY SOUTH,01,B1,"AHRC NYC NEW PROJECTS,IN",2,1,1
4834,2043300031,BX,2115 HAIGHT AVENUE,01,A1,"VAN TRAN, TRONG",2,1,1
4835,2044720016,BX,2424 SEYMOUR AVENUE,01,B3,"UJFALVI, JOSEPH A",2,1,1
4836,2044760078,BX,2515 FENTON AVENUE,01,A2,"PEREZ, ANDRE",2,1,1
4837,2044820028,BX,2544 WOODHULL AVENUE,01,A5,"RIVERA, SONIA",2,1,1
4838,2046100009,BX,975 BURKE AVENUE,08,M9,HOLINESS CHRISTIAN CHURCH OF THE BR,2,1,1
4839,2047440025,BX,3315 MICKLE AVENUE,01,A5,"ANDERSON, ANGELLA",2,1,1
4840,2048380023,BX,751 EAST 224 STREET,02,C1,JOE ROD CORP,2,1,1
4841,2048610038,BX,921 EAST 225 STREET,02,C0,"MOSS, JANICE",2,1,1
4842,2049630092,BX,2232 STRANG AVENUE,01,B1,"BELLO, JEMILIA",2,1,1
4843,2050040024,BX,4131 GUNTHER AVENUE,01,B1,"PINOTT, VICTOR",2,1,1
4844,2050210016,BX,4136 DE REIMER AVENUE,01,B1,RUBEN H AUGUSTA,2,1,1
4845,2050510023,BX,4334 GUNTHER AVENUE,01,A1,RACH 26 LLC,2,1,1
4846,2050830041,BX,4639 WHITE PLAINS ROAD,04,C7,4639 WHITE PLAINS ROAD REALTY CORP.,3,2,1
4847,2053060031,BX,3394 EAST TREMONT AVENUE,05,O2,JONMARK REALTY GROUP LLC,2,1,1
4848,2053830014,BX,2816 WELLMAN AVENUE,01,A1,ROBERT J AULETTA,2,1,1
4849,2053890042,BX,2871 ROEBLING AVENUE,02,C0,"LY, HENG KON",2,1,1
4850,2054150095,BX,1521 LIBRARY AVENUE,01,A5,J A CONCEPCION,2,1,1
4851,2054360053,BX,641 LOGAN AVENUE,01,B1,"CASTRO, DENISE",3,2,1
4852,2056290230,BX,273 CITY ISLAND AVENUE,04,S1,RISING TIDE REVIVAL LLC,2,1,1
4853,3003410015,BK,76 UNION STREET,02,C0,BURRY ANTHONY,2,1,1
4854,3005310032,BK,82 PIONEER STREET,01,B9,"DUNN, KELLY V",2,1,1
4855,3006380078,BK,668 3 AVENUE,07,G3,"SKJM MANAGEMENT, LLC",2,1,1
4856,3006760023,BK,142 31 STREET,01,B9,THOMAS A LOMBARDI,2,1,1
4857,3007230064,BK,329 43 STREET,01,B9,"NG, DARSHY",2,1,1
4858,3007600067,BK,831 47 STREET,01,B1,"SIMONOVITZ, OSSNATH",2,1,1
4859,3008730033,BK,288 17 STREET,01,B1,DESAPIO BEATRICE,2,1,1
4860,3010630007,BK,77 7 AVENUE,04,C7,SUPER ACE CORP,2,1,1
4861,3011740049,BK,495 ST JOHNS PLACE,03,D1,495 ST JOHNS LLC,2,1,1
4862,3012760064,BK,1223 PRESIDENT STREET,01,B1,"LABKOWSKI, YITSHAK Z",2,1,1
4863,3012910054,BK,403 CROWN STREET,01,B3,"BEREN , MIRIAM",2,1,1
4864,3013690033,BK,1614 PROSPECT PLACE,02,C3,1614 PROSPECT LLC,2,1,1
4865,3016860040,BK,340 MALCOLM X BOULEVARD,08,M1,KING EMMANUEL MISSIONARY BAPTIST CHURCH  INC,2,1,1
4866,3017680063,BK,175 HART STREET,08,M1,MT ZION PENTOCOSTAL,2,1,1
4867,3017760038,BK,206 PULASKI STREET,01,B1,"HEERWAGEN, WILLIAM",3,2,1
4868,3018910019,BK,97 HALL STREET,02,C0,"DEWEES, CHRISTOPHERR",2,1,1
4869,3019420052,BK,469 LAFAYETTE AVENUE,04,S4,"NOVE, SHALOM",2,1,1
4870,3025230031,BK,321 MCGUINNESS BOULEVARD,07,G4,MABA LLC,2,1,1
4871,3025950008,BK,188 GUERNSEY STREET,02,C2,"NGUYEN, UYVU DUC",2,1,1
4872,3026520041,BK,86A DIAMOND STREET,01,B9,"GAROCKI, MIROSLAW",2,1,1
4873,3027000020,BK,189 DRIGGS AVENUE,08,M1,ST STANISLAUS KOSTKA,3,2,1
4874,3031960048,BK,1061 WILLOUGHBY AVENUE,01,B9,ROBERT BYSZNSKI,2,1,1
4875,3034680028,BK,1534 BUSHWICK AVENUE,07,G4,BILL WOLF PETROLEUM CORP,2,1,1
4876,3034870068,BK,60 SUNNYSIDE AVENUE,01,A5,"MALLETTE, TIMOTHY M",2,1,1
4877,3035560008,BK,247 HERZL STREET,01,B1,"FULTON, SHEREE",2,1,1
4878,3036380019,BK,655 OSBORN STREET,01,B1,PETER FELIX,2,1,1
4879,3036740013,BK,89 BRADFORD STREET,01,B3,89 BRADFORD ST INC,2,1,1
4880,3038090044,BK,528 BRADFORD STREET,01,B1,"PRIMUS, LYDIA",2,1,1
4881,3038400024,BK,579 PENNSYLVANIA AVENUE,01,B1,"WILLIAMS, FORREST",2,1,1
4882,3039550025,BK,3002 FULTON STREET,04,S4,244 LINWOOD ONE LLC,3,2,1
4883,3039720054,BK,753 LIBERTY AVENUE,04,S3,PONCE VICTOR,2,1,1
4884,3039870001,BK,407 LINWOOD STREET,02,C0,"GUZMAN, YONAIRA",2,1,1
4885,3040140037,BK,389 JEROME STREET,01,B2,"CORNERSTONE RESIDENCE, LLC",2,1,1
4886,3040700035,BK,364 ATKINS AVENUE,01,B1,"MOHAMMED, NUR",2,1,1
4887,3041040052,BK,52 EUCLID AVENUE,01,B1,VERA CESAR,2,1,1
4888,3041940017,BK,442 CONDUIT BOULEVARD,06,E1,IRWIN KANDEL REALTY CORP.,2,1,1
4889,3042260017,BK,541 DREW STREET,01,B2,"CHINAPEN , TREVOR",2,1,1
4890,3042670036,BK,622 CRESCENT STREET,01,B2,"SEBAK, ROY",2,1,1
4891,3042690007,BK,679 HEMLOCK STREET,02,C0,"HOSSAIN, MOHAMMED",2,1,1
4892,3042750050,BK,698 DREW STREET,01,B2,HIGHWAY INN REALTY LLC,2,1,1
4893,3042900006,BK,443 FORBELL STREET,01,B2,"ARCHIBALD, DEIDRE",2,1,1
4894,3043050074,BK,657 VAN SICLEN AVENUE,08,M9,"HOPE CHRISTIAN CENTER, INC.",2,1,1
4895,3046060081,BK,37 EAST 52 STREET,01,B1,"DENNIS-CARDOZA , DEASREAN  G",2,1,1
4896,3046110056,BK,159 EAST 92 STREET,01,B1,"LEIGERTWOOD, CECILE",2,1,1
4897,3046510133,BK,310 ROCKAWAY PARKWAY,02,C3,"FRANCIS, ROY",2,1,1
4898,3047120004,BK,9117 AVENUE A,01,A5,"SMITH, PAULINE D",2,1,1
4899,3049730076,BK,665 EAST 39 STREET,01,B2,"SWIRIN-YAO, DOLORES",2,1,1
4900,3049790014,BK,812 EAST 46 STREET,01,A9,"SAM, PRINCE",2,1,1
4901,3050000004,BK,3615 FARRAGUT ROAD,01,A1,"ETSEYATSE, HENRY A",2,1,1
4902,3050100059,BK,1540 BROOKLYN AVENUE,01,B3,"BARGISEN, CLAIRE",2,1,1
4903,3050150063,BK,1542 ALBANY AVENUE,01,A9,STRAKER LIVINGSTON,2,1,1
4904,3050280070,BK,71 MAPLE STREET,01,A3,HAYWOODE M DOUGLAS,3,2,1
4905,3051290040,BK,937 ROGERS AVENUE,03,D3,ROGERS REALTY HOLDINGS LLC,2,1,1
4906,3051410014,BK,210 STRATFORD ROAD,01,B2,"IANNUCCI, MICHAEL",2,1,1
4907,3051680002,BK,2404 BEVERLEY ROAD,01,B1,"HASHEM, MOHAMMED A",2,1,1
4908,3052600009,BK,6 TERRACE PLACE,02,C0,"CAPUTO, AMELIA",2,1,1
4909,3052730046,BK,405 GREENWOOD AVENUE,01,A9,"CARRANO, PATRICK",2,1,1
4910,3053070036,BK,3347 12 AVENUE,02,C0,"FLORES, JOHN A",2,1,1
4911,3053530086,BK,489 MCDONALD AVENUE,04,S2,PUGLIESE DOMINICK,2,1,1
4912,3054160018,BK,4205 18 AVENUE,04,S2,LEONID FUKS,2,1,1
4913,3054160103,BK,155 WEBSTER AVENUE,02,C0,"ISRAEL ROTTENSTEIN, AS TRUSTEE",2,1,1
4914,3054370071,BK,1645 47 STREET,01,B1,ANDREA MAYER,2,1,1
4915,3054490027,BK,1738 48 STREET,01,A3,AARON STAHL,2,1,1
4916,3054807501,BK,1884 53 STREET,02,R3,UNAVAILABLE OWNER,2,1,1
4917,3055020033,BK,1564 58 STREET,01,B1,"SALAMON, JACOB",2,1,1
4918,3055110024,BK,1746 59 STREET,01,A1,CHANY STERN,2,1,1
4919,3055490005,BK,6409 20 AVENUE,04,K4,"20TH AVE PARTNERS,LLC",2,1,1
4920,3055840037,BK,3908 FT HAMILTON PARKWAY,04,S2,BAR-NAN REALTY CORP.,2,1,1
4921,3056010055,BK,947 44 STREET,01,B1,"POLL, CHAIM",2,1,1
4922,3056120012,BK,1418 44 STREET,02,C3,YOSEF WEISS-TRUSTEE,2,1,1
4923,3056240066,BK,1429 47 STREET,08,M9,ABC 47 REALTY LLC,2,1,1
4924,3056730053,BK,5420 FT HAMILTON PARKWAY,04,S1,BROTHER LIU INC,2,1,1
4925,3057030026,BK,1162 58 STREET,01,A1,KASSIRER CHANY,2,1,1
4926,3057520031,BK,1160 65 STREET,02,C0,"XIE, SHAO FENG",2,1,1
4927,3059470040,BK,7604 COLONIAL ROAD,01,A5,"JOERSS, ERIK",2,1,1
4928,3059550029,BK,1054 76 STREET,01,A5,JOHN MODAFFERI,2,1,1
4929,3059830057,BK,7924 10 AVENUE,01,A9,"CHEUNG, KIN CHIU",2,1,1
4930,3059840005,BK,7909 10 AVENUE,01,A9,"MCCORMICK, TRACY",2,1,1
4931,3059870013,BK,214 80 STREET,01,A1,"MAROPAKIS, GEORGE",2,1,1
4932,3059880054,BK,367 81 STREET,01,A5,"EPSTEIN, JOHN G",3,2,1
4933,3060310011,BK,40 85 STREET,01,B1,"DOLEH, MARWAN",2,1,1
4934,3060470017,BK,136 87 STREET,01,B2,ANTOUN HECHME,2,1,1
4935,3060640049,BK,337 90 STREET,01,B3,"337 90TH STREET REALTY, LLC",2,1,1
4936,3060730017,BK,8818 7 AVENUE,01,A5,"WONG, DAVID W",2,1,1
4937,3062050033,BK,1854 73 STREET,01,B3,NICOLA INFANTE,2,1,1
4938,3062460033,BK,1572 77 STREET,01,B1,"LAFERLITA, GENE",2,1,1
4939,3062910067,BK,1221 82 STREET,01,A3,"BASILE, MARIA",2,1,1
4940,3063620074,BK,8672 16 AVENUE,01,B1,BI MAN LIU,2,1,1
4941,3064000042,BK,8742 BAY 16 STREET,02,C0,BAY 16 ACQUISITION LLC,2,1,1
4942,3064490021,BK,199 BAY 31 STREET,02,C0,ANTHONY LEE,2,1,1
4943,3065100060,BK,975 EAST 7 STREET,01,B2,"GOLDBERGER, RIVKIE",2,1,1
4944,3065170059,BK,1079 EAST 4 STREET,01,A1,"COHEN, RAYMOND A",2,1,1
4945,3065310012,BK,1362 CONEY ISLAND AVENUE,04,S2,1362 CONEY ISLAND LLC,2,1,1
4946,3065320024,BK,1228 EAST 7 STREET,01,B1,"LEFKOWITZ, JOEL",2,1,1
4947,3065480071,BK,2213 60 STREET,02,C0,"BAGDASAROVA, MARINA",2,1,1
4948,3065660006,BK,314 AVENUE M,01,B2,"RUAN, BOSON",2,1,1
4949,3066170060,BK,1579 EAST 10 STREET,01,B2,"CABASSO, BRENDA",2,1,1
4950,3066290018,BK,1628 WEST 2 STREET,01,B1,LEONID SHEGELMAN,2,1,1
4951,3066620020,BK,1730 OCEAN PARKWAY,01,B2,RALPH SETYON AS TRUSTEE OF SETYON FAMILY  TRUST,2,1,1
4952,3066620022,BK,1732 OCEAN PARKWAY,01,B2,1732 OCEAN PARKWAY LLC,2,1,1
4953,3066960048,BK,1211 AVENUE I,02,C0,"REHMAN, SHAFIQ U",2,1,1
4954,3067110027,BK,975 EAST 18 STREET,01,A1,"GREENBERG, YAAKOV S",2,1,1
4955,3067220014,BK,1120 EAST 12 STREET,01,A5,DAVID ROSENBAUM,2,1,1
4956,3067230034,BK,1164 EAST 13 STREET,01,A9,ROMEO JOHN C,2,1,1
4957,3067840012,BK,1672 EAST 22 STREET,03,D1,1672 REALTY LLC,2,1,1
4958,3067920062,BK,1633 EAST 29 STREET,01,A1,"ROZ, RONNIE S",2,1,1
4959,3068030013,BK,1816 EAST 21 STREET,01,B3,ABOKSIS DAVID,2,1,1
4960,3068080004,BK,2512 QUENTIN ROAD,01,A1,"LAINEZ, JANET",2,1,1
4961,3068410001,BK,3004 AVENUE R,02,C9,NYSANDY11 MARINE PARK LLC,48,47,1
4962,3071080058,BK,2137 EAST 5 STREET,01,B2,"KASSIN, ISAAC",2,1,1
4963,3071310035,BK,2242 EAST 5 STREET,01,A5,BELA LEVY,2,1,1
4964,3071320011,BK,2108 OCEAN PARKWAY,08,M1,LERYNA FOUNDATION C/O,2,1,1
4965,3071750048,BK,2367 WEST 1 STREET,01,B3,2367 WEST 1ST STREET LLC,2,1,1
4966,3071750054,BK,2357 WEST 1 STREET,02,C3,"DERBY, ROSEMARIE",2,1,1
4967,3073030021,BK,4032 BEDFORD AVENUE,01,A1,"BAUM, ARI",2,1,1
4968,3073490057,BK,2151 EAST 16 STREET,01,A1,"ALMAGHRABI, JACK",2,1,1
4969,3073540056,BK,2225 EAST 21 STREET,01,B2,"SALMAN, ORTAL",2,1,1
4970,3074290036,BK,2472 KNAPP STREET,07,G4,"KNAPP ST SERVICE ENT,INC.",2,1,1
4971,3075740001,BK,2823 AVENUE I,02,C0,"CYWIAK, BARUCH",2,1,1
4972,3075830016,BK,1083 EAST 37 STREET,01,A9,FLORENCIA G SMALL,2,1,1
4973,3075850013,BK,1107 EAST 21 STREET,01,A1,GELB ABRAHAM,2,1,1
4974,3076390001,BK,1350 EAST 22 STREET,01,A1,"SCHON-EISENSTADT, DESIREE",2,1,1
4975,3076470028,BK,1243 EAST 29 STREET,01,A1,DOV MANDEL,2,1,1
4976,3076740071,BK,1564 EAST 21 STREET,01,A1,MOSHE MASLATON,2,1,1
4977,3076780090,BK,3600 BEDFORD AVENUE,01,A1,"GUTMAN, ARTHUR",2,1,1
4978,3077110022,BK,1737 BURNETT STREET,01,A1,"ZAGELBAUM, YOEL",2,1,1
4979,3077490074,BK,4597 KINGS HIGHWAY,01,A5,ALAN K BETTS,3,2,1
4980,3078630001,BK,3923 QUENTIN ROAD,01,A9,"FLORES, LETICIA",2,1,1
4981,3078970040,BK,1618 EAST 53 STREET,01,B1,CHARLAYNE WILLIAMS,2,1,1
4982,3082030074,BK,1210 EAST 96 STREET,08,I7,"FSNR ACQUISITION GROUP, LLC",2,1,1
4983,3082040013,BK,1209 EAST 96 STREET,01,B1,"SIMEON, CHRISSY JEAN",3,2,1
4984,3082380057,BK,1374 EAST 93 STREET,01,A9,"MANSWELL, TRACY",2,1,1
4985,3082620011,BK,1829 ROCKAWAY PARKWAY,01,B2,"WRIGHT, OLIVE BENNET",2,1,1
4986,3082620048,BK,1400 EAST 98 STREET,01,B2,EVENS ALCINDOR,2,1,1
4987,3083850067,BK,1440 EAST 64 STREET,01,A9,"GUGLIELMINO, VINCENT",2,1,1
4988,3084410011,BK,2269 EAST 72 STREET,01,B2,"HENNESSY, JAMES F",2,1,1
4989,3085400030,BK,2123 KIMBALL STREET,01,A1,"JIN, DAWEI",3,2,1
4990,3087490270,BK,166 GIRARD STREET,01,A1,DUNSKY JACOB,2,1,1
4991,4000310019,QN,5-21 49 AVENUE,02,C0,"BOTHNER-BY, PETER O",2,1,1
4992,4001700058,QN,45-07 48 AVENUE,11,V1,PLAZA 48 LLC,2,1,1
4993,4002090032,QN,50-09 39 PLACE,01,A1,MILTON MORENO,2,1,1
4994,4003970001,QN,39-39 27 STREET,01,B2,"SCHETTINO, ANTHONY",2,1,1
4995,4004160010,QN,27-01 QUEENS PLAZA NORTH,05,O3,BRAUSE PLAZA NORTH LLC,2,1,1
4996,4005350010,QN,14-25 30 DRIVE,02,C0,"REITZ, JUDITH E",2,1,1
4997,4005660015,QN,23-23 33 AVENUE,02,C0,"SAMANT, RAGHUNANDAN",2,1,1
4998,4005797502,QN,25-10 31 AVENUE,03,R4,ASTI CONDO,2,1,1
4999,4005870027,QN,32-25 30 STREET,01,B2,BERTA SERAFIN,2,1,1
5000,4006130061,QN,31-52 32 STREET,01,B3,"STEVENS, LAUREN",2,1,1
5001,4007730056,QN,20-62 46 STREET,01,B1,"MANGONE, ELIO",2,1,1
5002,4008360025,QN,33-18 24 AVENUE,01,B3,"TSIROGIANNIS, CHRISTOS",2,1,1
5003,4010450027,QN,24-44 82 STREET,01,B1,"ASTUDILLO, ROMULO",2,1,1
5004,4011010023,QN,24-23 89 STREET,01,A2,2423 89TH STREET LLC,2,1,1
5005,4011550013,QN,32-16 54 STREET,01,B1,"TENG, FEI",2,1,1
5006,4012120029,QN,37-36 58 STREET,02,C0,"ZHOU, XIN HUI",2,1,1
5007,4012180014,QN,37-65 63 STREET,01,B1,"BEGUM, RESMA",2,1,1
5008,4013350024,QN,40-25 60 STREET,02,C3,"ZONZINI, ANTOINETTE",2,1,1
5009,4013660051,QN,26-24 93 STREET,01,B2,"OCHOA , MILTON",2,1,1
5010,4013920055,QN,30-07 94 STREET,01,B3,HOBI NYC MANAGEMENT INC.,2,1,1
5011,4014720068,QN,37-11 84 STREET,02,C6,92 96 27TH ST,2,1,1
5012,4014810037,QN,37-48 94 STREET,01,B2,CORDERO GLORIA,2,1,1
5013,4014950028,QN,41-01 75 STREET,08,M1,UNITED SHERPA ASSOCIATION (U.S.A.) INC.,2,1,1
5014,4015050022,QN,40-28 HAMPTON STREET,01,A1,"PHAN-ZHENG, JEN TRINH",2,1,1
5015,4015390001,QN,80-23 QUEENS BOULEVARD,05,K5,"MCDONALD'S USA, LLC",2,1,1
5016,4015670009,QN,90-18 WHITNEY AVENUE,02,C0,"CHUN CHEUK LAM, TRUSTEE",2,1,1
5017,4015690053,QN,42-89 HAMPTON STREET,02,C0,"SARMIENTO, GERARDO",3,2,1
5018,4015760042,QN,93-05 43 AVENUE,01,A1,"SHI, AI JIAO",2,1,1
5019,4015960035,QN,40-56 JUNCTION BOULEVARD,04,S9,40-56 JUNCTION BOULEVARD LLC,2,1,1
5020,4016230112,QN,45-14 97 STREET,02,C0,GUSTAVO AGUDO,2,1,1
5021,4017130051,QN,33-33 98 STREET,01,B2,3333 98 GROUP CORP,2,1,1
5022,4017677501,QN,100-23 39 AVENUE,02,R1,UNAVAILABLE OWNER,2,1,1
5023,4017830014,QN,111-18 38 AVENUE,02,C0,"DIAZ, SANTA",2,1,1
5024,4020010044,QN,109-39 46 AVENUE,01,B1,"MIAO, JIM YUZHENG",2,1,1
5025,4022247502,QN,108-20 71 AVENUE,04,RM,UNAVAILABLE OWNER,2,1,1
5026,4023060226,QN,51-57 48 STREET,01,B1,"DAHAL, BISHNU P",2,1,1
5027,4023940023,QN,6638A CLINTON AVENUE,06,E1,STIVANELLO ROBERT,2,1,1
5028,4024910008,QN,53-35 73 STREET,01,B2,MASINA MARIJO,2,1,1
5029,4026360041,QN,60-17 54 PLACE,02,C0,"TAN, JI BAIN MICHAEL",2,1,1
5030,4027240072,QN,66-11 GRAND AVENUE,04,S9,"SPANOS, VICKY",2,1,1
5031,4027380038,QN,58-36 61 STREET,01,A5,"JUELE, GEOFFREY",2,1,1
5032,4027510062,QN,57-62 65 STREET,01,A5,FERREIRAS EDITH,2,1,1
5033,4027620039,QN,62-66 60 DRIVE,01,A5,MULLIGAN KATHLEEN M,2,1,1
5034,4028090080,QN,57-51 MAZEAU STREET,01,B3,"FITZPATRICK, VINCENT",2,1,1
5035,4028310017,QN,59-24 69 LANE,01,A5,GEORGE KALOGIANNIS,2,1,1
5036,4028650038,QN,86-31 54 AVENUE,01,A1,VALERIANO A CALMA,2,1,1
5037,4029050159,QN,83-11 57 AVENUE,01,B3,"HU, YING YI",2,1,1
5038,4030300092,QN,64-04 PLEASANTVIEW STREET,01,A5,"DOLEGA, ARTHUR",2,1,1
5039,4030400023,QN,65-58 79 STREET,01,B2,"BORST, ERICA",2,1,1
5040,4034270054,QN,18-13 HIMROD STREET,01,B1,"MORENO, ANGEL",2,1,1
5041,4035700020,QN,58-22 78 AVENUE,02,C0,"PICON, ROMULO W",2,1,1
5042,4036080083,QN,64-58 ADMIRAL AVENUE,01,B2,DANIEL SMITH,2,1,1
5043,4036080096,QN,65-24 ADMIRAL AVENUE,01,B2,"TOMCZYK, BEATA",2,1,1
5044,4038260003,QN,78-07 76 STREET,01,A9,JULIA MATISHEK,2,1,1
5045,4038260007,QN,78-04 78 STREET,01,B3,COHEN MITCHEL S,2,1,1
5046,4041710027,QN,20-16 127 STREET,11,V0,WAI MING YOUNG,2,1,1
5047,4043150047,QN,28-34 29 AVENUE,01,A2,"COLARUSSO, RITA",2,1,1
5048,4044100007,QN,31-39 137 STREET,11,V0,AMERICAN HK DEVELOPMENT INC.,2,1,1
5049,4044110001,QN,31-65 138 STREET,03,D4,"LINDEN TOWERS COOPERATIVE #6, INC.",4,3,1
5050,4044570026,QN,145-54 8 AVENUE,01,A1,ROCCO DICORATO,3,2,1
5051,4044590062,QN,107-27 11 AVENUE,02,C6,MALBA GARDENS OWNERS CORP,6,5,1
5052,4044670039,QN,2-53 148 STREET,01,A2,DIBENEDETTO LUCIANO,2,1,1
5053,4044820007,QN,147-16 12 AVENUE,01,A1,"BETANCES, MARIA",2,1,1
5054,4045100010,QN,150-24 6 AVENUE,01,A1,THE JANJUA TRUST NO. 1,2,1,1
5055,4045390088,QN,152-33 11 AVENUE,01,A5,"POLESOVSKY, CHRISTOPHER M",2,1,1
5056,4045490009,QN,154-47 13 AVENUE,01,A1,FLUSHING CHEN LLC,2,1,1
5057,4045560019,QN,157-31 11 AVENUE,01,A1,"SAVVIDES, HARRY",2,1,1
5058,4045680072,QN,14-77 157 STREET,01,A1,"JENG, YUN SHENG",2,1,1
5059,4046580036,QN,147-41 24 AVENUE,01,A5,"NG, HOI MON",2,1,1
5060,4047220018,QN,15-65 CLINTONVILLE STREET,11,V0,VALENZA 2012 REAL PROPERTY TRUST,2,1,1
5061,4047880038,QN,145-28 BAYSIDE AVENUE,08,M1,FIRST CHURCH OF CHRIST SCIENTIST FLUSHIN G/NY,2,1,1
5062,4049000015,QN,163-20 25 AVENUE,01,A0,"KAYKATY, VICTOR",2,1,1
5063,4049840017,QN,145-26 33 AVENUE,01,B3,SONG FAMILY DEVELOPMENT LLC,2,1,1
5064,4050190108,QN,136-21 41 AVENUE,05,O5,136-21 41ST AVENUE REALTY LLC,2,1,1
5065,4050290027,QN,40-12 149 PLACE,01,A1,TASHKENT RAHMET,2,1,1
5066,4050530038,QN,147-26 BARCLAY AVENUE,04,D7,"LAM, HAK TUNG",2,1,1
5067,4052830081,QN,35-58 164 STREET,02,C1,"ROMANO, FRANCO",2,1,1
5068,4053150017,QN,36-05 193 STREET,02,C0,WEI CHIANG,2,1,1
5069,4053340017,QN,41-02 162 STREET,05,K1,41-02 162ND LLC,2,1,1
5070,4054170032,QN,159-06 43 AVENUE,01,B2,"HUANG, KENNY X",2,1,1
5071,4054190045,QN,43-28 162 STREET,02,C0,"CHEN, KONG MIN",2,1,1
5072,4054530034,QN,46-38 156 STREET,01,B1,"SIAVICHAY, VICENTE",2,1,1
5073,4055680058,QN,49-46 166 STREET,01,A1,166 REAL ESTATE LLC,2,1,1
5074,4055700001,QN,164-05 UNDERHILL AVENUE,01,A1,ADEM HOT,2,1,1
5075,4056010055,QN,46-22 189 STREET,01,A1,KENNETH BASILE,2,1,1
5076,4060130035,QN,28-28 BELL BOULEVARD,01,A2,"VASCONEZ, SORAYA",2,1,1
5077,4060260001,QN,199-02 32 AVENUE,04,C7,MARBAY REALTY LTD,2,1,1
5078,4061090005,QN,211-10 33 ROAD,01,A0,"CHEN, GUIPING",2,1,1
5079,4062840036,QN,42-22 BELL BOULEVARD,04,K4,CORONA GROUP LLC,3,2,1
5080,4069890016,QN,75-07 170 STREET,01,A1,DAVID FLUG,2,1,1
5081,4072330029,QN,81-23 UTOPIA PARKWAY,01,A1,"COHEN, EMANUEL",2,1,1
5082,4072350021,QN,179-14 80 DRIVE,01,A1,ARABOV ABRAHAM,2,1,1
5083,4073470020,QN,47-48 215 PLACE,02,C6,ROCKY HILL TENANTS CORP,3,2,1
5084,4074530005,QN,202-14 58 AVENUE,01,A2,YUNG YAN,2,1,1
5085,4077660038,QN,79-43 209 STREET,01,A1,"KE, PENG",3,2,1
5086,4077750056,QN,218-51 HARTLAND AVENUE,01,A2,"TAASA, RAFAEL",2,1,1
5087,4079880034,QN,89-16 241 STREET,01,B3,"HAGEMANN , PATRICIA",2,1,1
5088,4080370076,QN,311 MANOR ROAD,01,A1,CLAUDIA BOTERO GOTZ,2,1,1
5089,4080820285,QN,40-00 235 STREET,08,W1,NYC DEPARTMENT OF EDUCATION,2,1,1
5090,4082330108,QN,250-18 RUSHMORE TERRACE,01,A1,"IAVARONE, MICHELE",2,1,1
5091,4087040127,QN,79-15 267 STREET,01,A0,THOMAS MC MAHON,2,1,1
5092,4089450065,QN,93-07 75 STREET,01,A9,"SIERRA, NOEMI",2,1,1
5093,4089800041,QN,91-47 86 STREET,01,B2,"LIN, ANTHONY",2,1,1
5094,4092030050,QN,86-73 107 STREET,01,B2,ARJUNE  JANKEY,2,1,1
5095,4092410176,QN,122-25 METROPOLITAN AVENUE,01,B3,"HERMAN, DAVID",2,1,1
5096,4092750064,QN,121-07 JAMAICA AVENUE,04,S3,"121-07 JAMAICA, LLC",2,1,1
5097,4093480043,QN,91-43 116 STREET,02,C3,"HARILALL, VISHNU",2,1,1
5098,4093540045,QN,89-25 127 STREET,01,A1,SUNRISE PLAZA HOMES V LLC,2,1,1
5099,4094280031,QN,101-50 111 STREET,01,B3,"PHAGORA, JAGDISH SINGH",2,1,1
5100,4094460026,QN,130-14 ATLANTIC AVENUE,02,C0,"SHIWNARAIN, LAKHMATTIE",2,1,1
5101,4094690022,QN,126-19 101 AVENUE,04,S2,"MC NAMEE, JAMES G.",2,1,1
5102,4095610041,QN,103-19 124 STREET,01,B3,"GANGA, ANDREW H",2,1,1
5103,4095830001,QN,129-02 LIBERTY AVENUE,05,K1,LEBCHIR PROPERTIES INC,2,1,1
5104,4096130065,QN,107-35 133 STREET,02,C0,DHANMATIE SHIWPRASHAD,2,1,1
5105,4096760056,QN,89-25 146 STREET,01,B3,"MCLAULIN, PULMATIE",2,1,1
5106,4097010008,QN,87-10 144 STREET,01,B3,"YASMIN, FOUJIA",3,2,1
5107,4098040057,QN,90-34 171 STREET,03,D3,171 HILLSIDE ASSOCIATE LLC,2,1,1
5108,4098510054,QN,85-38 168 PLACE,01,B2,MOHAMMAD S KHONDKER,2,1,1
5109,4098920042,QN,173-07 CROYDON ROAD,01,A1,"WONG, MICHAEL",2,1,1
5110,4099150028,QN,88-11 179 PLACE,04,K4,PRIYA LLC,4,3,1
5111,4099190048,QN,88-28 183 STREET,01,A1,"SIDDIQUI, RAHEEL",2,1,1
5112,4099230002,QN,89-40 184 STREET,01,B2,"BRIDGPAL RAMKIRPAL, VADIM",2,1,1
5113,4101630086,QN,104-84 165 STREET,01,B3,"RAHMAN, ATM",2,1,1
5114,4102120048,QN,170-19 93 AVENUE,02,C0,"AHMED, MOSTAK",2,1,1
5115,4102130053,QN,92-55 172 STREET,01,B3,SEEPERSAUD MUNILALL,2,1,1
5116,4102280001,QN,171-02 LIBERTY AVENUE,04,K4,"MURPHY, ANTOINETTE",2,1,1
5117,4102320043,QN,173-49 103 ROAD,01,A1,"MANNAN, MOHAMMAD A",2,1,1
5118,4102330209,QN,103-34 177 STREET,01,A1,"BRYANT, WANDA",2,1,1
5119,4103720017,QN,186-08 104 AVENUE,01,A1,ADEMOLA AJIMATANRAREJE,2,1,1
5120,4103760035,QN,105-26 189 STREET,01,A1,"CLIFTON, JANICE MARIE",2,1,1
5121,4104070008,QN,186-15 MURDOCK AVENUE,01,B3,"MILLER, OLGA MC CALLA",3,2,1
5122,4105040050,QN,86-76 PALO ALTO STREET,01,A1,"NEKAVA, MICHAEL",2,1,1
5123,4106590003,QN,89-95 215 PLACE,01,A1,HEMLATA JAGARNAUTH,2,1,1
5124,4108200009,QN,91-53 191 STREET,03,D3,191 HOLDING LLC,2,1,1
5125,4108260001,QN,195-30 SAGAMORE AVENUE,01,B3,"USMAN, SHUAIB",2,1,1
5126,4109070006,QN,204-12 109 AVENUE,01,A1,FATNY REALTY HOLDINGS LLC,2,1,1
5127,4109710021,QN,194-19 113 AVENUE,01,A1,"SINGH, MERLEEN ANN",2,1,1
5128,4109880043,QN,191-21 MURDOCK AVENUE,01,A1,"WILLIAMS, ROMONA",2,1,1
5129,4110110040,QN,114-46 196 STREET,01,B3,"GRANGER, LANAIRE D",2,1,1
5130,4110670048,QN,116-37 195 STREET,01,A1,"WISKY, REAN",2,1,1
5131,4111980089,QN,218-66 110 AVENUE,01,A1,"AKTHER, SULTANA",2,1,1
5132,4112080049,QN,110-05 225 STREET,01,B3,NYC HOUSING AUTHORITY,2,1,1
5133,4112360039,QN,219-19 114 AVENUE,01,A1,"RAWLINS, IRVING S",2,1,1
5134,4112980053,QN,115-82 217 STREET,01,A1,"BATTLE, MARIE J",2,1,1
5135,4113220034,QN,116-02 222 STREET,01,B3,"BANKS, TERRENCE",2,1,1
5136,4116170018,QN,111-34 113 STREET,01,B2,"REYNOSO, LINDA",2,1,1
5137,4117530028,QN,119-68 130 STREET,01,A1,"KUMAR, NARINDER",2,1,1
5138,4117700085,QN,129-22 132 STREET,01,A1,"BRANCH, DARNLEY",2,1,1
5139,4119330034,QN,109-27 143 STREET,01,A1,BUTLER JOHNSON JR,2,1,1
5140,4119540053,QN,111-29 VAN WYCK EXPRESSWAY,11,V0,SK CAPITAL NYC LLC,2,1,1
5141,4119640285,QN,111-41 147 STREET,01,A1,"AGBOSASA, GANIYU",2,1,1
5142,4119700027,QN,114-44 141 STREET,01,A1,"RAM, EDWARD",2,1,1
5143,4119770070,QN,146-02 LINDEN BOULEVARD,01,B3,WAYNE DAIMON,2,1,1
5144,4120130016,QN,117-43 141 STREET,01,A1,"MEDINA, MARIO",2,1,1
5145,4120150315,QN,117-63 142 PLACE,01,A1,"MAYORGA-REYES JR, SANTIAGO",2,1,1
5146,4120160027,QN,117-81 142 PLACE,01,A1,"BOODRAM, KAMLA",2,1,1
5147,4120550062,QN,137-05 130 AVENUE,01,B3,"BRIJLALL , KALICHARAN",2,1,1
5148,4121100025,QN,130-21 147 STREET,01,A1,DAVID SINCLAIR,3,2,1
5149,4121420012,QN,109-50 153 STREET,01,A1,SAGOR REALTY LLC,2,1,1
5150,4121700028,QN,155-19 113 AVENUE,01,B2,"TAN, KIN HONG",3,2,1
5151,4122090143,QN,118-12 155 STREET,01,A9,"ISLAM, SHAH",2,1,1
5152,4122190048,QN,123-25 152 STREET,01,A2,"KAIKAI, SAFULA",2,1,1
5153,4125240017,QN,174-04 128 AVENUE,01,B2,"GABOUREL, CORY",2,1,1
5154,4126210011,QN,196-22 118 AVENUE,01,A5,KIMBLE THELMA P,2,1,1
5155,4126830003,QN,197-08 120 AVENUE,01,B2,"RAJNAUTH , GLENDA",2,1,1
5156,4126830020,QN,120-36 198 STREET,01,B3,"DOWNEY, VERDINE E",2,1,1
5157,4129440007,QN,131-71 233 STREET,01,A2,"BROWNE, DENVER R",2,1,1
5158,4129700016,QN,133-23 FRANCIS LEWIS BLVD,01,A5,MARVO FORDE,2,1,1
5159,4131030018,QN,223-02 MERRICK BOULEVARD,06,E1,ML 223 02 LLC,2,1,1
5160,4131110026,QN,220-12 135 AVENUE,01,A1,"MULHOLLAND, JULIET C",2,1,1
5161,4131860045,QN,139-14 231 STREET,01,A1,"JARVIS, SANDY",2,1,1
5162,4133540035,QN,178-36 146 TERRACE,01,A2,"CAMPBELL, SHIRLEY",2,1,1
5163,4134610054,QN,146-16 228 STREET,01,B2,BISHOP BRENDA A,2,1,1
5164,4135460062,QN,240-06 145 AVENUE,01,B3,ROSA I BLAKE,2,1,1
5165,4136050032,QN,140-11 255 STREET,01,A2,GOUEDE NICHOLAS,2,1,1
5166,4136060020,QN,139-21 254 STREET,01,B3,"RENOIS, ARNOLD",3,2,1
5167,4153150035,QN,10 WEST 10 ROAD,01,A1,"SAVITSKY, STACEY",2,1,1
5168,4155440057,QN,11-31 NAMEOKE STREET,01,A1,"RENDLER, MICHOEL",2,1,1
5169,4156020033,QN,3-06 SEAGIRT AVENUE,01,B9,"ALLY, VADIM",4,3,1
5170,4156580010,QN,22-20 BIRDSALL AVENUE,02,C0,"HALL, RANDY",2,1,1
5171,4157660049,QN,505 GRASSMERE TERRACE,01,A1,"WILLABUS, KEITH",2,1,1
5172,4158910005,QN,53-07 ROCKAWAY BEACH BOULEVARD,05,K1,AHK HOLDING CORP.,2,1,1
5173,4160270008,QN,618 BEACH 67 STREET,01,B3,"DAVIS, CHARISSA",2,1,1
5174,4160810026,QN,325 BEACH 69 STREET,02,C0,BERTRAM RICHARDSON,2,1,1
5175,4161240095,QN,3-05 BEACH 90 STREET,01,B3,"JALIL, MOHAMMED",2,1,1
5176,4162160012,QN,249 BEACH 120 STREET,02,C0,MICHAEL PASTRIKOS,2,1,1
5177,4162440014,QN,553 BEACH 132 STREET,01,A2,MCLOUGHLIN VICTORIA,2,1,1
5178,4162680060,QN,222 BEACH 135 STREET,01,A1,MALKE LEVINE,2,1,1
5179,5000280071,SI,22 CRESCENT AVENUE,01,A1,"LEVAY, MICHAEL",2,1,1
5180,5000360050,SI,62 SCRIBNER AVENUE,01,B2,KS TRIPLE A INC,2,1,1
5181,5000370076,SI,67 SCRIBNER AVENUE,01,A1,F&V VISCIONE,2,1,1
5182,5000420015,SI,150 WINTER AVENUE,01,A1,150 WINTER LLC,2,1,1
5183,5000670032,SI,197 FILLMORE STREET,01,A1,BLADE CONTRACTING INC,2,1,1
5184,5000870006,SI,150 ARNOLD STREET,01,A1,ERNESTINA MC CULLERS,2,1,1
5185,5001150039,SI,48 OXFORD PLACE,02,C3,"HIDRIC, MUSLIJA",2,1,1
5186,5001440013,SI,2 NORTH MADA AVENUE,01,B3,THOMAS CORDASSO,2,1,1
5187,5001500257,SI,583 HENDERSON AVENUE,01,B2,"LI, SHUHUA",2,1,1
5188,5001540086,SI,349 PELTON AVENUE,01,A1,"DICKS, JOSEPH",2,1,1
5189,5001570081,SI,51A ELM STREET,01,B9,"OQUENDO, IGNACIO",2,1,1
5190,5001570199,SI,109 ELM STREET,01,B9,JEFFREY RUFF,2,1,1
5191,5001620012,SI,323 BEMENT AVENUE,01,A1,"QUINZI, NICOLE",2,1,1
5192,5001880008,SI,1718 RICHMOND TERRACE,06,E2,UNAVAILABLE OWNER,3,2,1
5193,5002030044,SI,134 DONGAN STREET,01,B2,"BETANCOURT, ANNA",2,1,1
5194,5002150250,SI,857 POST AVENUE,01,B2,ALICJA ADAMEK,2,1,1
5195,5002260091,SI,77 LYCEUM COURT,01,A5,JOEL L. FERNANDEZ,2,1,1
5196,5003000236,SI,578 BEMENT AVENUE,01,A1,"CARUSO, FRANK",2,1,1
5197,5003100274,SI,18 CLOVE LAKE PLACE,01,A1,C. FALLACARA,2,1,1
5198,5003110023,SI,9 WEST RALEIGH AVENUE,01,A1,WILLIAMS DALE,2,1,1
5199,5003290104,SI,59 KNOX PLACE,01,A0,JOSEPH BROGNA,2,1,1
5200,5003740310,SI,32 ELMIRA AVENUE,01,A1,CHERYL A NADEAU,2,1,1
5201,5003770573,SI,132 CROWELL AVENUE,01,A3,"GRANELLO, JAMES",2,1,1
5202,5004090011,SI,161 SPRINGFIELD AVENUE,01,A1,"DEFAZIO, WILLIAM",2,1,1
5203,5005310025,SI,50 HARRISON STREET,01,A1,"BRADY, THOMAS",2,1,1
5204,5005660032,SI,268 TARGEE STREET,02,C2,"SINGH, JARNAIL",5,4,1
5205,5006090051,SI,15 SUNNYSIDE TERRACE,01,B1,KIMBERLEY A. BELLICO-,2,1,1
5206,5006230130,SI,1046 VAN DUZER STREET,01,B2,GR ISLAND 1046 LLC,2,1,1
5207,5006500005,SI,1033 VAN DUZER STREET,01,B3,"WONG, ALAN",2,1,1
5208,5007240010,SI,2040 VICTORY BOULEVARD,05,O7,"MORGAN PROPERTIES, LL",2,1,1
5209,5007760075,SI,299 KELL AVENUE,01,B9,"GARFINKEL, CHAIM",2,1,1
5210,5008480166,SI,67 HUNTON STREET,01,A1,"GENOVESE, ANTONIO",2,1,1
5211,5010350012,SI,221 PORT RICHMONT AVENUE,11,V1,CASTLETON HOSING DEVELOPMENT FUND CORPOR ATION,2,1,1
5212,5010440059,SI,395 HEBERTON AVENUE,01,A1,LEE FAMILY TRUST,2,1,1
5213,5010490032,SI,16 RAINBOW AVENUE,01,A1,"RIVERA, EDWIN",2,1,1
5214,5010580038,SI,58 TABB PLACE,01,B2,"GARCIA GUTIERREZ, FERMIN J",2,1,1
5215,5011160013,SI,37 JOHN STREET,01,B9,"HIDRIC, MUSLIJA",2,1,1
5216,5011240011,SI,135 EATON PLACE,01,B1,"ATTIA, NADER",2,1,1
5217,5011400013,SI,603 VILLA AVENUE,01,B3,"MIRANDA, JOHN",2,1,1
5218,5011760028,SI,275 SIMONSON AVENUE,01,A9,LOMBARDI LOUIS L,2,1,1
5219,5011980109,SI,392 SIMONSON AVENUE,01,A1,"PUNITHALINGAM, MUTHULINGAM",2,1,1
5220,5012110141,SI,74 VAN PELT AVENUE,01,A1,G HALL,2,1,1
5221,5012120059,SI,35 DE HART AVENUE,01,A1,BELLAMY SHEILA,2,1,1
5222,5012130004,SI,145 UNION AVENUE,02,C3,BVA MARTINERS REALTY,2,1,1
5223,5012660054,SI,184 SOUTH AVENUE,04,S9,"CULOTTA, PAUL",3,2,1
5224,5013180125,SI,72 HOLLAND AVENUE,01,A1,KEITH L WALTON,2,1,1
5225,5014420072,SI,150 CRYSTAL AVENUE,01,A2,A LA FATA,2,1,1
5226,5015040007,SI,163 AUBURN AVENUE,01,B2,163 AUBURN LLC,2,1,1
5227,5015080208,SI,52 CAMBRIDGE AVENUE,01,A9,ANTHONY ALEGRE,2,1,1
5228,5017000019,SI,463 VAN NAME AVENUE,01,A9,SALVATORE PISCICELLI,2,1,1
5229,5026370052,SI,4164 VICTORY BOULEVARD,05,K2,4162 LLC,2,1,1
5230,5029200062,SI,496 MOSEL AVENUE,05,O1,"JOHNSEN, KATHLEEN",2,1,1
5231,5031660023,SI,34 GRASMERE AVENUE,01,A5,"TONG, FANG CAI",2,1,1
5232,5032460094,SI,126 KENSINGTON AVENUE,01,B2,"XIE, MULI",2,1,1
5233,5032500023,SI,184 KENSINGTON AVENUE,01,B3,"VALENTI, LOUIS A",2,1,1
5234,5033010062,SI,89 CROMWELL AVENUE,04,S5,"SOTTILE, THOMAS",3,2,1
5235,5033060031,SI,58 SEAVIEW AVENUE,01,A1,PAMELA DECONZO,2,1,1
5236,5033980018,SI,26 WINFIELD STREET,01,B9,"MARCHENKO, LARISSA",2,1,1
5237,5034720012,SI,492 SEAVIEW AVENUE,01,A1,"SHERRY, AUDREY JILL",2,1,1
5238,5038250021,SI,659 SEAVER AVENUE,11,V0,HOUSING TRUST FUND CORPORATION,3,2,1
5239,5038340005,SI,659 QUINCY AVENUE,11,V0,HOUSING TRUST FUND CORPORATION,2,1,1
5240,5038870049,SI,1201 OLYMPIA BOULEVARD,01,B9,"CHEN, QING HUA",2,1,1
5241,5039050039,SI,340 BRYANT AVENUE,01,B9,DZEMAL MUSOVIC,2,1,1
5242,5039300090,SI,509 NEW DORP LANE,09,Q1,NATIONAL PARK SERVICE,24,23,1
5243,5040410075,SI,68 WEED AVENUE,01,A1,PHILIP L LAFACE,2,1,1
5244,5040700058,SI,209 HETT AVENUE,02,C0,"LIN & LIN STATEN ISLAND INVESTMENT, LLC",2,1,1
5245,5040850064,SI,48 TOPPING STREET,01,A2,JOHN WILLIAM SCHRIEFE,2,1,1
5246,5042220001,SI,2545 HYLAN BOULEVARD,05,GW,"BASSO, SALVATORE",2,1,1
5247,5042310007,SI,128 BEACH AVENUE,01,A1,BRUCE SHERIDAN,2,1,1
5248,5042900009,SI,171 ISABELLA AVENUE,01,A1,SHAWN R OHARA,2,1,1
5249,5044670012,SI,382 CLARKE AVENUE,01,A2,"HUDGENS, DAVID",2,1,1
5250,5045970036,SI,139 ELKHART STREET,01,A2,JOHN TURKUS,2,1,1
5251,5052790015,SI,142 DRIGGS STREET,01,B2,"D'AMICO, ANDREW",2,1,1
5252,5066530019,SI,5682 AMBOY ROAD,01,B2,"RODRIGUEZ, ALVARO",2,1,1
5253,5066700075,SI,39 CASE AVENUE,01,A1,"KAPITAN, FRANCIS",2,1,1
5254,5069240008,SI,583 RAMONA AVENUE,01,B2,"IMPARATO, ROBERT",2,1,1
5255,5069410014,SI,130 UNCAS AVENUE,01,A1,GLENN ABOLT AND ANNET,2,1,1
5256,5069430004,SI,6019 AMBOY ROAD,01,A1,CALABRESE PATRICIA P,2,1,1
5257,5069440117,SI,31 DEPEW PLACE,01,A1,MARIYA STILBANS,2,1,1
5258,5075340295,SI,15 EMERALD COURT,01,B2,RICKY CAMARDA,3,2,1
5259,5078120096,SI,168 BEDELL AVENUE,01,A2,DARISA PIVEN,2,1,1
5260,5079420003,SI,70 SUMMIT ROAD,01,A1,"LEVEROCK, JESSICA",2,1,1
5261,1000160100,MN,345 SOUTH END AVENUE,04,D6,BATTERY PARK CITY AUTHORY,6,5,1
5262,1001420001,MN,292 GREENWICH STREET,08,W1,NYC DEPARTMENT OF EDUCATION,2,1,1
5263,1001840008,MN, MARGINAL STREET,07,T2,NYS DEPARTMENT OF TRANSPORTATION,4,3,1
5264,1004470030,MN,93 1 AVENUE,04,C7,93 FIRST,2,1,1
5265,1005000015,MN,128 WOOSTER STREET,04,S3,"128 WOOSTER, LLC",2,1,1
5266,1006270017,MN,45 HORATIO STREET,01,B9,45 HORATIO LLC,2,1,1
5267,1007610004,MN,492 9 AVENUE,04,C7,"492 NINTH AVENUE, LLC",2,1,1
5268,1009100064,MN,423 3 AVENUE,04,C7,MARION AVE.,2,1,1
5269,1010540048,MN,432 WEST 45 STREET,05,O3,REISS REALTY CORP,5,4,1
5270,1011170001,MN,1930 BROADWAY,04,D7,DELBRO REALTY 1920,2,1,1
5271,1012280005,MN,251 WEST 80 STREET,08,M1,ALL ANGELS CHURCH INC,2,1,1
5272,1012360029,MN,205 WEST 88 STREET,04,D6,WEST 88 STREET LLC,2,1,1
5273,1013000020,MN,465 LEXINGTON AVENUE,04,K4,465 LEXINGTON AVENUE,2,1,1
5274,1014120021,MN,1105 LEXINGTON AVENUE,04,C7,TSOUMPAS 1105 EQUITIES LLC,2,1,1
5275,1015280028,MN,1597 2 AVENUE,04,C7,83 OWNERS LLC,7,6,1
5276,1016680001,MN,1860 2 AVENUE,08,W1,NYC DEPARTMENT OF PARKS AND RECREATION,2,1,1
5277,1016810104,MN,303 EAST 109 STREET,02,C3,309 EAST 109TH STREET PARTNERS LLC,2,1,1
5278,2023220081,BX,220 EAST 138 STREET,06,F5,CIGON LLC,2,1,1
5279,2024070018,BX,390 EAST 161 STREET,07,G5,ROSE 871 LLC,2,1,1
5280,2024260064,BX,1201 WEBSTER AVENUE,07,G5,HESS RETAIL STORES LLC,5,4,1
5281,2026690080,BX,1007 UNION AVENUE,08,M9,"HP MJM HOUSING DEVELOPMENT FUND COMPANY, INC.",7,6,1
5282,2027750198,BX,363 HUNTS POINT AVENUE,,Z9,HALLECK HOLDING CORP.,2,1,1
5283,2027800073,BX,1280 RYAWA AVENUE,,Z9,NYC DEPARTMENT OF SMALL BUSINESS SERVICES,6,5,1
5284,2027820018,BX,1328 FINDLAY AVENUE,01,B1,"SOLOMON, PERLEY",2,1,1
5285,2029770110,BX,1515 SOUTHERN BOULEVARD,05,O7,CASTILLO EAST LLC,2,1,1
5286,2029960047,BX,1517 BRYANT AVENUE,01,B2,"LEE, TAE YOUNG TARQUIN",2,1,1
5287,2031150028,BX,730 EAST FORDHAM ROAD,07,G3,"GTY-CPG (QNS/BX) LEASING, INC.",2,1,1
5288,2032190142,BX,2451 DEVOE TERRACE,02,C0,"DELACRUZ, MANUEL A",2,1,1
5289,2032260100,BX,110 WEST KINGSBRIDGE RD,08,I1,BRONX V A MEDICAL CENTER,10,9,1
5290,2032490071,BX,2764 CLAFLIN AVENUE,01,A1,LONNIE HAMILTON,2,1,1
5291,2033740039,BX,4215 KATONAH AVENUE,01,A1,"SORZA-ENRIQUES, JESUS",2,1,1
5292,2033790100,BX,215 EAST 238 STREET,01,B3,QUATTROCCHI FAMILY TRUST DATED 3-20-08,2,1,1
5293,2034290427,BX,102 HARDING PARK,01,A1,"RIVERA, DEBBIE A",2,1,1
5294,2034830014,BX,315 CASTLE HILL AVENUE,01,B2,"LANFRANCO, RAFAEL",2,1,1
5295,2035270006,BX,1907 LACOMBE AVENUE,01,A1,"KHALAKAZAMAN, ABUL H",2,1,1
5296,2036940020,BX,2226 BRUCKNER BOULEVARD,01,B2,"UDDIN, TAZ",2,1,1
5297,2037210001,BX,1677 BRUCKNER BOULEVARD,05,K5,"WHITE CASTLE SYSTEM,INC",2,1,1
5298,2037380062,BX,1143 WHEELER AVENUE,02,C3,"ORTIZ-ALVARADO, JOSE",2,1,1
5299,2038140022,BX,2128 WESTCHESTER AVENUE,05,O5,2128 WESTCHESTER AVE LLC,2,1,1
5300,2039180041,BX,1533 ST LAWRENCE AVENUE,01,A1,EDGAR VILLACIS,2,1,1
5301,2039250018,BX,1565 THIERIOT AVENUE,03,D1,"PREMIER APARTMENTS, LLC",2,1,1
5302,2039710059,BX,1565 PARKER STREET,01,B2,"BABUL, MOHAMMED",2,1,1
5303,2039720006,BX,1510 PARKER STREET,02,C0,ADEN PARKER REALTY CORP.,2,1,1
5304,2039720057,BX,1569 ZEREGA AVENUE,01,B2,1569 ZEREGA TRUST,2,1,1
5305,2042660040,BX,1949 RADCLIFF AVENUE,01,B1,D'AGOSTINO  ROSA,2,1,1
5306,2042740019,BX,1943 YATES AVENUE,02,C0,MARGARET DEAN,2,1,1
5307,2044810078,BX,1533 HAWTHORNE STREET,01,A5,"CASUCCI, PAULINE A",2,1,1
5308,2045430012,BX,3022 BRONX PARK EAST,01,A1,"RUSSELL, RAPHAEL T",2,1,1
5309,2045760028,BX,980 BURKE AVENUE,01,B1,SPENCE ERNEST,2,1,1
5310,2046460076,BX,3629 WILLETT AVENUE,01,B1,"MENA, FRANK",2,1,1
5311,2046500075,BX,3723 WILLETT AVENUE,10,G0,"ARMSTRONG , MELODEE",2,1,1
5312,2046630024,BX,720 EAST 216 STREET,11,V0,720 E. 216 DEVELOPMENT LLC,3,2,1
5313,2047620068,BX,3064 FENTON AVENUE,01,A2,JETJOMLONG LINDA,2,1,1
5314,2047660019,BX,3025A MICKLE AVENUE,01,A5,"LUTCHMANSINGH, DALTON",2,1,1
5315,2047690001,BX,3185 GUNTHER AVENUE,01,B1,HENRY NORMALYN,2,1,1
5316,2048330015,BX,685 EAST 230 STREET,02,C2,685 EAST 230TH REALTY CORP.,2,1,1
5317,2048440011,BX,757 EAST 230 STREET,01,B3,"SINGH, MAHENDRA",2,1,1
5318,2049220015,BX,3653 MAROLLA PLACE,01,B1,DOUGLAS LLOYD,2,1,1
5319,2050460004,BX,713 EAST 237 STREET,01,B2,713 EAST 237 LLC,2,1,1
5320,2050720010,BX,1719 NEREID AVENUE,04,S1,HYACINTH MILLER,2,1,1
5321,2050810028,BX,4528 RICHARDSON AVENUE,01,B2,NIPAL KAMAL,3,2,1
5322,2051080005,BX,647 EAST 242 STREET,01,B1,THE SIMPSON FAMILY IRREVOCABLE TRUST,2,1,1
5323,2051100020,BX,665 EAST 243 STREET,01,B3,EVADNE COLEY,2,1,1
5324,2053500051,BX,3140 EAST TREMONT AVENUE,05,O5,3100 TREMONT ASSOCIATES INC,2,1,1
5325,2053980054,BX,1424 HOBART AVENUE,01,B3,SCHNEIDER ROBERT,2,1,1
5326,2054100290,BX,1464 KENNELLWORTH PLACE,01,B3,"BRUNO , DELILAH  J",2,1,1
5327,2054160155,BX,1641 BAY VIEW AVENUE,01,A5,DEUTSCHE BANK NATIONAL TRUST CO,2,1,1
5328,2054480031,BX,4189 EAST TREMONT AVENUE,02,C0,"REYES, EDWIN D",2,1,1
5329,2054580041,BX,1022 THROGS NECK EXPWY SR,01,B1,"SEVERINO, CARLOS",2,1,1
5330,2054680038,BX,924 WILCOX AVENUE,01,B1,"D'ERCOLE, PASQUA M",2,1,1
5331,2055150120,BX,64A EDGEWATER PARK,01,A8,EDGEWATER PK OWNERS COOPERATIV,39,38,1
5332,2055910016,BX,279 CALHOUN AVENUE,01,A2,GERENA DAVID,2,1,1
5333,2055990056,BX,271 DAVIS AVENUE,01,A1,"BIP, CHHEN",2,1,1
5334,2056250240,BX,117 HORTON STREET,01,A1,WILLIAMS JOHN H,2,1,1
5335,2056260078,BX,81 PILOT STREET,02,C0,"MAZZELLA, PHILLIP",4,3,1
5336,2056260123,BX,54 REYNOLDS STREET,01,A1,"HOSTOMKSY, DONALD G",2,1,1
5337,2056270122,BX,91 CENTRE STREET,01,A1,"KRAWITZ, LAWRENCE",2,1,1
5338,2056550221,BX,4240 BOSTON ROAD,06,E1,PASCAP CO INC,6,5,1
5339,2058283527,BX,5028 FIELDSTON ROAD,08,W3,RIVERDALE COUNTRY SCH,3,2,1
5340,3003740002,BK,525 CLINTON STREET,02,C0,"SAVINO, MICHAEL",2,1,1
5341,3004707501,BK,126 4 PLACE,02,R6,UNAVAILABLE OWNER,4,3,1
5342,3005170020,BK,99 COMMERCE STREET,06,F9,"JAB 1 REALTY, LLC",3,2,1
5343,3005310033,BK,84 PIONEER STREET,01,B9,ADA BERRIOS,2,1,1
5344,3005870027,BK,67 DIKEMAN STREET,01,B9,WALSH JOHN,2,1,1
5345,3005970020,BK,121 COFFEY STREET,01,A1,MICHAEL L & GLORIA KROPSKY,2,1,1
5346,3007510036,BK,868 45 STREET,02,C0,"CHEN, ZHONG",2,1,1
5347,3007730018,BK,326 48 STREET,01,B9,OCTAVIO A HERNANDEZ,2,1,1
5348,3008160001,BK,5323 5 AVENUE,05,O5,SUNSET 5TH LLC,3,2,1
5349,3008740071,BK,333 18 STREET,02,C2,333 18TH STREET LLC,2,1,1
5350,3008760033,BK,472 17 STREET,01,B2,"PAGAN, ELIZABETH",2,1,1
5351,3008790068,BK,271 19 STREET,01,B2,"GIGLIOTTI, VITTORIA",2,1,1
5352,3010650001,BK,810 UNION STREET,04,K4,810 UNION LLC,2,1,1
5353,3010740033,BK,174 8 AVENUE,01,A4,GERSON KATHLEEN,2,1,1
5354,3012770075,BK,1275 PRESIDENT STREET,01,A5,"BRANOVER, DANIEL",2,1,1
5355,3012840049,BK,1289 CARROLL STREET,01,A4,"BEECHAM-ROBINSON, ANITA",2,1,1
5356,3012980015,BK,366 CROWN STREET,01,A4,LOUIS BRAFMAN,2,1,1
5357,3013180045,BK,96 STERLING STREET,01,B1,"TEJADA, CARLOS",2,1,1
5358,3013250061,BK,17 LAMONT COURT,01,B1,"LAMONT RESIDENCES, LLC",2,1,1
5359,3013600022,BK,1144 ST MARKS AVENUE,02,C3,"ANTOINE, ELIZABETH",2,1,1
5360,3013690026,BK,1596 PROSPECT PLACE,02,C3,ENEAU'S REALTY LLC,2,1,1
5361,3014090014,BK,1702 PRESIDENT STREET,01,B1,"DINERMAN, MORDECHAI Y",2,1,1
5362,3014090063,BK,1691 CARROLL STREET,02,C3,1691 Y AND S LLC,2,1,1
5363,3014180028,BK,678 CROWN STREET,01,B1,"RAITPORT, YOSSI",2,1,1
5364,3014620004,BK,501 RALPH AVENUE,04,S1,"FORBES, SOPHIE",2,1,1
5365,3014770001,BK,1203 EAST NEW YORK AVENUE,05,K1,1203 EAST NY OWNER LLC,2,1,1
5366,3014810039,BK,8 HOWARD AVENUE,08,M1,GRAND CONSISTORY/NY,3,2,1
5367,3016560071,BK,589 HANCOCK STREET,01,B3,"BRACEY, DENISE",3,2,1
5368,3016820033,BK,406 DECATUR STREET,02,C0,CITY OF NEW YORK,2,1,1
5369,3017860005,BK,238 KOSCIUSZKO STREET,01,B2,"OSINOWO, FUNMILOLA",2,1,1
5370,3018660017,BK,44 HERKIMER PLACE,01,B9,"ABDUL HAFEEZ, BISMILLAH",4,3,1
5371,3019810060,BK,428A GRAND AVENUE,10,G0,GRENIER KARESSE,2,1,1
5372,3019890038,BK,430 FRANKLIN AVENUE,04,S2,"ALSTON TRUSTEE, IRENE",2,1,1
5373,3019890057,BK,111 PUTNAM AVENUE,02,C0,SNA CB 2018 HOUSING DEVELOPMENT FUND COM PANY INC,2,1,1
5374,3019970048,BK,1135 FULTON STREET,05,K1,BERMUDA REALTY NO. 2 LLC,3,2,1
5375,3022050012,BK,126 HOOPER STREET,02,C3,"CHAVA NEIMAN, AS TRUSTEE",2,1,1
5376,3022120009,BK,178 HEWES STREET,02,C0,178 HEWES CORP,2,1,1
5377,3022790001,BK,29 WYTHE AVENUE,11,V1,FALSE ALARM LTD,2,1,1
5378,3026830056,BK,40 MCGUINNESS BOULEVARD,01,B9,SHARON TSING-WAI WONG,2,1,1
5379,3027210046,BK,21 RICHARDSON STREET,02,C0,"SANSEVERINO, SAM",2,1,1
5380,3027580037,BK,653 METROPOLITAN AVENUE,04,D6,653 METROPOLITAN REALTY INC.,2,1,1
5381,3030450029,BK,195 MESEROLE STREET,02,C2,COLON ISMAEL,2,1,1
5382,3030540006,BK,190 MESEROLE STREET,02,C1,"KENNEDY PROPERTIES, LLC",2,1,1
5383,3030540019,BK,220 BUSHWICK AVENUE,04,C7,B TWO TWO LLC,2,1,1
5384,3031900045,BK,309 STARR STREET,06,F4,HAPPIER TWO PRODUCTIONS LLC,3,2,1
5385,3033810057,BK,1109 JEFFERSON AVENUE,01,B2,1109 JEFFERSON AVE REALTY CORP,2,1,1
5386,3034400014,BK,114 COOPER STREET,02,C0,114 COOPER STREET LLC,2,1,1
5387,3036000028,BK,815 THOMAS S BOYLAND ST,01,B1,GORDON JOHN,2,1,1
5388,3038850154,BK,24 CROSBY AVENUE,01,B2,"ARROYO, DANIEL",2,1,1
5389,3039480037,BK,2831 ATLANTIC AVENUE,04,S4,ISLAMIC HERITAGE HERBMETICS LLC,2,1,1
5390,3039500021,BK,2876 FULTON STREET,02,C0,CARLOS E LORA,2,1,1
5391,3039580029,BK,3084 FULTON STREET,04,S4,3084 FULTON INC.,2,1,1
5392,3039810016,BK,602 LIBERTY AVENUE,04,S9,R H J T R INC,4,3,1
5393,3040040023,BK,398 SHEPHERD AVENUE,01,B1,"ARTHUR, MICHELLE",2,1,1
5394,3041740072,BK,398 GRANT AVENUE,08,M4,ST SYLVESTERS CHURCH,2,1,1
5395,3042260021,BK,106-04 RUBY STREET,01,B2,"RAKIB UDDIN, MOHAMME",2,1,1
5396,3043030012,BK,696 MILLER AVENUE,02,C2,GMC IRIS LLC,2,1,1
5397,3043160025,BK,710 SHEPHERD AVENUE,01,B1,ANCHOR ESTABLISHMENT LLC,2,1,1
5398,3046400033,BK,173 EAST 53 STREET,02,C0,GAK2010 ENTERPRISES LLC,2,1,1
5399,3046450013,BK,306 EAST 91 STREET,02,C3,BERTRAM ASHMAN,3,2,1
5400,3046500082,BK,277 EAST 95 STREET,02,C2,"MC CARTHY, SHERWIN",3,2,1
5401,3046720049,BK,391 ROCKAWAY PARKWAY,02,C3,WILLIAMS COLLETT,2,1,1
5402,3047540051,BK,622 EAST 95 STREET,02,C0,"MARTINEZ-HERNANDEZ, EVA",2,1,1
5403,3047600048,BK,677 EAST 49 STREET,01,A5,"GONZALES, BRUCE",2,1,1
5404,3047910041,BK,448 LINCOLN ROAD,01,B9,"DIXON, PETER",2,1,1
5405,3048090005,BK,1165 NOSTRAND AVENUE,05,O7,COMMUNITY FAMILY PLANNIN,3,2,1
5406,3049550068,BK,521 EAST 38 STREET,01,A9,"DAVID, TYECHIA",2,1,1
5407,3049730013,BK,590 EAST 40 STREET,01,A1,"BARNES, LAMARR",2,1,1
5408,3051350042,BK,2401 BEVERLEY ROAD,04,K4,UNA JOSEPH 2018 IRREVOCABLE TRUST,2,1,1
5409,3051410102,BK,338 STRATFORD ROAD,01,B3,SOCHEAT CHUM,2,1,1
5410,3051790067,BK,469 MARLBOROUGH ROAD,01,B2,"ROBINSON, GAIL",2,1,1
5411,3053210048,BK,52 KERMIT PLACE,01,B2,52 KERMIT LLC,2,1,1
5412,3053650017,BK,1530 39 STREET,01,B1,"MALINAS, JONATHAN",2,1,1
5413,3053657501,BK,1524 39 STREET,02,R6,UNAVAILABLE OWNER,2,1,1
5414,3053870001,BK,306 CORTELYOU ROAD,04,S3,"TAVERAS, FRANCISCO",2,1,1
5415,3054150033,BK,107 WEBSTER AVENUE,02,C0,"WEBER, ANDREW",2,1,1
5416,3054340020,BK,1634 45 STREET,01,B3,"FUHRER, BEN-ZION",2,1,1
5417,3054357501,BK,1740 45 STREET,02,R6,NAME NOT ON FILE,2,1,1
5418,3054540018,BK,1620 49 STREET,02,C0,"KLEIN, SHAYA",2,1,1
5419,3054680007,BK,5105 18 AVENUE,01,B2,BRUNNER FAMILY HOLDINGS LLC,2,1,1
5420,3054690019,BK,1942 51 STREET,01,A5,"BRAILOFSKY, MALKY",2,1,1
5421,3054750053,BK,1957 53 STREET,01,A5,ROBERT HERZOG,2,1,1
5422,3055010069,BK,2113 58 STREET,01,A1,"SCHARF, LIPA",2,1,1
5423,3055157501,BK,2174 59 STREET,02,R6,UNAVAILABLE OWNER,2,1,1
5424,3055360024,BK,2144 62 STREET,01,B3,PENNISI ANGELO,2,1,1
5425,3055420015,BK,2024 63 STREET,01,A5,"AUGUSTA, JR., JOHN",2,1,1
5426,3055660020,BK,1563 68 STREET,01,A5,KWOK Y POON,2,1,1
5427,3055710036,BK,6702 21 AVENUE,02,C3,"GAO, XIAO LING",2,1,1
5428,3056237510,BK,1325 47 STREET,02,R1,UNAVAILABLE OWNER,2,1,1
5429,3056530049,BK,5120 11 AVENUE,01,B1,JANKOVITS FAMILY FAMILY,2,1,1
5430,3056790033,BK,864 55 STREET,02,C0,"GAO, CHENG EN",2,1,1
5431,3056880033,BK,1070 56 STREET,08,N2,JEWISH BD OF FAMILY & CHILDREN SERV,2,1,1
5432,3057090035,BK,1070 59 STREET,08,M1,CHRIST EVANG LUTH CHU,2,1,1
5433,3058600089,BK,82 68 STREET,01,B3,"HYLAND, MARISA",2,1,1
5434,3058820009,BK,7005 NARROWS AVENUE,01,A5,ROSEANN WOODS,2,1,1
5435,3058840005,BK,7035 NARROWS AVENUE,01,A1,RICHARD TROC,3,2,1
5436,3059240037,BK,1076 73 STREET,01,B3,"COLON, DONNA MARIE",2,1,1
5437,3059450069,BK,953 76 STREET,01,A5,"TRIBUZIO, FRANCO",2,1,1
5438,3059610071,BK,411 78 STREET,01,B1,ANNA GABRIEL SUPPLEMENTAL NEEDS TRUST,2,1,1
5439,3059660008,BK,44 78 STREET,01,A1,"BADYNA, ANGELIQUE",2,1,1
5440,3059840072,BK,1017 80 STREET,01,A1,ANGILLETTA  DOMINICK,2,1,1
5441,3059950016,BK,150 81 STREET,01,A3,"FALLAH, ABRAHAM",2,1,1
5442,3060550033,BK,22 BATTERY AVENUE,01,B2,"RAMADANI, FATON",2,1,1
5443,3060560001,BK,35 BATTERY AVENUE,01,B1,DAMON K. LEW,2,1,1
5444,3060810074,BK,373 91 STREET,02,C1,373 91ST STREET LLC,2,1,1
5445,3061100065,BK,213 GELSTON AVENUE,01,A9,"ALMONTE, ALEX",2,1,1
5446,3061130045,BK,255 95 STREET,08,N9,COMMUNITY RESIDENTIAL OPPORTUNITIES,2,1,1
5447,3061160024,BK,256 95 STREET,01,B2,"TENCONI, CECILIA",2,1,1
5448,3062020034,BK,1566 73 STREET,01,A1,"LEE, CHI SHING",2,1,1
5449,3062600046,BK,7812 18 AVENUE,01,B2,LACCONA ROCCO,2,1,1
5450,3063090063,BK,1337 84 STREET,01,A9,"GUARINO, JOSEPH J",2,1,1
5451,3063470028,BK,2152 85 STREET,02,C0,2152 REALTY LLC,2,1,1
5452,3064270030,BK,8787 15 AVENUE,01,B1,CARPENTIER FRAN,2,1,1
5453,3065037501,BK,842 OCEAN PARKWAY,04,RM,UNAVAILABLE OWNER,2,1,1
5454,3065200010,BK,932 EAST 8 STREET,01,A1,"HADDAD, MILLO",2,1,1
5455,3065330039,BK,1188 EAST 8 STREET,01,A1,TAWIL NEIL,2,1,1
5456,3065330045,BK,727 AVENUE L,02,C0,VICTOR TAWIL,2,1,1
5457,3065590045,BK,2379 65 STREET,05,O7,ALMA MANAGEMENT LLC,2,1,1
5458,3065680013,BK,1312 OCEAN PARKWAY,01,B1,"HECHT, BONNIE WOLSKY",2,1,1
5459,3065790056,BK,1391 WEST 6 STREET,01,A9,"LUI, PUI SHEUNG",2,1,1
5460,3065890041,BK,1472 EAST 8 STREET,01,A3,"BROWN, KENNETH I",2,1,1
5461,3066120017,BK,1536 OCEAN PARKWAY,02,C0,"WEINMAN, JACK",2,1,1
5462,3066150080,BK,1539 EAST 8 STREET,01,B2,"CABASSO, SHARON",2,1,1
5463,3066150084,BK,1531 EAST 8 STREET,01,A1,"SHALOM, JACOB",2,1,1
5464,3066160085,BK,1515 EAST 9 STREET,01,B3,TOBIAS ESTHER,2,1,1
5465,3066340024,BK,1740 EAST 3 STREET,01,B1,1740 EAST 3RD STREET LLC,2,1,1
5466,3066820085,BK,1831 OCEAN PARKWAY,01,B1,"ANTEBI, ELLIOT",2,1,1
5467,3066970054,BK,881 EAST 13 STREET,01,A1,JOSHUA MARKOVICS,2,1,1
5468,3067260065,BK,1159 EAST 15 STREET,01,A9,"BECK, NATALIE",2,1,1
5469,3067550029,BK,1470 EAST 18 STREET,01,A1,UNGER STEVEN,2,1,1
5470,3067570046,BK,1968 OCEAN AVENUE,08,I5,ESTHER PROPERTIES LLC,2,1,1
5471,3068280046,BK,2211 AVENUE S,01,A1,"SAADEH, VICTOR",2,1,1
5472,3068610056,BK,32 BAY 34 STREET,01,B3,SALVATORE COLANDREA 2018 IRREVOCABLE TRU ST,2,1,1
5473,3070030059,BK,3743 NAUTILUS AVENUE,01,B2,"RIBACK, FERN",2,1,1
5474,3070900015,BK,1922 EAST 9 STREET,01,A1,"COHEN, ELI D.",2,1,1
5475,3071040524,BK,2047 EAST 1 STREET,01,A1,RONALD TAWIL,2,1,1
5476,3071310027,BK,2224 EAST 5 STREET,01,B2,YL AND NM REALTY LLC,2,1,1
5477,3071350056,BK,2159 EAST 8 STREET,01,B1,"JAJATI, SAMI",2,1,1
5478,3071450073,BK,2277 WEST 6 STREET,01,B2,"CHEN, FENG TING",2,1,1
5479,3071930063,BK,2437 WEST 3 STREET,01,B2,"LA PORTA, MARGARET",2,1,1
5480,3073050070,BK,1941 EAST 26 STREET,01,A1,"NATANEL LANIADO, AS TRUSTEE",2,1,1
5481,3073180026,BK,2048 EAST 14 STREET,08,M3,HOMECREST PRES CHURCH,2,1,1
5482,3073710015,BK,2218 EAST 12 STREET,01,A1,"ABDOO  AS TRUSTEE, ANGELA F",2,1,1
5483,3073730066,BK,2251 HOMECREST AVENUE,01,A3,DANIEL FAKS,2,1,1
5484,3073800058,BK,1901 AVENUE W,02,C0,TATIANA TURETSKY,2,1,1
5485,3073810124,BK,2266 EAST 22 STREET,01,B1,"HUANG, YAMIN",2,1,1
5486,3073990084,BK,1402 GRAVESEND NECK ROAD,04,S2,H.K.M. INC,2,1,1
5487,3074050010,BK,2378 EAST 21 STREET,01,A9,"RANGINI, NISAN",2,1,1
5488,3074180036,BK,1609 AVENUE Y,05,K1,DOL REALTY LLC,2,1,1
5489,3074380051,BK,2565 EAST 17 STREET,05,O7,2565 E 17TH REALTY LLC,2,1,1
5490,3075560150,BK,2895 BEDFORD AVENUE,08,W5,BROOKLYN COLLEGE,9,8,1
5491,3075910030,BK,939 EAST 27 STREET,01,B1,"EISNER, LUDWIG",2,1,1
5492,3075960075,BK,1846 NEW YORK AVENUE,01,A9,"TYBERG, CHAIM",2,1,1
5493,3076030054,BK,1092 EAST 22 STREET,01,A1,"MATALON, MICHAEL",2,1,1
5494,3076230065,BK,1146 EAST 24 STREET,01,B2,JEROME KATZ,2,1,1
5495,3076240022,BK,1155 EAST 24 STREET,01,B2,"SCHLOSSER, AARON",2,1,1
5496,3076240053,BK,3242 BEDFORD AVENUE,04,S1,"BAUM, NAFTOLY T",2,1,1
5497,3077010058,BK,1644 MADISON PLACE,01,A1,DANIEL D. SOFER,2,1,1
5498,3077040061,BK,1658 EAST 32 STREET,01,B1,"THURM, SAMUEL",2,1,1
5499,3077430081,BK,1024 EAST 40 STREET,01,A9,"WATSON, CLARE",2,1,1
5500,3078260031,BK,1481 EAST 46 STREET,01,A5,"BELIZAIRE, MAGDALENE",2,1,1
5501,3078490055,BK,1488A EAST 52 STREET,01,A5,"BYRON, JILLIAN V",2,1,1
5502,3078520002,BK,5419 AVENUE M,01,A9,"DECOTEAU, REGINALD S",2,1,1
5503,3078740052,BK,2082 UTICA AVENUE,08,W9,"UTICA BK, LLC",2,1,1
5504,3079030055,BK,1426 EAST 59 STREET,01,A9,"SAMUEL, HILTON",2,1,1
5505,3079690001,BK,5001 GLENWOOD ROAD,05,G8,PREMIER LINCOLN-MERCURY INC,3,2,1
5506,3080370036,BK,1001 EAST 85 STREET,01,B1,"HARRIOTT, CALVIN",2,1,1
5507,3080370164,BK,1030 EAST 86 STREET,01,B2,"SOUTH, RONALD",2,1,1
5508,3080660065,BK,1264 EAST 88 STREET,01,A2,IVAN ESPINOSA,2,1,1
5509,3081120011,BK,745 EAST 94 STREET,01,B1,"WILLIAMS, ALSTEAD A",2,1,1
5510,3081480041,BK,526 EAST 99 STREET,01,B2,"GONEL, SOLANGE",2,1,1
5511,3082800041,BK,9618 AVENUE M,01,B2,"BENEDUCE, SALVATORE",2,1,1
5512,3083850075,BK,1460 EAST 64 STREET,01,A9,"TABRISKY, JENNI AMANDA",2,1,1
5513,3084720063,BK,1854 MADISON PLACE,01,A9,"KINSBERG, ARI",2,1,1
5514,3085020020,BK,1940 EAST 36 STREET,09,Q9,NYC DEPARTMENT OF PARKS AND RECREATION,2,1,1
5515,3085090029,BK,1921 HENDRICKSON STREET,01,B3,JOSE BARRETO,2,1,1
5516,3085090062,BK,2316 FLATBUSH AVENUE,11,V1,2316 FLATBUSH AVENUE LLC,2,1,1
5517,3086610054,BK,2962 BRIGHTON 1 STREET,08,W8,2962 B1S LLC,2,1,1
5518,3087260051,BK,87 WEST END AVE,05,O5,"GROBSHTEYN, YURY",2,1,1
5519,3087380004,BK,271 WEST END AVENUE,01,A1,YELENA LEVIT,2,1,1
5520,3087540038,BK,134 LANGHAM STREET,01,B3,"RATSENBERG, BORIS",2,1,1
5521,3087570081,BK,1608 SHORE BOULEVARD,01,A1,"SHAPIRO, DMITRIY",2,1,1
5522,4000067501,QN,1-55 BORDEN AVENUE,04,RM,UNAVAILABLE OWNER,2,1,1
5523,4004610009,QN,42-33 9 STREET,06,F4,9TH ST 43RD LLC,2,1,1
5524,4005210053,QN,33-47 13 STREET,01,B1,WOLFANG LUBO,2,1,1
5525,4005670005,QN,23-49 BROADWAY,04,S2,"LAUCELLA, AS EXECUTOR, ROBERT",2,1,1
5526,4006040006,QN,35-45 31 STREET,02,C0,MOUTAFIS PETER,2,1,1
5527,4006290017,QN,35-02 28 AVENUE,04,S4,C P G REALTY INC,3,2,1
5528,4006790068,QN,31-66 42 STREET,01,A1,"SHEPP JR, MICHAEL L",2,1,1
5529,4006790069,QN,31-68 42 STREET,02,C0,PETRUSO GIROLAMA,2,1,1
5530,4007020025,QN,25-47 43 STREET,01,B2,EDGAR CARHUAPOMA,3,2,1
5531,4008490022,QN,20-55 28 STREET,01,B1,REZ PROPERTIES INC.,2,1,1
5532,4008670006,QN,22-67 24 STREET,01,A5,"CUOZZO, KIM",2,1,1
5533,4008750013,QN,23-73 23 STREET,01,B1,SAKKAS ANASTASIOS,2,1,1
5534,4008750018,QN,23-61 23 STREET,02,C0,"WALD, ELLIE",2,1,1
5535,4011340033,QN,31-16 58 STREET,02,C0,"ZHANG , JIE",2,1,1
5536,4013040053,QN,40-24 73 STREET,02,C0,"LIU, ANSON",2,1,1
5537,4013550007,QN,72-06 44 AVENUE,02,C0,72-02 44TH AVENUE LLC,2,1,1
5538,4013680043,QN,25-21 94 STREET,01,B3,ANGEL O SINCHI,2,1,1
5539,4014820027,QN,37-36 95 STREET,01,B2,"ONIZAWA-PRASAD, RIE",2,1,1
5540,4015630001,QN,41-49 BENHAM STREET,08,N9,URBAN RESOURCE INSTITUTE,2,1,1
5541,4015900033,QN,94-25 41 ROAD,01,A5,"RODRIGUEZ, MARIA CHRISTINA",2,1,1
5542,4016120020,QN,96-20 42 AVENUE,01,B3,RUILOVA FREDDY,2,1,1
5543,4016590030,QN,27-42 MCINTOSH STREET,01,B1,BPS37 MANAGEMENT INC,2,1,1
5544,4017140013,QN,33-18 100 STREET,01,B1,"ASTORIA REAL ESTATE SERVICE, INC.",2,1,1
5545,4017420042,QN,35-25 101 STREET,01,B2,"GAGUANCELA, SEGUNDOM",2,1,1
5546,4018350083,QN,87-19 51 AVENUE,02,C0,UNAVAILABLE OWNER,2,1,1
5547,4018540018,QN,90-40 52 AVENUE,02,C0,"PAGUAY , NELLY  E",2,1,1
5548,4018670065,QN,51-19 92 STREET,02,C0,51-19 LLC,2,1,1
5549,4018870045,QN,50-28 96 STREET,02,C0,"LIU, WU",2,1,1
5550,4018950048,QN,53-36 96 STREET,01,A5,"ZENG, ZHAO SONG",2,1,1
5551,4019060017,QN,55-17 97 PLACE,01,A1,"LIAO, WUBIN EMERSON",2,1,1
5552,4019340013,QN,50-27 103 STREET,02,C0,"DIAZ, LUIS",2,1,1
5553,4020080067,QN,108-29 53 AVENUE,02,C3,PINA  JOSE A,2,1,1
5554,4022310025,QN,110-40 JEWEL AVENUE,01,A3,"PINCHASOW, EDUARD",2,1,1
5555,4022400050,QN,112-29 68 DRIVE,01,A7,"BOROCHOV, REUVEN",2,1,1
5556,4023180037,QN,5804 47 AVENUE,02,C0,"CHANG, JAE OK",2,1,1
5557,4023220001,QN,59-50 61 STREET,03,D4,BIG SIX TOWERS INC,3,2,1
5558,4023960056,QN,66-40 HULL AVENUE,01,A1,RAYMOND M MCGARVEY,2,1,1
5559,4024350007,QN,49-07 69 STREET,06,E2,49-07 69TH HOLDINGS LLC,2,1,1
5560,4024850049,QN,73-27 52 AVENUE,01,A5,"CHIN, BENZ",2,1,1
5561,4024920302,QN,52-37 79 STREET,01,B1,WAH PO YU,2,1,1
5562,4025010041,QN,69-45 GRAND AVENUE,04,S2,ANTZOULIS FAMILY LIMITED PARTNERSHIP,2,1,1
5563,4026310008,QN,59-15 56 STREET,11,V1,BRENDAN LAWLESS,2,1,1
5564,4027380002,QN,58-35 60 LANE,01,B2,DANIEL ZWICK AS TRUSTEE,2,1,1
5565,4027720062,QN,62-44 65 STREET,01,A5,MORRISROE  THOMAS,2,1,1
5566,4027800028,QN,59-78 68 STREET,01,B1,"PIAZZA, BARBARA",2,1,1
5567,4028080068,QN,72-24 57 AVENUE,01,B1,"LIN, QIU QIN",2,1,1
5568,4028750001,QN,85-01 52 AVENUE,01,B2,"LUU, CINDY NGO",2,1,1
5569,4030500041,QN,66-66 70 STREET,01,A2,"LUGO, MAGALY",2,1,1
5570,4032480071,QN,64 GROTON STREET,01,A3,LIOR EVAN,2,1,1
5571,4034730065,QN,871 ONDERDONK AVENUE,04,S4,RC CH OF ST MATTHIAS,2,1,1
5572,4034770051,QN,1933 GATES AVENUE,01,B2,CHROSTOWSKI JOZEF,2,1,1
5573,4035550051,QN,1676 SUMMERFIELD STREET,02,C0,"ALTAGRACIA NUNEZ, JOSEFINA",2,1,1
5574,4035670054,QN,1727 DECATUR STREET,01,B2,GONZALEZ  ARELIS,2,1,1
5575,4035680021,QN,1712 DECATUR STREET,01,B2,JOBALU RIDGEWOOD LLC,2,1,1
5576,4037230051,QN,78-29 64 LANE,01,A1,"MCNAMARA, JAMES",2,1,1
5577,4037950031,QN,69-42 78 STREET,01,B2,NATALE AMMIRATI,2,1,1
5578,4038130071,QN,77-21 75 STREET,01,A5,"ZUKOWSKI, PAWEL",2,1,1
5579,4038270053,QN,78-51 78 STREET,01,B3,JOHN A KONDRICK,2,1,1
5580,4038860864,QN,87-09 69 AVENUE,01,A1,JOHN F BERNARDONE,2,1,1
5581,4038920043,QN,87-10 69 AVENUE,01,A1,"HAVASOV, ADUARD",2,1,1
5582,4039330010,QN,8-01 115 STREET,01,A1,"SHI, YANLAN",2,1,1
5583,4039690042,QN,10-02 125 STREET,01,A9,STEVE R LAURITANO,3,2,1
5584,4041330001,QN,127-03 20 AVENUE,05,HH,127-03 20TH AVE LLC,3,2,1
5585,4041990032,QN,22-30 124 STREET,01,B2,"CHAN, IEONG",2,1,1
5586,4046320025,QN,146-41 20 ROAD,01,B1,"SYMON, MARYANN",2,1,1
5587,4047980096,QN,146-33 32 AVENUE,01,A1,"KUMAR, ARUN",2,1,1
5588,4049730001,QN,133-11 ROOSEVELT AVENUE,07,G4,ALLIANCE ENERGY LLC,2,1,1
5589,4049960074,QN,34-04 148 STREET,01,B1,"JOHANNA H. LIN, AS CO-TRUSTEE",2,1,1
5590,4050120060,QN,143-35 37 AVENUE,08,P7,NYC DEPARTMENT OF PARKS AND RECREATION,2,1,1
5591,4050760001,QN,49-04 COLLEGE POINT BLVD,07,G3,BP PRODUCTS NORTH AMERICA INC,2,1,1
5592,4051190011,QN,56-41 135 STREET,02,C0,"GIUNTA, SANTINA",2,1,1
5593,4051490042,QN,137-63 KALMIA AVENUE,01,A1,"MARGHOOB, AMNA D",2,1,1
5594,4052000151,QN,45-35 KISSENA BOULEVARD,03,D3,SELFHELP/UNITED HELP KISSENA,2,1,1
5595,4052090029,QN,46-53 UNION STREET,01,B1,"ZHENG, KE TAI",2,1,1
5596,4052780009,QN,40-21 159 STREET,05,O5,4021 PLAZA LLC,2,1,1
5597,4052960045,QN,36-19 169 STREET,01,B1,"CHEN, BI ZHEN",2,1,1
5598,4054870033,QN,157-18 LABURNUM AVENUE,01,A2,"KENNEDY, GERALD P",2,1,1
5599,4055100068,QN,171-43 45 AVENUE,01,A0,KIM TO CHUNG,2,1,1
5600,4056170022,QN,47-15 197 STREET,01,B1,"LEE, CIN FUK",2,1,1
5601,4057400053,QN,163-51 19 AVENUE,01,A0,EUGENE MCQUAID,2,1,1
5602,4061070005,QN,210-10 33 ROAD,01,A1,"GLIKAKIS, FEDON",2,1,1
5603,4061540001,QN,205-04 36 AVENUE,01,A1,GIANNIKIOS EMMANUEL,2,1,1
5604,4061560019,QN,35-26 208 STREET,01,A1,"LEE, PHOEBE",2,1,1
5605,4062000001,QN,38-35 204 STREET,01,A1,"ZINK, TERRY",2,1,1
5606,4062150002,QN,208-08 41 AVENUE,02,C9,BAYSIDE GARDENS LLC,13,12,1
5607,4063520073,QN,130-03 58 AVENUE,01,B1,"WINTECH REALTY, LLC",2,1,1
5608,4063950046,QN,63-31 136 STREET,01,A1,PERRONE ANTHONY,2,1,1
5609,4064840002,QN,138-40 JEWEL AVENUE,02,C6,JOYCE EQUITIES INC,28,27,1
5610,4068950050,QN,61-26 168 STREET,01,B1,HER-YIH JOU,2,1,1
5611,4069210027,QN,67-17 167 STREET,01,A1,"BABAISAKOV, EDUARD",2,1,1
5612,4071820059,QN,73-43 195 STREET,01,A1,ELBERG MICHAEL,2,1,1
5613,4073060024,QN,206-44 45 ROAD,02,C0,"MA, JACK JUNXIAN",2,1,1
5614,4073610027,QN,48-44 203 STREET,01,A1,"HUANG, QUAN ZHUANG",2,1,1
5615,4077540047,QN,220-21 77 AVENUE,01,A1,"ABRAMOV, ILER",2,1,1
5616,4078700001,QN,79-25 WINCHESTER BOULEVARD,08,I1,CREEDMOOR PSYCH CNTR,4,3,1
5617,4080370038,QN,372 BEVERLY ROAD,01,A1,CAROL BELLOMO,2,1,1
5618,4080470007,QN,210 HOLLYWOOD AVENUE,01,A1,"BURKE, BRIAN",2,1,1
5619,4081160116,QN,42-64 247 STREET,01,A5,PATRICIA MULHALL,2,1,1
5620,4081190023,QN,42-34 248 STREET,01,B1,"SHIN, SONG CHOL",2,1,1
5621,4082330436,QN,50-15 MORENCI LANE,01,A2,"COYLE, PATRICK J",2,1,1
5622,4082867503,QN,240-02 70 AVENUE,02,R3,HIGHPOINT AT DOUGLASTON CONDO,21,20,1
5623,4085850024,QN,82-38 LITTLE NECK PARKWAY,01,A2,"HAQUE, LAILA",2,1,1
5624,4086620050,QN,247-39 JERICHO TURNPIKE,05,K2,247 JAMAICA LLC,2,1,1
5625,4086670019,QN,250-16 88 ROAD,01,B1,"TOOR, SUKHDEEP",2,1,1
5626,4087870030,QN,84-50 258 STREET,01,A1,"CHUNG, OI LING",2,1,1
5627,4089100001,QN,78-14 88 ROAD,01,B2,"RODRIGUEZ, DANNY",2,1,1
5628,4089750064,QN,94-02 89 AVENUE,01,B2,OSCAR NUNEZ,2,1,1
5629,4090660012,QN,97-12 93 STREET,02,C0,KAMBOURAS DEMETRIS,2,1,1
5630,4091510014,QN,107-18 89 STREET,01,A1,"CALIO, SALVATORE",2,1,1
5631,4093120039,QN,104-55 93 AVENUE,01,B2,"MARTINEZ, YANIRA",2,1,1
5632,4093940023,QN,108-09 97 AVENUE,02,C0,"JANJUA, HARVINDER",2,1,1
5633,4094070023,QN,97-38 106 STREET,01,B2,SHAHID HANIF,2,1,1
5634,4094160042,QN,95-72 115 STREET,01,B3,NORFOLK ESTATES LLC,2,1,1
5635,4094260041,QN,108-05 103 AVENUE,01,B3,"BOODHU, BUPENDRA",2,1,1
5636,4094650013,QN,97-14 125 STREET,02,C0,"AKHTER, ZULEKHA",2,1,1
5637,4094670014,QN,95-18 127 STREET,01,B3,PERMANAND BAJNAUTH AS TRUSTEE,2,1,1
5638,4095250031,QN,107-04 103 STREET,01,B3,RUSSIF ZAHUR,2,1,1
5639,4095420039,QN,107-47 104 STREET,01,A1,GRANNUM  GEORGE,3,2,1
5640,4095490072,QN,107-19 111 STREET,01,B3,BIBI YUSUFF,2,1,1
5641,4095900046,QN,130-09 107 AVENUE,01,A1,"RAHAMAN, ABDUL",2,1,1
5642,4095940006,QN,105-16 135 STREET,01,B3,"LACHHMAN, RAJWANTI",3,2,1
5643,4096150062,QN,107-39 135 STREET,01,B2,"SINGH, SANGAT",3,2,1
5644,4097000001,QN,139-26 87 AVENUE,02,C0,"DHALIWAL, BALDEEP S",2,1,1
5645,4097070020,QN,150-40 87 AVENUE,02,C0,"KHAN, NADIA",2,1,1
5646,4097830019,QN,84-48 160 STREET,01,A1,GEORGE KAROUSOS,2,1,1
5647,4097920073,QN,161-44 84 AVENUE,07,U9,NYC DEPARTMENT OF ENVIRONMENTAL PROTECTION,3,2,1
5648,4098020027,QN,90-19 169 STREET,02,C3,"KARMAKAR, JOY GOPAL",2,1,1
5649,4098990033,QN,90-23 181 STREET,01,A1,BLANDINE LOUISSAINT,2,1,1
5650,4101150045,QN,156-25 LIBERTY AVENUE,06,F5,NYC HOUSING PRESERVATION AND DEVELOPMENT,2,1,1
5651,4102670017,QN,109-35 175 STREET,01,A1,"DHANSAR, SANJAY",2,1,1
5652,4102760013,QN,110-36 178 STREET,01,A1,"DIALLO, ALPHA OUMAR SANKARELLA",2,1,1
5653,4103000004,QN,112-59 177 STREET,01,A1,"HAYES, MARVA V",2,1,1
5654,4103720020,QN,186-16 104 AVENUE,01,A1,"ALSTON, MARY",2,1,1
5655,4104670018,QN,196-21 90 AVENUE,01,A3,"RAMCHAND, ANITA",2,1,1
5656,4105090123,QN,191-28 PALO ALTO AVENUE,01,A1,"OLSEN, ALEXANDER",2,1,1
5657,4105230057,QN,193-19 85 ROAD,01,A2,"ILLOVSKY, CATHERINE",2,1,1
5658,4105510047,QN,93-40 210 PLACE,01,A1,"WRIGHT, VALERY J",2,1,1
5659,4105560061,QN,90-28 207 STREET,01,A1,"SURUJLAL, ALSOLAMADIN B.",2,1,1
5660,4105580060,QN,90-36 209 STREET,01,A1,HENRY A RIVERA,2,1,1
5661,4106530062,QN,89-32 212 PLACE,01,A1,"DEGUIA, DANILO P.",2,1,1
5662,4108310051,QN,94-32 201 STREET,01,A1,"LEITE, REGINA",2,1,1
5663,4109430228,QN,109-98 204 STREET,01,A1,"DUNN, BALVIN G",3,2,1
5664,4109510086,QN,190-36 111 ROAD,01,A1,"LEWIS, RALSTON",2,1,1
5665,4110030153,QN,113-06 208 STREET,01,A1,"DAVIS , WINIFRED  L",2,1,1
5666,4110330009,QN,115-31 FARMERS BOULEVARD,01,B2,"JEGEDE, JOSEPHINE P.",2,1,1
5667,4110400025,QN,115-29 199 STREET,01,A1,"CHARDAVOINE, MARTHE",2,1,1
5668,4110420122,QN,115-58 202 STREET,01,A1,"MCFARLANE, JUNETH",3,2,1
5669,4110440054,QN,115-34 204 STREET,01,A5,"GARCIA JONES, NORMA",2,1,1
5670,4110540006,QN,211-20 115 AVENUE,01,B1,GREATER ZION DELIVERANCE TABERNACLE,2,1,1
5671,4110740062,QN,116-12 203 STREET,01,B3,"MARTEN, RAFAEL",2,1,1
5672,4110940021,QN,102-06 217 PLACE,01,B3,OLGA PUCKERIN,2,1,1
5673,4110990037,QN,214-08 104 AVENUE,01,B3,"SUKHU, MOHABIR",2,1,1
5674,4111040118,QN,217-16 104 AVENUE,01,A1,"KENNEDY, MARIE",2,1,1
5675,4113200020,QN,116-27 219 STREET,01,A1,"SHINE,  BENJAMIN",2,1,1
5676,4115310051,QN,137-11 95 STREET,01,A1,"HUEZO, ANTHONY R",2,1,1
5677,4117130028,QN,116-25 120 STREET,01,A1,"ALI, NAZIA",2,1,1
5678,4119470294,QN,147-25 FERNDALE AVENUE,01,A2,"REYNOLDS, BARBARA",2,1,1
5679,4120070209,QN,116-58 148 STREET,01,A1,"HSBC BANK USA, N.A., AS TRUSTEE",2,1,1
5680,4120260057,QN,119-06 146 STREET,01,A1,"NEHORALALL, OLAV",2,1,1
5681,4120560009,QN,140-12 ROCKAWAY BOULEVARD,04,S2,DAVID HAUGHTON,2,1,1
5682,4121410022,QN,109-44 153 STREET,01,A5,"SAMUEL, GALE",2,1,1
5683,4121990006,QN,159-10 115 ROAD,01,A2,JONES DONNA E,2,1,1
5684,4122030015,QN,150-78 116 DRIVE,01,B3,"HUNTER, JEANETTE",2,1,1
5685,4122090152,QN,118-30 155 STREET,01,A9,11830 155TH STREET CORP,2,1,1
5686,4124790043,QN,176-17 SUNBURY ROAD,01,A2,"JOHNSON, BETTY",2,1,1
5687,4125480044,QN,176-04 133 ROAD,08,M1,CONG JEHOVAHS WITNESS,2,1,1
5688,4125680014,QN,134-51 173 STREET,01,A2,"RIDLEY, TRACEY",2,1,1
5689,4126010042,QN,190-07 117 ROAD,01,A1,"RAMOUTAR, CLINT",2,1,1
5690,4126330020,QN,117-30 204 STREET,01,A5,"CADET, KATIA A",2,1,1
5691,4126440049,QN,119-41 FARMERS BOULEVARD,01,B3,ROCKAWAY STORAGE INC,2,1,1
5692,4126530058,QN,119-11 197 STREET,01,B3,"ABRAHAM, ANTHONY",2,1,1
5693,4126600030,QN,119-19 203 STREET,01,A1,"BROWN , NORMA",2,1,1
5694,4129730023,QN,233-10 133 AVENUE,01,A2,"MCLEOD, GEORGETTE P",2,1,1
5695,4130480040,QN,179-31 142 AVENUE,01,B2,"MILLERY, ANN MARIE",2,1,1
5696,4130690024,QN,142-40 224 STREET,01,A2,DAVID OPONT,2,1,1
5697,4131530008,QN,226-05 141 AVENUE,01,A5,"SALES, BETTY JEAN",2,1,1
5698,4131610024,QN,134-21 233 STREET,01,B3,"WILLS, MICHAEL",2,1,1
5699,4134670068,QN,145-84 220 STREET,01,A2,DENVER LLC,2,1,1
5700,4134940092,QN,144-40 225 STREET,01,B3,ETHLIN ATKINSON,2,1,1
5701,4135060205,QN,228-14 EDGEWOOD AVENUE,01,B2,"CLARKE, PAULETTE",2,1,1
5702,4137500166,QN,147-83 EDGEWOOD STREET,01,B3,"MCKENZIE, RICHARD G JR",2,1,1
5703,4139210036,QN,23 1 STREET,01,A2,BARNEY SABELLA JR,2,1,1
5704,4139620107,QN,157-25 82 STREET,01,A1,"PAVIS , ROBERT  E",2,1,1
5705,4139900028,QN,158-48 92 STREET,01,A0,WILLIAM RUIZ,2,1,1
5706,4155270015,QN,21-23 BIRDSALL AVENUE,04,S3,FIRST CHURCH OF GOD,2,1,1
5707,4157140129,QN,10-41 MCBRIDE STREET,02,C0,"ROMERO, JOSE  V",2,1,1
5708,4157710011,QN,530 BRIAR PLACE,03,D1,BRIAR OWNERS LLC,2,1,1
5709,4159670022,QN,423 BEACH 44 STREET,01,A1,"KOLAWOLE, EUNICE",2,1,1
5710,4160500010,QN,69-43 ELIZABETH AVENUE,01,A2,NATIONSTAR MORTGAGE LLC,2,1,1
5711,4160810035,QN,311 BEACH 69 STREET,02,C0,311 BEACH 69TH CORP,2,1,1
5712,4162370075,QN,144 BEACH 128 STREET,02,C0,"144 BEACH ASSOCIATES, LLC",2,1,1
5713,4162600029,QN,4-25 BEACH 137 STREET,02,C0,"WEINGARTEN, DEBORAH",2,1,1
5714,4162780006,QN,133-09 ROCKAWAY BEACH BLVD,01,B1,ELLEN RATNER FAMILY TRUST,2,1,1
5715,5001060041,SI,62 BRIGHTON AVENUE,01,B1,ANTHONY RONDINELLI,2,1,1
5716,5001190099,SI,259 CASTLETON AVENUE,01,B2,SCOT PRENDERGAST,2,1,1
5717,5001320336,SI,12 ABBY PLACE,01,A1,"OCCHIPINTI, VINCENT",2,1,1
5718,5001340004,SI,467 BARD AVENUE,01,A1,FARRELL SUZANNE,2,1,1
5719,5001390014,SI,151 N ST AUSTINS PLCE,08,M1,CORPORATION OF THE PRESIDING BISHOP OF T HE CHURCH,2,1,1
5720,5001400014,SI,21 ST AUSTINS PLACE,01,A1,"GUSTAFSSON, MARY E",2,1,1
5721,5001490093,SI,98 DAVIS AVENUE,01,B9,"J. HELMS PROPERTIES, LLC",2,1,1
5722,5001500219,SI,164 PELTON AVENUE,01,A1,"CANAVAN, COLLEEN A",2,1,1
5723,5001650139,SI,392 SHEFFIELD STREET,01,A1,"HUDSON, AMY",2,1,1
5724,5001800075,SI,41 SENECA STREET,01,B2,ANTHONY B. EBISIKE,2,1,1
5725,5002240105,SI,287 MYRTLE AVENUE,01,A1,"MORA, LINETTE",2,1,1
5726,5002460056,SI,1197 CLOVE ROAD,01,A1,1197 CLOVE LLC,2,1,1
5727,5002510041,SI,230 HART BOULEVARD,01,A1,SUSAN C OBRIEN,2,1,1
5728,5002520101,SI,313 SHARON AVENUE,01,B2,JOSEPH MEAGHER,2,1,1
5729,5002920019,SI,16 NUTLY PLACE,01,A1,WILLIAM J. LAVASSEUR,2,1,1
5730,5003130053,SI,47 WEST RALEIGH AVENUE,01,A1,ARNOLD P OLSEN,2,1,1
5731,5003170018,SI,46 EGBERT AVENUE,01,A1,"TIERNEY, PATRICK A",3,2,1
5732,5003890101,SI,79 BURNSIDE AVENUE,01,A1,"CONTI, LOIS",2,1,1
5733,5004140013,SI,110 WOOLLEY AVENUE,01,A1,"VAUTRINOT, RYAN E",2,1,1
5734,5004770058,SI,200 BRYSON AVENUE,01,A2,"DEFRANCESCO, ASSUNTA",2,1,1
5735,5005290041,SI,13 TOMPKINS STREET,01,A1,"ZAPANTA, RIZALITO",3,2,1
5736,5005650051,SI,174 TARGEE STREET,05,O7,174 TARGEE ST LLC,2,1,1
5737,5005790033,SI,340 VICTORY BOULEVARD,04,K4,MILIHA ELEZ DEDOVIC,2,1,1
5738,5006140150,SI,640 VAN DUZER STREET,01,A2,"ZHANG, MING",2,1,1
5739,5006230110,SI,5 CUNARD AVENUE,01,A5,"MULLINGS, SAMUEL",2,1,1
5740,5006590043,SI,73 CAYUGA AVENUE,02,C0,"FIGUEIRA, FRANCISCO",2,1,1
5741,5007070243,SI,663 MANOR ROAD,08,W2,ST JOHN'S EVANGELICAL LUTHERAN CHURCH OF,3,2,1
5742,5007090039,SI,15 JOSEPHINE STREET,01,B2,"LJUBANOVIC, VJOLLCA",2,1,1
5743,5007410019,SI,28 ARDMORE AVENUE,01,A2,MARIANNE BARBIERI,3,2,1
5744,5007670010,SI,41 LIVINGSTON AVENUE,01,A1,"SYMACHEN, KUNJU- KUNJU",2,1,1
5745,5008560024,SI,96 VISTA AVENUE,01,A1,"QOKU, FATOS",2,1,1
5746,5008690583,SI,105 DELAWARE STREET,01,A1,DIVI TRUST,2,1,1
5747,5010060089,SI,51 ANN STREET,01,A5,"BIRCH, MICHAEL",2,1,1
5748,5010380018,SI,1054 POST AVENUE,01,A1,"APONTE, ROSA F",2,1,1
5749,5010410019,SI,85 CATHERINE STREET,01,A1,DEAN MARSAC,2,1,1
5750,5010480076,SI,43 RAINBOW AVENUE,01,A1,"LORENZO, SOFRONIO",2,1,1
5751,5010870031,SI,93 NICHOLAS AVENUE,01,B2,CATO ROBIN L,2,1,1
5752,5010960024,SI,15 GROVE PLACE,01,B2,FRANCINE JOYNER,2,1,1
5753,5011240012,SI,133 EATON PLACE,01,B1,"NAJJAR, DEVON",2,1,1
5754,5011320038,SI,485 VILLA AVENUE,01,B2,R HAFNER,2,1,1
5755,5011320046,SI,602 PORT RICHMOND AVENUE,08,W2,RC CHURCH ST ROCH,5,4,1
5756,5011590076,SI,26 WRIGHT AVENUE,01,A1,"CRUZ, JAMIE",2,1,1
5757,5012360142,SI,91 LOCKMAN AVENUE,01,A1,WANDA RICHARDSON,2,1,1
5758,5012540105,SI,22 GRANDVIEW AVENUE,01,B2,"ALMAZO, FRANCISCO F",2,1,1
5759,5014000001,SI,5805 HYLAN BOULEVARD,07,Y7,PORT AUTHORITY OF NY AND NJ,4,3,1
5760,5014410016,SI,51 BRYSON AVENUE,01,B1,"COSCIA, MARK F",2,1,1
5761,5014810215,SI,244 WILLOWBROOK ROAD,01,A2,"DITORE, LOUIS C",2,1,1
5762,5015257503,SI,491 WILLOW ROAD EAST,02,R3,JEFFREY HAND,31,30,1
5763,5015600055,SI,1583 RICHMOND AVENUE,05,O7,FRANK V & ROSE M PONTERIO,2,1,1
5764,5019920021,SI,36 ANJALI LOOP,01,B9,Sophia Leung,2,1,1
5765,5021150132,SI,69 PLYMOUTH ROAD,01,B9,CIANFRONE IRREVOCABLE LIVING TRUST,2,1,1
5766,5021620192,SI,3555 VICTORY BOULEVARD,05,K6,TOP TOMATOE PLAZA LL,3,2,1
5767,5026200043,SI,78 TOWERS LANE,01,A5,"LIU, QING JIANG",2,1,1
5768,5026290063,SI,33 MILDRED AVENUE,01,A1,CRAIG HARTY,2,1,1
5769,5028290104,SI,73 HYLAN BOULEVARD,01,A1,MARIA DINATALE,4,3,1
5770,5028320012,SI,1329 BAY STREET,01,A1,PROT EPIS CHUR ST JOH,2,1,1
5771,5028790131,SI,49 MARY STREET,01,A1,"RAZAK, ROOKMIN",2,1,1
5772,5029060035,SI,729 TARGEE STREET,01,A1,"MASSA, CARMELITA",2,1,1
5773,5030760002,SI,16 BROWN PLACE,01,A1,"AVERACK, PATRICIA ANN",2,1,1
5774,5031110048,SI,188 CEDAR AVENUE,01,B1,"KOLACZKO, PETER",3,2,1
5775,5031600001,SI,2062 CLOVE ROAD,04,K4,GAETANO DEMETRIO,3,2,1
5776,5032740009,SI,33 PIAVE AVENUE,01,B2,"LILOV, MICHAEL",2,1,1
5777,5033550001,SI,631 FATHER CAPODANNO BLVD,08,I1,NYC DEPARTMENT OF PARKS AND RECREATION,18,17,1
5778,5035960006,SI,2198 RICHMOND ROAD,02,C1,MATRAND LLC,3,2,1
5779,5037020050,SI,301 SANILAC STREET,01,A5,"DERVISEVIC, ELVIS",2,1,1
5780,5037910006,SI,557 HUNTER AVENUE,01,A6,"JATA, ARTANA",2,1,1
5781,5038010033,SI,1057 OLYMPIA BOULEVARD,01,A5,"MENG, YUEMEI",2,1,1
5782,5038050004,SI,53 MAPLETON AVENUE,01,A5,SHERMAN&RUBY LEE,2,1,1
5783,5038390032,SI,737 OCEANSIDE AVENUE,01,A1,WILLIAM J JANKUNIS,2,1,1
5784,5040540056,SI,27 MANILA PLACE,01,A1,"PUCCIARELLO, WILLIAM",2,1,1
5785,5043710041,SI,34 WOLVERINE STREET,01,B2,"VELEZ, SAMUEL",2,1,1
5786,5044210142,SI,102 WEST CEDARVIEW AVE,01,A1,"DIACO, MICHAEL",2,1,1
5787,5044780266,SI,179 COTTER AVENUE,01,A5,"TORSNEY, JAMES",2,1,1
5788,5046960030,SI,3240 AMBOY ROAD,01,B2,"BONILLA, JOSEPH",2,1,1
5789,5051500033,SI,79 GRANDVIEW TERRACE,01,A3,NELSON KIM  HOU  AUYEUNG AS TRUSTEE,2,1,1
5790,5051580051,SI,271 NELSON AVENUE,01,A1,RICHARD T PASCONE,2,1,1
5791,5052230025,SI,4158 AMBOY ROAD,01,A1,FAITH BEISER,3,2,1
5792,5052620135,SI,201 HILLCREST STREET,01,A2,KUCHMAN JOSEPH,2,1,1
5793,5055180045,SI,268 GENESEE AVENUE,01,A2,"CICALO, MARGARET",2,1,1
5794,5056150007,SI,20 STUYVESANT AVENUE,01,A2,VINCENT MAZZELLA,2,1,1
5795,5056940053,SI,32 DETROIT AVENUE,01,B2,"LIN, QIANG",2,1,1
5796,5060850125,SI,21 DAHLIA STREET,01,B2,CROCIFISSO CARUSO,2,1,1
5797,5062210018,SI,1020 ARDEN AVENUE,01,B3,"CIECIORKO, MARIUSZ",2,1,1
5798,5062220054,SI,11 LORRAINE AVENUE,01,A1,"CUSICK, SEAN",2,1,1
5799,5064540010,SI,488 PHILIP AVENUE,01,A3,SVETLANA LUSHER,2,1,1
5800,5066650075,SI,47 VAN WYCK AVENUE,01,B2,PANNONE RAYMOND,2,1,1
5801,5066940229,SI,181 TRENTON COURT,01,A1,WALTER NEIL,2,1,1
5802,5070417501,SI, GERVIL STREET,02,R3,FAWN RIDGE CONDOMINIUM II,110,109,1
5803,5073110012,SI,29 STORER AVENUE,04,S1,"GRASSO, JOSEPH",2,1,1
5804,5075340120,SI,86 STATION AVENUE,01,A1,DONMALD SHULER,2,1,1
5805,5075720089,SI,55 MADSEN AVENUE,01,B2,COLLEEN MAGUIRE,2,1,1
5806,5075770106,SI, WEINER STREET,11,V0,"CRISPI, PATRICIA",2,1,1
5807,5079640026,SI,21 TOTTENVILLE PLACE,01,A1,"WALLA, GARY",2,1,1
5808,5080010024,SI,72 TYRRELL STREET,01,B3,"KASSAB, MAHMOUD",3,2,1
5809,5080490011,SI,7601 AMBOY ROAD,01,B2,"BANOME, ROBERT",2,1,1
5810,1006150014,MN,266 WEST 12 STREET,01,A4,ANDICA KUNST,2,1,1
5811,1006410063,MN,345 WEST 12 STREET,02,C4,345 WEST 12TH STREET LLC,2,1,1
5812,1007630043,MN,302 WEST 40 STREET,02,C4,302 WEST 40TH STREET LLC,2,1,1
5813,1008290045,MN,6 WEST 28 STREET,05,O5,JTRE NOMAD 8 W 28TH LLC,2,1,1
5814,1009620050,MN,500 EAST 30 STREET,05,K5,NYC DEPARTMENT OF SMALL BUSINESS SERVICES,3,2,1
5815,1010560136,MN,402 WEST 47 STREET,04,C7,FRANZBLAU TRUST HOLDINGS - 402 W.47TH ST REET LLC,2,1,1
5816,1012040016,MN,35 WEST 90 STREET,03,D4,35 WEST 90 OWNERS CORPORATION,2,1,1
5817,1013100034,MN,916 3 AVENUE,04,C7,916-918 THIRD AVENUE,2,1,1
5818,1013450041,MN,326 EAST 53 STREET,04,D6,THE ANIMAL MEDICAL CENTER,2,1,1
5819,1013750001,MN,790 5 AVENUE,05,H5,THE METROPOLITAN CLUB INC,2,1,1
5820,1014967502,MN,1010 PARK AVENUE,08,RA,UNAVAILABLE OWNER,2,1,1
5821,1015300023,MN,1623 2 AVENUE,04,S5,NR SECOND AVENUE/EAST 47TH STREET LLC,2,1,1
5822,1016880035,MN,336 EAST 117 STREET,02,C1,336 EAST 117TH STREET REALTY 2013 LLC,2,1,1
5823,2023310012,BX,284 EAST 150 STREET,05,O2,"GUARDSMAN ELEVATOR CO., INC",2,1,1
5824,2023400110,BX,329 CANAL PLACE,10,G1,IESI NY CORPORATION,2,1,1
5825,2024360021,BX,300 EAST 169 STREET,02,C0,MARIA I ODOCHA,2,1,1
5826,2025120057,BX,1026 NELSON AVENUE,01,A1,"VIVAR, JULIO B",2,1,1
5827,2027620365,BX,1399 LAFAYETTE AVENUE,08,P5,THE POINT COMMUNITY DEVEL CORP,6,5,1
5828,2027680295,BX,1264 RANDALL AVENUE,07,G3,1264 RANDALL AVENUE H,2,1,1
5829,2030160033,BX,1916 LONGFELLOW AVENUE,01,A1,1916 LONGFELLOW AVE LLC,2,1,1
5830,2030970006,BX,2130 CLINTON AVENUE,01,A5,"SALADINI, JOSE A.",2,1,1
5831,2031650024,BX,2420 CRESTON AVENUE,02,C1,FORDHAM FIVE ASSOCIATES,2,1,1
5832,2032220040,BX,2075 UNIVERSITY AVENUE,08,W5,BRONX COMMUNITY COLLEGE,3,2,1
5833,2032710225,BX,3811 REVIEW PLACE,02,C3,GANESH PERSAUD AND ZEROLENE PERSAUD REVO CABLE,2,1,1
5834,2034327505,BX,192 HERON LANE,02,R3,UNAVAILABLE OWNER,82,81,1
5835,2034530057,BX,1505 HARDING PARK,01,A2,"JEAN, WALLACE",2,1,1
5836,2035120018,BX,436 TURNEUR AVENUE,01,B1,LACHHMANEN VEERA,2,1,1
5837,2037590009,BX,1114 WHITE PLAINS ROAD,04,S5,"SHAO ZHU SU, AS TRUSTEE",2,1,1
5838,2037680078,BX,1205 VIRGINIA AVENUE,01,A1,"RABBANI, GOLAM",2,1,1
5839,2037740038,BX,1264 BOYNTON AVENUE,02,C3,"BHARRAT , MOHABIR",2,1,1
5840,2038450038,BX,2417 HALSEY STREET,02,C0,"PEREZ, CLARA REYES",3,2,1
5841,2038780047,BX,1333 THIERIOT AVENUE,01,A1,RIVERA JOSEPHINE,2,1,1
5842,2039000002,BX,1402 TAYLOR AVENUE,01,B2,"BUDRAJ, JOSEPH",2,1,1
5843,2039650011,BX,1432 DORIS STREET,04,C7,MAG PROPERTIES III LLC,2,1,1
5844,2039660010,BX,2206 STARLING AVENUE,01,B2,"COSTELLO, CAROL",2,1,1
5845,2039900022,BX,1603 PARKER STREET,02,C2,"PESCE, ALFONSO",2,1,1
5846,2041100019,BX,1713 WILLIAMSBRIDGE ROAD,02,C0,"CHRISTOPHER, GERALD",2,1,1
5847,2042310013,BX,1928 MULFORD AVENUE,01,B3,"ZHANG, BRIAN",3,2,1
5848,2044770044,BX,2445 EASTCHESTER ROAD,01,A2,"PACELLI, OLGA",2,1,1
5849,2045110016,BX,2732 HOLLAND AVENUE,01,A1,FIRST KEY HOME NY LLC,2,1,1
5850,2045140009,BX,2724 MATTHEWS AVENUE,01,B1,"MINAYA, ROSEMARY",2,1,1
5851,2045490019,BX,3006 WILLIAMSBRIDGE ROAD,08,P9,BRONX JEWISH COMMUNITY COUNCIL INC,2,1,1
5852,2047080023,BX,1147 EAST 213 STREET,01,A5,HERMAN WHITE,2,1,1
5853,2047870042,BX,1599 EAST GUN HILL ROAD,05,O2,LORD CHESTERFIELD CORP,2,1,1
5854,2048480072,BX,862 EAST 224 STREET,01,B2,UNITED CHURCH OF JESUS CHRIST (APOSTOLIC ) INC.,2,1,1
5855,2048670064,BX,952 EAST 232 STREET,02,C0,JOSEPH DEPACE JR. IRREVOCABLE LIVING TRU ST,2,1,1
5856,2048890115,BX,1323 EAST 223 STREET,01,B1,WEBSTER STEVEN,2,1,1
5857,2048990050,BX,1212 EAST 225 STREET,01,A2,"MOORE, AKINWALE",2,1,1
5858,2049050001,BX,1155 EAST 225 STREET,03,D3,NYC HOUSING AUTHORITY,44,43,1
5859,2049240007,BX,2080 NEEDHAM AVENUE,01,B2,"TALL, DORIS E",2,1,1
5860,2050530065,BX,4341 ELY AVENUE,01,A1,"RAMELIZE, YUSEF W",2,1,1
5861,2050720033,BX,4466 BYRON AVENUE,01,B9,"WELSH, JENNIFER",2,1,1
5862,2053070018,BX,2722 GIFFORD AVENUE,01,A2,LEONOR ESPENORIO,2,1,1
5863,2053860056,BX,2817 ROEBLING AVENUE,01,A5,"ZHENG , XIU YUN",2,1,1
5864,2054060091,BX,3137 WATERBURY AVENUE,02,C0,"KOLA, PETRIT",2,1,1
5865,2054460036,BX,322 LOGAN AVENUE,01,A1,JUDITH BRANDENSTEIN,2,1,1
5866,2054510036,BX,2986 MILTON PLACE,01,B1,"AQUINO, AUGUSTIN M",2,1,1
5867,2055340037,BX,2811 BARKLEY AVENUE,01,B1,"ROLON, JOHN",2,1,1
5868,2055450089,BX,755 CALHOUN AVENUE,01,B3,"MCCALL, MENARD",2,1,1
5869,2055450136,BX,740 QUINCY AVENUE,01,B1,"MOTA, ERIKA S",2,1,1
5870,2055770093,BX,327 REVERE AVENUE,01,A1,SILVA DAVID,2,1,1
5871,2056260306,BX,59 EARLEY STREET,01,A2,"INCE, BRENDAN L",2,1,1
5872,2057490685,BX,3111 HENRY HUDSON PKWY W,01,A3,"130 HOLDINGS, LLC",2,1,1
5873,2058461706,BX,5475 FIELDSTON ROAD,01,B2,"CHIARELLO, RICHARD",2,1,1
5874,3000420001,BK,53 BRIDGE STREET,05,O6,53 BRIDGE LLC,3,2,1
5875,3003520049,BK,55 SUMMIT STREET,05,K1,SS DEV PARTNERS LLC,2,1,1
5876,3003990060,BK,459 BALTIC STREET,10,G1,BASILE JOSEPH J,2,1,1
5877,3004820001,BK,375 HAMILTON AVENUE,07,G3,SMITH AND HAMILTON LLC,2,1,1
5878,3004830020,BK,539 SMITH STREET,06,F1,539 SMITH STREET REALTY CORP,2,1,1
5879,3005380001,BK,110 COLUMBIA STREET,03,D3,NYC HOUSING AUTHORITY,24,23,1
5880,3006120099,BK,640 COLUMBIA STREET,11,V1,640 COLUMBIA OWNER LLC,2,1,1
5881,3006340063,BK,203 19 STREET,02,C0,"MURPHY, BRIAN THOMAS",2,1,1
5882,3009170043,BK,4024 6 AVENUE,02,C0,DEACON STELLA,2,1,1
5883,3009987505,BK,257 8 STREET,02,R1,UNAVAILABLE OWNER,2,1,1
5884,3010340034,BK,262 13 STREET,01,B1,"VAKILI, ALI",2,1,1
5885,3011060001,BK,211 PROSPECT PARK WEST,04,S5,"SR PPW, LLC",2,1,1
5886,3012190050,BK,677 ST MARKS AVENUE,01,A4,"FRANCIS, CHARLES",2,1,1
5887,3012840038,BK,1336 PRESIDENT STREET,01,A5,WILTSHIRE ETHELMA,2,1,1
5888,3012910018,BK,1274 CARROLL STREET,01,A5,"STERN , SHMUEL",2,1,1
5889,3012980045,BK,583 MONTGOMERY STREET,01,B1,BARBER  RENEE MADELINE,2,1,1
5890,3013040086,BK,173 SULLIVAN PLACE,01,B1,HELEN E. ST. BERNARD,2,1,1
5891,3013240043,BK,19 BALFOUR PLACE,02,C0,BADDAL MAUREEN,2,1,1
5892,3013840052,BK,1373 LINCOLN PLACE,03,D3,HP UTICA PLACE HOUSING DEVELOPMENT FUND  CO. INC.,2,1,1
5893,3014290051,BK,829 EAST NEW YORK AVENUE,04,S2,EMPIRE HOLDINGS LP,2,1,1
5894,3015010046,BK,627 DECATUR STREET,01,B3,"MYLAN, NICOLE B",2,1,1
5895,3017090008,BK,39 ROCHESTER AVENUE,01,B3,"WALCOTT, YOLETTE",2,1,1
5896,3017130018,BK,912 HERKIMER STREET,01,B3,"LAMAR EVANS, AS TRUSTEE",3,2,1
5897,3017160033,BK,8 WALWORTH STREET,06,E1,"TOLDOS YEHUDAH, LLC",2,1,1
5898,3018170090,BK,151 MADISON STREET,01,B3,"RIES, ETHAN",2,1,1
5899,3018600063,BK,95 HERKIMER STREET,01,B9,ENOMA ALONGE,2,1,1
5900,3018870059,BK,76 CLINTON AVENUE,01,B3,FRANK A MINGO,3,2,1
5901,3019410052,BK,451 LAFAYETTE AVENUE,04,S2,"ABDULLA, MOHAMED M",2,1,1
5902,3020990008,BK,61A SOUTH ELLIOTT PLACE,01,B3,"GATTER, SHAUN",2,1,1
5903,3023040012,BK,138 NORTH 10 STREET,03,D3,"BEDFORD ACQUISITIONS, L.L.C.",2,1,1
5904,3023260017,BK,114 NORTH 7 STREET,04,C7,1 LIKA LLC,2,1,1
5905,3024490010,BK,316 SOUTH 4 STREET,02,C3,ANGEL J. LIU-ERAZO JR,2,1,1
5906,3025130017,BK,192 FREEMAN STREET,01,B9,"BRIAN A. DEBENEDITTIS, AS TO 50% INTERES T",2,1,1
5907,3025170027,BK,520 KINGSLAND AVENUE,06,E1,KING'S LAND REALTY ASSOCIATES LLC,2,1,1
5908,3025590053,BK,161 GREENPOINT AVENUE,04,S4,"MADALINSKI, ZOFIA",2,1,1
5909,3027980030,BK,497 SCOTT AVENUE,06,F5,WASTE MANAGEMENT OF NEW YORK LLC,2,1,1
5910,3029160049,BK,259 DEVOE STREET,02,C0,"SCIANGULA, DOMINICK J",2,1,1
5911,3031360014,BK,18 BELVIDERE STREET,02,C0,VIRGINIA ALAMO,2,1,1
5912,3031620036,BK,89 JEFFERSON STREET,01,B2,CONTROLLED CHAOS LLC,2,1,1
5913,3031740032,BK,206 KNICKERBOCKER AVENUE,04,S9,206 KNICKERBOCKER AVE INC,2,1,1
5914,3032680022,BK,176 STANHOPE STREET,01,B2,"MARRERO, MARIA",2,1,1
5915,3032750023,BK,72 HIMROD STREET,02,C1,72 HIMROD RESIDENCE LLC,2,1,1
5916,3033770042,BK,287 CORNELIA STREET,02,C2,287 CORNELIA ST LLC,2,1,1
5917,3034010005,BK,1565 BROADWAY,04,K4,1565 BWAY RLTY CORP,2,1,1
5918,3035380029,BK,162 HERZL STREET,01,B1,CHRISTIAN L. DOSSOU,2,1,1
5919,3035520013,BK,187 GRAFTON STREET,01,B1,"HANCOCK , GWENNETH",2,1,1
5920,3036820022,BK,2518 ATLANTIC AVENUE,11,V1,GREEN FIELD GROUP LLC,2,1,1
5921,3037070024,BK,208 BRADFORD STREET,01,B3,MARIN DOMINGA,2,1,1
5922,3038840325,BK,33 CROSBY AVENUE,08,M9,"ST. JOHN THE BAPTISTE MONASTERY FOUNDATI ON OF NYS,",3,2,1
5923,3039270043,BK,92 ESSEX STREET,01,A1,LONDONO ZENAIDA,2,1,1
5924,3039290057,BK,146 HIGHLAND PLACE,01,B1,"BAICHU, RAMDHAN",2,1,1
5925,3039540005,BK,265 CLEVELAND STREET,01,A1,"LALL, RAMSOOK",2,1,1
5926,3039580016,BK,179 SHEPHERD AVENUE,01,A1,"DINGLE, JILL W",2,1,1
5927,3039760017,BK,45 MONTAUK AVENUE,01,B2,LARA ANN,2,1,1
5928,3041370012,BK,201 NORWOOD AVENUE,01,B1,"MARTE, MARIA M",2,1,1
5929,3041740073,BK,400 GRANT AVENUE,08,M4,ST SYLVESTERS CHURCH,2,1,1
5930,3041960001,BK,463 CONDUIT BOULEVARD,07,G3,"BOLLA EM REALTY, LLC",2,1,1
5931,3042530008,BK,619 HEMLOCK STREET,01,B1,"REDMOND , ANGELLA",2,1,1
5932,3043120072,BK,663 ASHFORD STREET,01,B2,"WRIGHT, ROSELLE",2,1,1
5933,3043250023,BK,762 WYONA STREET,02,C0,"DESOUZA, NERITA",2,1,1
5934,3044580046,BK,1079 HEGEMAN AVENUE,01,B1,"PIERRE, DONALD",2,1,1
5935,3046310061,BK,243 EAST 95 STREET,02,C3,243 EAST 95TH LLC,2,1,1
5936,3046800007,BK,858 LINDEN BOULEVARD,02,C0,"CARTER, L.",2,1,1
5937,3046800062,BK,229 EAST 54 STREET,01,B3,"JONES, RIDLEY",2,1,1
5938,3048450007,BK,590 CLARKSON AVENUE,01,B1,VIOLET JOHNSON,2,1,1
5939,3048460021,BK,34 EAST 42 STREET,01,B3,GEORGE WILKINS,2,1,1
5940,3048600023,BK,90 EAST 40 STREET,02,C3,"DABEL, YVETTE",2,1,1
5941,3048740054,BK,203 EAST 37 STREET,08,M1,CHURCH OF GOD 7TH DAY INC,2,1,1
5942,3049050030,BK,304 EAST 35 STREET,01,B1,"JOLICOEUR, POLONE",2,1,1
5943,3049520046,BK,3511 AVENUE D,01,A9,"TUCKER, JULIET",2,1,1
5944,3049710012,BK,588 EAST 38 STREET,01,B1,"SHAHIDULLAH, MOHAMMED",2,1,1
5945,3050140067,BK,816 EAST 40 STREET,01,A1,KELSO GEORGE R,2,1,1
5946,3050640053,BK,2038 BEDFORD AVENUE,05,K1,RITA REALTY LLC,2,1,1
5947,3050660068,BK,271 LENOX ROAD,04,D6,"KARP, ELI",2,1,1
5948,3051430078,BK,358 ARGYLE ROAD,01,B3,"SMITH , BENJAMIN",2,1,1
5949,3052820042,BK,104 EAST 4 STREET,01,B2,"CERRIDWEN, CHARLENE",2,1,1
5950,3053130014,BK,85 LOUISA STREET,02,C0,"BUKHORIM, LMAN ACHAI",2,1,1
5951,3054010077,BK,669 EAST 7 STREET,01,B1,669 EAST 7TH LLC,2,1,1
5952,3054020065,BK,573 EAST 8 STREET,01,B2,LIEBERMAN RENA,2,1,1
5953,3054430076,BK,1641 48 STREET,01,A9,"HOROWITZ, MENASHE",2,1,1
5954,3054490064,BK,1723 49 STREET,01,B2,"DINI BIGAJER, AS CO-TRUSTEE",2,1,1
5955,3054660042,BK,1680 51 STREET,01,A7,BISTRICER DAVID,2,1,1
5956,3054780032,BK,1658 53 STREET,01,B2,"KLITNICK, MEYER",2,1,1
5957,3054940047,BK,1848 55 STREET,01,B2,"ARON, GUTMAN",2,1,1
5958,3054951143,BK,5312 21 AVENUE,07,G9,JJL HOLDINGS LLC,2,1,1
5959,3055330040,BK,6202 19 AVENUE,01,B3,"ALOMARI, ABDO",2,1,1
5960,3056010056,BK,945 44 STREET,01,B1,945 44TH STREET LLC,2,1,1
5961,3056070063,BK,939 45 STREET,02,C0,WEBER NAFTALY,2,1,1
5962,3056290024,BK,1340 47 STREET,02,C0,"DINTER, ADRIENNE F",2,1,1
5963,3056960010,BK,1112 57 STREET,01,B2,1112 57 LLC,2,1,1
5964,3057370027,BK,1044 63 STREET,01,B2,888 LI EN INC,2,1,1
5965,3057690060,BK,1447 OVINGTON AVENUE,02,C0,"LAI, SHAO XUAN",2,1,1
5966,3058930038,BK,562 OVINGTON AVENUE,01,B2,MK SHORE LLC,2,1,1
5967,3059550032,BK,1060 76 STREET,01,A5,"WU, HUI XIN",2,1,1
5968,3061430051,BK,311 BATTERY AVENUE,01,A5,POLY PREP COUNTRY DAY SCHOOL,2,1,1
5969,3061730029,BK,1952 70 STREET,02,C0,AMY KWOK CHU CHAN,2,1,1
5970,3062170015,BK,1926 74 STREET,01,B2,FRANCA MANNINO,2,1,1
5971,3062767501,BK,2151 80 STREET,02,R3,UNAVAILABLE OWNER,3,2,1
5972,3062970013,BK,1916 81 STREET,02,C0,"AU-YEUNG, DANNY",2,1,1
5973,3063940044,BK,88 BAY 10 STREET,01,B3,"RANDAZZO, VITO",2,1,1
5974,3065200027,BK,968 EAST 8 STREET,01,A1,"SAMUEL JEMAL, AS TRUSTEE",2,1,1
5975,3065400015,BK,1316 EAST 5 STREET,01,A5,1316 EAST FIFTH STREET TRUST,2,1,1
5976,3065510072,BK,2217 63 STREET,01,B2,"LIN, WENXI",2,1,1
5977,3065690036,BK,1446 EAST 7 STREET,01,B1,"GAMZEHLATOVA, FANNYPNINA",2,1,1
5978,3065860052,BK,409 AVENUE O,01,A9,ROBERT ROSENBLATT,2,1,1
5979,3065890026,BK,1440 EAST 8 STREET,01,A3,"SERUYA, ESTHER",2,1,1
5980,3065950014,BK,1514 WEST 11 STREET,03,D1,RO-ART REALTY LLC,2,1,1
5981,3066170041,BK,1920 CONEY ISLAND AVENUE,04,S2,1920 CONEY RLTY INC,2,1,1
5982,3066580016,BK,1774 EAST 2 STREET,01,B3,"ESSES, ALFRED",4,3,1
5983,3066810472,BK,501 AVENUE S,01,A3,"FRANCO, ISAAC S",3,2,1
5984,3067160029,BK,1060 EAST 15 STREET,01,B1,"HUYNH, TINA",2,1,1
5985,3067230038,BK,1176 EAST 13 STREET,01,A9,BETH MERMELSTEIN 2012 IRREVOCABLE TRUST,2,1,1
5986,3067290047,BK,1816 AVENUE K,01,A1,"LEHMANN, SANDRA",2,1,1
5987,3067330081,BK,1239 EAST 13 STREET,01,A5,"RITA GLUCK FAMILY TRUST DATED MARCH 18,  2016",2,1,1
5988,3067510082,BK,1437 EAST 13 STREET,01,B2,"JACOBOWITZ, YOSEF",2,1,1
5989,3067650028,BK,1558 EAST 19 STREET,03,D4,1558 OWNERS CORP,2,1,1
5990,3067690093,BK,1563 EAST 22 STREET,01,A1,"BAKER, ARYEH",2,1,1
5991,3067800037,BK,1688 EAST 18 STREET,08,M3,CONGREGATION OHEV TZ,2,1,1
5992,3068080018,BK,1736 EAST 26 STREET,01,A1,ALON COHEN,2,1,1
5993,3068240027,BK,1854 EAST 19 STREET,01,B2,"DICHY, CHARLES",2,1,1
5994,3068280044,BK,2219 AVENUE S,01,B3,"SNADO, JOSEPH",2,1,1
5995,3068610020,BK,8645 23 AVENUE,01,B1,"DEMARTINO, RALPH",2,1,1
5996,3068750019,BK,149 BAY 35 STREET,01,A1,"XIE, ZHIMING",2,1,1
5997,3068970015,BK,8837 26 AVENUE,01,B1,8837 LAU LLC,2,1,1
5998,3069170063,BK,2827 CROPSEY AVENUE,04,S2,RICHARD S L CHOW,2,1,1
5999,3069600032,BK,3808 MAPLE AVENUE,01,B2,VLADIMIR TIKHONOV,2,1,1
6000,3070280019,BK,4030 SURF AVENUE,01,B1,"SMOLENSKY, OSCAR",2,1,1
6001,3071040526,BK,2041 EAST 1 STREET,01,A1,"MORRIS, GLORIA",2,1,1
6002,3071050049,BK,2069 EAST 2 STREET,01,A3,SITT SAM,2,1,1
6003,3071100054,BK,2139 EAST 7 STREET,02,C0,"CHAMI, ALBERT I",2,1,1
6004,3071300058,BK,2209 EAST 3 STREET,01,A9,ABRAHAM BERT HIDARY,2,1,1
6005,3071310016,BK,2190 EAST 5 STREET,01,B2,ALBERT COHEN SABAN TRUST,2,1,1
6006,3071320036,BK,2166 OCEAN PARKWAY,01,B1,"LATI, NASIM",2,1,1
6007,3071350073,BK,2113 EAST 8 STREET,02,C0,CHALOUM KHADIDA,2,1,1
6008,3071360030,BK,2468 CONEY ISLAND AVENUE,05,O5,2464 CONEY ISLAND AVENUE LLC,2,1,1
6009,3071440026,BK,2252 WEST 6 STREET,01,B2,"CALLE, LUIS",2,1,1
6010,3071590007,BK,716 AVENUE V,01,B1,"GINDI, JOSEPH",2,1,1
6011,3071810017,BK,2320 OCEAN PARKWAY,02,C0,"KASSAB,  JINA T",2,1,1
6012,3073430022,BK,2138 EAST 12 STREET,01,A1,"YEDID, TEDDY",2,1,1
6013,3073510065,BK,2133 EAST 18 STREET,01,A1,AILI KATASH,2,1,1
6014,3073810110,BK,2226 EAST 22 STREET,01,B3,"NG, CHE SING",2,1,1
6015,3075850068,BK,1026 EAST 22 STREET,01,A5,FISCHER PENINA,2,1,1
6016,3076040055,BK,1026 EAST 23 STREET,01,A1,YAACOV JACOBSON,2,1,1
6017,3076230073,BK,1164 EAST 24 STREET,01,A1,"ELEFANT, JACOB",2,1,1
6018,3076240026,BK,1145 EAST 24 STREET,01,B2,REBECCA KRAITENBERGER,2,1,1
6019,3076490028,BK,1239 EAST 31 STREET,01,B2,FOSTER EPHRIAM,3,2,1
6020,3076930003,BK,3117 AVENUE P,01,B1,"RUAN, ZHUO HUAN",2,1,1
6021,3076950068,BK,1534 EAST 34 STREET,01,B1,"LEE, SO KAU",2,1,1
6022,3077170055,BK,3422 QUENTIN ROAD,04,O8,KOKOTAS KATINA,2,1,1
6023,3079320302,BK,5836 PRESTON COURT,,Z9,"GEOJEN REALTY, LLC",2,1,1
6024,3082030005,BK,9517 AVENUE J,08,I7,"FSNR ACQUISITION GROUP, LLC",2,1,1
6025,3082200011,BK,1309 EAST 93 STREET,01,A1,FELIPE VILLAROMAN,2,1,1
6026,3082390042,BK,9318 AVENUE K,04,S3,AVENUE K MANAGEMENT LLC,2,1,1
6027,3082410025,BK,1357 EAST 95 STREET,01,B3,"BENOIT, WILFRID JEAN",2,1,1
6028,3082450012,BK,1161 EAST 99 STREET,01,B3,"CASTRO, STEPHANIE",2,1,1
6029,3083640034,BK,2317 RALPH AVENUE,07,G3,KAPSIN DALLAS RLTY CORP,2,1,1
6030,3084330052,BK,2128 EAST 74 STREET,10,G0,"2134-2138 EAST 74TH STREET, INC.",2,1,1
6031,3087280052,BK,66 COLERIDGE STREET,01,A4,"MANDALAOUI, ISAAC",2,1,1
6032,3087510456,BK,177 HASTINGS STREET,01,A1,"SHAMAH, HAROLD",2,1,1
6033,3087530013,BK,115 JAFFRAY STREET,01,B3,"ZAMDBORG, YURY",2,1,1
6034,3088390001,BK,2701 KNAPP STREET,07,G4,"SUNOCO, LLC",2,1,1
6035,3089230949,BK,66 GOTHAM AVENUE,01,A1,"DENARDO, JAIME",2,1,1
6036,4005360024,QN,14-02 30 AVENUE,01,B1,THOMAS FLEMING,2,1,1
6037,4005890034,QN,31-19 30 STREET,02,C0,"SOUMAKIS, SARANTOS",2,1,1
6038,4005960143,QN,28-16 ASTORIA BOULEVARD,04,S2,UNITED CYPRIANS OF AMERICA INC,2,1,1
6039,4006520067,QN,25-50 37 STREET,01,B2,"MEDINA, MARIA",2,1,1
6040,4006530020,QN,25-41 37 STREET,02,C1,25-41 37 STREET REALTY LLC,2,1,1
6041,4006610014,QN,28-17 37 STREET,02,C0,CARMELO CORBO 2017 IRREVOCABLE TRUST,2,1,1
6042,4006770012,QN,32-63 41 STREET,01,B1,THE KOREAN CENTRAL CHURCH OF NEW YORK,2,1,1
6043,4006810117,QN,30-08 41 STREET,02,C0,MARIA RUFFINI,2,1,1
6044,4007830024,QN,22-50 43 STREET,01,B3,"ELISSA, NARMELLA",2,1,1
6045,4007840059,QN,21-64 45 STREET,01,A5,GEORGE J WYTAK,2,1,1
6046,4007990064,QN,40-19 21 AVENUE,01,A1,"WEITZEL, RICARDO",3,2,1
6047,4008750037,QN,23-13 23 STREET,01,A5,"HYNDMAN, JAMES E JR.",2,1,1
6048,4008820059,QN,20-18 23 STREET,01,B1,ZAHARIADIS PHYLLIS,2,1,1
6049,4012700030,QN,70-11 35 ROAD,01,B3,"HOWLADER, MANNAN",2,1,1
6050,4013420025,QN,42-56 65 PLACE,02,C0,RADEGUNDO LANDRITO,2,1,1
6051,4013550030,QN,72-50 44 AVENUE,01,A5,"SHAO, YI MING",2,1,1
6052,4014130053,QN,32-45 83 STREET,01,B1,"TU, HUI",2,1,1
6053,4014810064,QN,37-41 93 STREET,01,B2,"TORRES, HILDA A",2,1,1
6054,4015530050,QN,41-25 ELBERTSON STREET,01,B3,NGHIEM LLC,2,1,1
6055,4015990056,QN,95-13 43 AVENUE,02,C0,"KALAM, ABUL",2,1,1
6056,4016960046,QN,32-43 101 STREET,01,B2,"GUACHICHULCA , PEDRO V",2,1,1
6057,4017210012,QN,33-12 107 STREET,01,B2,"CHEN, YUAN",2,1,1
6058,4017480079,QN,34-23 106 STREET,02,C0,"LIN, LING FU",2,1,1
6059,4017540029,QN,34-34 111 STREET,02,C0,"ZHOU, SUI MIN",2,1,1
6060,4017550101,QN,34-11 111 STREET,02,C0,"CHEN, YAN RONG",2,1,1
6061,4017650022,QN,38-29 99 STREET,02,C0,EMPRESARIOS EXITOSOS LATINOAMERICANOS,2,1,1
6062,4017660071,QN,37-65 100 STREET,01,B2,"MINCHALA, MANUEL C",2,1,1
6063,4017860015,QN,112-34 39 AVENUE,02,C1,"LIU'S REALTY 168, LLC",2,1,1
6064,4018540059,QN,90-31 53 AVENUE,01,B3,"HUYNH, CIN M.",2,1,1
6065,4019117501,QN,94-31 59 AVENUE,04,RM,REGO PARK CONDOMINIUM,2,1,1
6066,4019940010,QN,106-34 50 AVENUE,02,C0,BLANCA A VELEZ,2,1,1
6067,4020160014,QN,111-12 43 AVENUE,01,B9,"DE SOUZA, CESAR A",2,1,1
6068,4021080019,QN,99-24 62 ROAD,01,B3,"MURDUKHAYEV, ISAK",2,1,1
6069,4022300061,QN,110-11 JEWEL AVENUE,01,A3,"YAKUBOV, CO-GUARDIAN, ALBERT",2,1,1
6070,4022670113,QN,76-15 113 STREET,02,C1,DUIGNAN WILLIAM,2,1,1
6071,4023270033,QN,48-02 58 LANE,01,A9,"ROSALES, JOSE C",2,1,1
6072,4023890014,QN,48-21 65 PLACE,02,C0,"CHEN, AI LIAN HUANG",2,1,1
6073,4026290012,QN,59-04 55 STREET,06,F5,"ROZMUS, WIESLAW",2,1,1
6074,4026350009,QN,54-20 FLUSHING AVENUE,04,S3,"TEJADA, DILENIA",2,1,1
6075,4026760029,QN,57-63 58 STREET,01,B1,"SERRANO, OSCAR",2,1,1
6076,4027290012,QN,60-14 59 ROAD,01,A5,"GAYMES, TRACY",2,1,1
6077,4027530264,QN,64-68 58 ROAD,01,A5,AMADO-GONZALEZ MARIA ELSA,2,1,1
6078,4027590113,QN,64-25 60 AVENUE,01,A5,"KWASNIK, MARIUSZ",2,1,1
6079,4027600035,QN,64-52 60 AVENUE,01,A5,JOHN CIRAMI,2,1,1
6080,4027600058,QN,64-15 60 ROAD,01,B3,"HOEFFERLE, FRANK",2,1,1
6081,4029730051,QN,62-57 83 PLACE,01,A1,"PHELAN, ROSEMARIE",3,2,1
6082,4029960015,QN,63-20 84 STREET,01,A1,THE LACH REVOCABLE LIVING TRUST,2,1,1
6083,4030390004,QN,65-04 78 STREET,01,B3,STEVEN T CAMPBELL,2,1,1
6084,4030530088,QN,66-32 PLEASANTVIEW STREET,01,B2,RICHARD KUMP,2,1,1
6085,4030690039,QN,66-34 79 PLACE,01,B3,"WARTWIG, JOSEPH",2,1,1
6086,4031160047,QN,63-04 ELLWELL CRESCENT,01,A1,SUSANA IZRAILOVA,2,1,1
6087,4031690021,QN,99-22 67 ROAD,03,D3,STONE HILL REALTY CO LLC,2,1,1
6088,4031800088,QN,67-38 SELFRIDGE STREET,01,B1,"KUANG, WANLI",3,2,1
6089,4034400034,QN,1745 GROVE STREET,01,B2,1745 GROVE LLC,2,1,1
6090,4035810008,QN,60-16 ST FELIX AVENUE,01,B3,"MALDONADO, ERNESTO",2,1,1
6091,4036670387,QN,67-48 73 PLACE,01,B2,STANISLAW BALDYGA,2,1,1
6092,4037830010,QN,68-01 79 STREET,04,S2,"BOSSIO, CARMINE",2,1,1
6093,4037900016,QN,69-62 74 STREET,01,B1,SRODIN BARBARA,2,1,1
6094,4038110064,QN,77-56 74 STREET,01,A5,F & F SBASCHNIK,2,1,1
6095,4039000001,QN,102-02 METROPOLITAN AVENUE,05,K2,"102 METRO, LLC",2,1,1
6096,4039167503,QN,4-09 121 STREET,02,R3,RIVERVIEW AT COLLEGE POINT CONDO III,46,45,1
6097,4039680044,QN,7-23 124 STREET,01,B2,"MCGOVERN, SEAN",2,1,1
6098,4040920030,QN,15-06 127 STREET,02,C0,"BUILES, JAIME",2,1,1
6099,4041710034,QN,20-34 127 STREET,01,B2,"TSENG, PHILLIP C",2,1,1
6100,4044280027,QN,13-32 141 STREET,01,A1,"GATZONIS, MICHAEL",2,1,1
6101,4044390023,QN,5-18 PARSONS BOULEVARD,01,A2,"PIMENTEL, FRANKLIN",2,1,1
6102,4045800035,QN,160-30 11 AVENUE,01,A1,"BACALOCOSTANTIS, KIRIACOS",2,1,1
6103,4046120060,QN,168-14 14 AVENUE,01,A1,KOUTMANIS MARK,2,1,1
6104,4046550024,QN,20-38 149 STREET,01,B3,YA SU SHI,2,1,1
6105,4046690053,QN,149-18 19 AVENUE,01,B1,"PIAZZA, JOSEPH J",2,1,1
6106,4047060042,QN,151-74 19 AVENUE,01,B3,"JIANG, LONG",2,1,1
6107,4047370050,QN,154-61 21 AVENUE,01,A1,GALLAGHER MICHAEL,2,1,1
6108,4047880061,QN,144-63 32 AVENUE,01,B3,SANDY & LISA LLC,2,1,1
6109,4049090003,QN,164-08 29 AVENUE,01,A1,"ARROYO, AS TRUSTEE UNDER THE, DEBRA",2,1,1
6110,4051840017,QN,143-44 FRANKLIN AVENUE,01,B3,"WANG, FU HAN",2,1,1
6111,4053530023,QN,40-10 189 STREET,01,A5,"ZHANG, QIUFENG",2,1,1
6112,4053770053,QN,147-37 ASH AVENUE,08,M3,"TIAN DER MONASTERY,INC",2,1,1
6113,4060250036,QN,32-45 FRANCIS LEWIS BLVD,05,K6,MONROE LLC,2,1,1
6114,4060320030,QN,32-50 203 STREET,01,A5,MARIETTA CALLAHAN,2,1,1
6115,4060810041,QN,33-25 201 STREET,01,A5,"FIGLIOZZI, GERALD",2,1,1
6116,4061120070,QN,213-05 34 ROAD,01,A1,"TSOUKIAS, GUS P.",2,1,1
6117,4061960034,QN,37-25 222 STREET,01,A3,"WONG , ROBERT D",2,1,1
6118,4063680088,QN,132-42 60 AVENUE,02,C0,FRASCA SANTE,2,1,1
6119,4070000060,QN,76-32 171 STREET,01,A1,"IVGI, LERON",2,1,1
6120,4072130019,QN,75-42 197 STREET,01,B1,"DE GOYANES, CECILIAO",2,1,1
6121,4072400074,QN,181-09 TUDOR ROAD,01,A1,"BETESH, SHIMON",2,1,1
6122,4073010062,QN,204-05 45 ROAD,01,A5,"YAO, CINDY",2,1,1
6123,4073060028,QN,206-54 45 ROAD,02,C0,JAMES W HARRINGTON,2,1,1
6124,4076150047,QN,64-57 214 STREET,01,B1,PASQUALE J. MIGNONE,2,1,1
6125,4077720022,QN,79-23 215 STREET,01,A1,"TIU, NANCY",2,1,1
6126,4077840077,QN,80-58 211 STREET,01,A2,AARON HENRY,3,2,1
6127,4080940036,QN,109 PROSPECT AVENUE,01,A1,"FILLOS, CHRISTOPHER",2,1,1
6128,4081160057,QN,40-22 247 STREET,01,A5,"ZHANG, XIAO YUAN",2,1,1
6129,4081380034,QN,43-11 WESTMORELAND STREET,01,A1,"MUNRO, DONALD",2,1,1
6130,4082100037,QN,246-17 52 AVENUE,01,A1,"HATZIS, CHRYSOSOTOMAS D",2,1,1
6131,4082320399,QN,249-55 RUSHMORE TERRACE,01,A2,J ZODDA,2,1,1
6132,4086520027,QN,244-44 88 DRIVE,01,A1,MOSHIUR R. TARAFDAR,2,1,1
6133,4087160053,QN,80-34 261 STREET,01,A1,"CULLEN, BRETT  WILLIAM",2,1,1
6134,4087640001,QN,81-16 LANGDALE STREET,02,C6,UNAVAILABLE OWNER,25,24,1
6135,4087670157,QN,83-42 256 STREET,01,A1,"RAMCHANDANI, RAJ",2,1,1
6136,4089020006,QN,76-12 88 AVENUE,01,B3,"ZHENG, JUAN",2,1,1
6137,4089090029,QN,78-19 90 AVENUE,01,B2,JOANN SEUBERT TRUSTEE,2,1,1
6138,4089150039,QN,88-44 85 STREET,02,C3,"LUCAS, MONICA L",2,1,1
6139,4089920223,QN,91-48 96 STREET,01,A5,DANIEL D TAVERAS,2,1,1
6140,4091520053,QN,107-45 89 STREET,01,A1,"TORRES, LIZZETTE",2,1,1
6141,4092240012,QN,86-14 111 STREET,01,A1,PERTAB SACHEE,2,1,1
6142,4092790089,QN,125-09 JAMAICA AVENUE,08,M1,RICHMOND HILL JAME MASJID AND ISLAMIC CE NTER,2,1,1
6143,4092790098,QN,86-43 125 STREET,01,B2,"HASSAN, MUNIR",2,1,1
6144,4093090007,QN,102-26 92 AVENUE,01,B3,"CHOWDHURY, SAIFUL I",2,1,1
6145,4093450027,QN,89-48 LEFFERTS BOULEVARD,02,C0,"SAVI'S QUIK SERV, INC.",2,1,1
6146,4093760021,QN,101-09 94 AVENUE,,Z9,2630 STEINWAY LLC,2,1,1
6147,4093950025,QN,95-46 110 STREET,02,C0,"MOTILAL, KAREN",2,1,1
6148,4094040051,QN,97-27 102 STREET,01,B3,"MC INTOSH, JAMES",2,1,1
6149,4094400068,QN,93-04 124 STREET,01,A9,"RAMTEJ , GOUKARRAN",2,1,1
6150,4094400087,QN,94-20 124 STREET,01,A9,RAMSARRAN BALRAM,2,1,1
6151,4094440038,QN,127-21 95 AVENUE,01,B3,"RAMDATH, ANZAVIER",2,1,1
6152,4094480023,QN,132-06 ATLANTIC AVENUE,01,B1,"U.S. BANK TRUST, N.A., AS TRUSTEE",2,1,1
6153,4094510024,QN,95-38 117 STREET,01,A1,MILDRED CONDE,2,1,1
6154,4094690016,QN,97-22 127 STREET,01,B3,"SHARMA, AMBIKA",2,1,1
6155,4095160017,QN,103-28 112 STREET,01,B3,"69 ADELPHI STREET I, INC.",2,1,1
6156,4095270016,QN,104-16 105 STREET,01,B2,"MARQUEZ, JOFFRE",2,1,1
6157,4095710024,QN,104-40 118 STREET,01,B2,10440 LLC,2,1,1
6158,4096110005,QN,131-10 107 AVENUE,01,B3,ROBERT JONES,2,1,1
6159,4096130070,QN,107-29 133 STREET,01,B2,"AHDOOT, MATTHEW",2,1,1
6160,4096170059,QN,88-17 136 STREET,01,B2,"HUSAIN, TARIQ",2,1,1
6161,4097610028,QN,89-29 162 STREET,02,C0,"LATIF, ABDUL",2,1,1
6162,4098500071,QN,85-50 168 STREET,02,C0,FAISAL SETARUDDIN,2,1,1
6163,4099300042,QN,88-20 184 STREET,01,A1,"BANARSE, KENNETH H.M",2,1,1
6164,4099670048,QN,184-49 HOVENDEN ROAD,01,A2,184-49 HOVENDEN LLC,2,1,1
6165,4099750033,QN,89-31 138 PLACE,01,B2,"GAHUANCELA, MIGUEL",2,1,1
6166,4099790001,QN,139-02 90 AVENUE,01,B2,JOSE HERRERA,2,1,1
6167,4100100015,QN,97-16 SANDERS PLACE,01,B3,ALVES LEONILDA,2,1,1
6168,4100490030,QN,145-37 105 AVENUE,01,B2,"SUKDEO, BIBI A",2,1,1
6169,4100760026,QN,144-17 SHORE AVENUE,01,A1,VIJAYA LOPEZ,2,1,1
6170,4101670027,QN,164-02 107 AVENUE,01,B3,"UDDIN, KAMAR",2,1,1
6171,4102190062,QN,172-25 DOUGLAS AVENUE,06,E9,AMERICAN RECYCLING MANAGEMENT,3,2,1
6172,4102330185,QN,173-16 103 ROAD,01,B3,"EMINOF, NADIRA",2,1,1
6173,4102340274,QN,104-16 177 STREET,01,A1,"WILCOX, DALE",2,1,1
6174,4102740020,QN,110-45 175 STREET,01,B3,"COELLO, JUNIOR",2,1,1
6175,4102770010,QN,110-27 178 STREET,01,B3,"NICHOLSON, SHARON A",2,1,1
6176,4102880015,QN,112-10 175 STREET,01,A1,SPIGNER ARCHIE,2,1,1
6177,4103330072,QN,177-28 105 AVENUE,01,B1,FASHAKIN JANET O,2,1,1
6178,4103680033,QN,102-73 189 STREET,01,B3,"GONZALEZ, REINA D",2,1,1
6179,4104100017,QN,185-17 ILION AVENUE,01,A1,LE ROY A WILLIAMS,2,1,1
6180,4104360035,QN,110-24 FARMERS BOULEVARD,08,M1,NEW YORK WASHINGTON CME ANNUAL CONFERENC E INC,4,3,1
6181,4105420095,QN,94-20 210 STREET,01,A1,SUCHETRA CHATTERGOON,2,1,1
6182,4106270017,QN,92-17 214 STREET,01,A1,"KHAN, TIPU",2,1,1
6183,4107030064,QN,92-61 219 STREET,01,A1,PAUL-BLANC JACQUES,3,2,1
6184,4107610037,QN,217-68 100 AVENUE,01,A1,"PIERRE-LYS, JEAN",2,1,1
6185,4109620424,QN,111-42 205 STREET,01,A5,"BUCKNOR, SONIA",2,1,1
6186,4110220050,QN,205-17 114 ROAD,01,B3,Louise Perez Jones,3,2,1
6187,4110630056,QN,192-05 LINDEN BOULEVARD,04,K4,TONY HOLDING LLC,2,1,1
6188,4111010049,QN,106-08 217 STREET,01,A1,DAVID & DEBORAH O DAVIS,2,1,1
6189,4112830012,QN,115-47 219 STREET,01,A1,ROBERT L REEDER SR,3,2,1
6190,4112930060,QN,115-48 230 STREET,01,A2,"SAINT-VIL, PATRICK",2,1,1
6191,4113720046,QN,90-59 PITKIN AVENUE,07,G2,PITKIN AVE LLC,2,1,1
6192,4119260029,QN,109-80 141 STREET,01,B3,NUNABOY DEVELOPMENT LLC,3,2,1
6193,4119380023,QN,145-46 LAKEWOOD AVENUE,02,C0,JOAN ANDREA LEWIS,2,1,1
6194,4119630061,QN,111-59 146 STREET,01,A1,"SINGH, TARWATTIE S",2,1,1
6195,4119640286,QN,111-39 LIVERPOOL STREET,01,A1,"SOBHAN, SOOKRAM",2,1,1
6196,4119650118,QN,111-23 148 STREET,01,A5,"ABDUL, ZORIFA",2,1,1
6197,4119850023,QN,115-38 142 STREET,01,B2,"MARCH, ANTHONY",2,1,1
6198,4119960118,QN,116-32 139 STREET,01,A1,"RAMCHARAN, NIRMALA",2,1,1
6199,4120270058,QN,119-18 147 STREET,01,A1,"MEDINA, MARIBEL",2,1,1
6200,4120500032,QN,123-21 146 STREET,01,A1,JULIA DIAZ,2,1,1
6201,4121630049,QN,110-54 160 STREET,01,A1,NICHOLS GUY E,2,1,1
6202,4121920043,QN,115-58 155 STREET,01,A1,"MCDERMOTT-RHODEN, CARLENE A",2,1,1
6203,4122120020,QN,150-26 120 AVENUE,01,A2,WILLIAMS  HORACINA L,2,1,1
6204,4123900265,QN,172-01 BAISLEY BOULEVARD,04,S9,"CD COLLINS, LLC",2,1,1
6205,4124500039,QN,118-66 FARMERS BOULEVARD,01,B2,"THIMMARAYAN, PERMAUL",2,1,1
6206,4125240062,QN,174-68 128 AVENUE,01,B2,"GRIFFITHS, RODCLIFFE",2,1,1
6207,4125680034,QN,134-56 174 STREET,01,B3,"HALL, EUGENE",2,1,1
6208,4126210018,QN,118-22 197 STREET,01,A1,NYC HOUSING AUTHORITY,2,1,1
6209,4126230048,QN,118-39 198 STREET,01,B3,"SMITH, VIOLA",2,1,1
6210,4126340029,QN,117-17 204 STREET,01,A5,NYC HOUSING AUTHORITY,2,1,1
6211,4126430003,QN,188-06 119 AVENUE,01,B2,"ADEGOR, FREEBORN",2,1,1
6212,4126510061,QN,119-15 195 STREET,01,B3,119-15 195 ST LLC,2,1,1
6213,4126540026,QN,119-40 199 STREET,01,A2,"WEBSON, ARNELLA",2,1,1
6214,4126540051,QN,119-19 198 STREET,01,A1,"SAMUELS, CRAIG",2,1,1
6215,4126680076,QN,188-11 122 AVENUE,01,A1,BETTY JAMES,2,1,1
6216,4126820006,QN,196-10 120 AVENUE,01,A1,"MANLEY, MARIE E",2,1,1
6217,4128250116,QN,224-20 FRANCIS LEWIS BLVD,01,B3,BASSIE SHEMTOV,2,1,1
6218,4129310055,QN,131-63 221 STREET,01,A1,LINCOLN SIDDON,3,2,1
6219,4129440023,QN,131-37 233 STREET,01,A2,"EASTMAN, DAWN",2,1,1
6220,4129500014,QN,243-05 131 ROAD,01,A3,SHARON PARELLA,2,1,1
6221,4129560039,QN,217-01 MERRICK BOULEVARD,05,O2,217-01 MERRICK LLC,2,1,1
6222,4130300063,QN,217-18 137 AVENUE,01,A1,"MCFARLANE, BRYAN",2,1,1
6223,4130410025,QN,140-36 184 STREET,01,B1,"DAVIS, STEVE A",2,1,1
6224,4133440038,QN,180-10 145 DRIVE,01,A1,"DIXON, DIANNE",2,1,1
6225,4134730034,QN,225-08 145 ROAD,01,A2,TOUSSAINT YVANNE,2,1,1
6226,4135570086,QN,241-25 143 AVENUE,01,B3,"RUTH, SYLVIA",2,1,1
6227,4135680041,QN,243-20 145 AVENUE,01,B3,"MURAT, RICARDO A",2,1,1
6228,4136610044,QN,255-43 147 ROAD,01,A1,"ETIENNE, MICHELINE",3,2,1
6229,4155560057,QN,10-29 NEILSON STREET,02,C0,GOSHEM REALTY LLC,2,1,1
6230,4155690001,QN,7-17 CEDAR LAWN AVENUE,01,A1,"SHLOMI , TAL",2,1,1
6231,4156210137,QN,1324 GRANDVIEW TERRACE,01,B2,"KRANZLER, LEV",2,1,1
6232,4156590006,QN,13-50 PINSON STREET,01,B2,"TAMISI, LOYCE",2,1,1
6233,4156600064,QN,13-41 PINSON STREET,01,B2,WILEY MICHAEL,2,1,1
6234,4161690021,QN,156 BEACH 97 STREET,02,C0,BEACH 97TH STREET ASSOCIATES LLC,2,1,1
6235,4162170019,QN,231 BEACH 121 STREET,01,B2,"MAGGIO, ROBERT",2,1,1
6236,4162180003,QN,122-11 NEWPORT AVENUE,01,B3,KISSIL ARTOUR,2,1,1
6237,4162720035,QN,2-27 BEACH 138 STREET,01,A1,"CZEISLER, RAPHAEL",2,1,1
6238,4162770001,QN,1-98 BEACH 133 STREET,01,A1,"MOORE , WILLIAM C",2,1,1
6239,4163230028,QN,1-43 BEACH 149 STREET,01,A1,"PERELSON, MICHAEL",2,1,1
6240,5000260003,SI,45 SHERMAN AVENUE,02,C0,"BLANCO, LUISA",2,1,1
6241,5000920001,SI,196 HENDERSON AVENUE,08,W2,RC CHURCH ST PETER,4,3,1
6242,5001270032,SI,175 FOREST AVENUE,01,B2,MARIA ANDRUZZI,2,1,1
6243,5002080007,SI,501 CARY AVENUE,05,O5,BOGART LLC,4,3,1
6244,5002160067,SI,117 SENECA STREET,01,B9,JOHN R GOULDSBURY,2,1,1
6245,5002230002,SI,451 CLOVE ROAD,01,A5,"POLICIER, ALTAGRACE",2,1,1
6246,5002250050,SI,903 FOREST AVENUE,04,S2,"LIAN, YU",2,1,1
6247,5002460072,SI,140 BEVERLY AVENUE,01,A1,"WALDRON, RICHARD",2,1,1
6248,5002510004,SI,350 FOREST AVENUE,05,K1,HANNA & ZAKA YOUSSEF,2,1,1
6249,5002530045,SI,352 SHARON AVENUE,02,C3,"DANIEL G. PIZZUTO, TRUSTEE",2,1,1
6250,5002980153,SI,117 HARTFORD AVENUE,01,A1,"BATTIATO, JOSEPH",2,1,1
6251,5003540032,SI,1230 FOREST AVENUE,07,G4,1234 FOREST HOLDING C,3,2,1
6252,5003580024,SI,288 KINGSLEY AVENUE,01,A1,"RABINER, STEFANIE",2,1,1
6253,5003630034,SI,117 COLLEGE AVENUE,01,A1,"ZARRILLI, GERALD R",2,1,1
6254,5003680110,SI,48 SAWYER AVENUE,01,A1,CHARLES ESPOSITO,2,1,1
6255,5005360013,SI,26 GROVE STREET,01,A1,"BANKS, MICHELLE",2,1,1
6256,5005930590,SI,22 ARLO ROAD,02,C9,GRYMES HILL APARTMENT,46,45,1
6257,5006880055,SI,45 DENOBLE LANE,01,A3,"MARCHESE, ANTHONY",2,1,1
6258,5006920313,SI,404 LITTLE CLOVE ROAD,01,B2,DOMINICK FAVALORO,2,1,1
6259,5007280044,SI,177 PURDY AVENUE,01,A2,"RAGNATELLI, JOHN",2,1,1
6260,5007420026,SI,42 MARTIN AVENUE,01,A5,"BRANCATO, JENNIFER A",2,1,1
6261,5008160023,SI,257 PORTAGE AVENUE,01,B2,VARUGHESE THOMAS,3,2,1
6262,5008370265,SI,50 MILDEN AVENUE,01,A2,"SABZPOSH, SYED WASIL ALI",2,1,1
6263,5008710121,SI,169 FOUR CORNERS ROAD,01,A3,JOSEPH LAMENDELLA,2,1,1
6264,5009520036,SI,211 ROCKLAND AVENUE,01,A3,HUMBERTO LOPES,2,1,1
6265,5010580007,SI,33 ORANGE AVENUE,01,A1,CUPO SUSAN,2,1,1
6266,5011490061,SI,32 MORNINGSTAR ROAD,02,C3,"DURANTE, MARIA T",3,2,1
6267,5011940121,SI,286 SIMONSON AVENUE,01,A5,FELIPE CATHERIN R,2,1,1
6268,5012300049,SI,34 GRIDLEY AVENUE,01,A2,MIGUEL A. TORRES,3,2,1
6269,5012330004,SI,305 HARBOR ROAD,01,B2,"DE LA CRUZ, ANDREA",2,1,1
6270,5012370048,SI,35 ANDROS AVENUE,01,B2,35 ANDROS LLC,2,1,1
6271,5012370108,SI,74 LOCKMAN AVENUE,01,A1,"FERRER, ALEXANDER",2,1,1
6272,5022760057,SI,293 LIGHTHOUSE AVENUE,01,A1,"ZAWALICH, THOMAS",2,1,1
6273,5024510100,SI,410 RICHMOND HILL ROAD,02,C1,410 RHR LLC,2,1,1
6274,5026380050,SI,145 EAST SERVICE ROAD,05,K8,ACADIA WEST SHORE EXPRESSWAY LLC,2,1,1
6275,5028450033,SI,1076 BAY STREET,04,S1,DAVID BOCHICCHIO,2,1,1
6276,5028480001,SI,159 VERMONT AVENUE,01,B1,"LATONA, WENDY",2,1,1
6277,5030230072,SI,327 FINGERBOARD ROAD,01,A1,FRANKTROMBETTA CONTRACTING,2,1,1
6278,5030720065,SI,38 LYMAN AVENUE,01,A1,DORN STEPHENSON,2,1,1
6279,5032950021,SI,88 BURGHER AVENUE,01,B2,HEALY BARBARA,2,1,1
6280,5033060051,SI,51 LIBERTY AVENUE,01,A1,SUSAN ROZAK,2,1,1
6281,5033160053,SI,167 DELAWARE AVENUE,01,B2,HENG CHOONG CHANG,2,1,1
6282,5038050034,SI,970 OLYMPIA BOULEVARD,02,C0,"ALI, OTHMAN M",4,3,1
6283,5038090041,SI,167 BADEN PLACE,01,A1,"LEVTER, PAVEL",2,1,1
6284,5038090043,SI,169 BADEN PLACE,01,A1,"ETINGIN, EUGENE",2,1,1
6285,5038830001,SI,1151 OLYMPIA BOULEVARD,01,A1,"LE LAM, TRONG",2,1,1
6286,5039000012,SI,2488 HYLAN BOULEVARD,07,G3,"2488 HYLAN BOULEVARD, LLC",2,1,1
6287,5040650043,SI,17 ROMA AVENUE,01,A2,FAR POINT HOLDING CORP.,2,1,1
6288,5042460008,SI,330 BEACH AVENUE,01,A1,ADAM JELICKS,2,1,1
6289,5051260044,SI,151 GREAT KILLS ROAD,01,A1,OAK DEVELOPERS LLC,2,1,1
6290,5053570057,SI,1363 ARDEN AVENUE,01,A1,VICTOR ARIAS,2,1,1
6291,5054350016,SI,36 MARGARET STREET,01,B2,"LIA, VINCENT",2,1,1
6292,5054440109,SI,15 MICHAEL COURT,01,A5,SCARPETIS GEORGE,2,1,1
6293,5055980072,SI,10 SERRELL AVENUE,01,B2,"XHAHO, FOTI",2,1,1
6294,5056640105,SI,820 DRUMGOOLE ROAD WEST,01,B2,LORRAINE FRANCHI,2,1,1
6295,5061690037,SI,1951 ARTHUR KILL ROAD,07,Y9,NYC DEPARTMENT OF SANITATION,2,1,1
6296,5062290004,SI,167 JEFFERSON BOULEVARD,01,A1,JOSEPH CASTELLANO,2,1,1
6297,5062490015,SI,5125 AMBOY ROAD,01,B2,"AMBER, LANA",2,1,1
6298,5062600042,SI,132 JEFFERSON BOULEVARD,01,A2,"SAKIR, BAUDIN",3,2,1
6299,5065860020,SI,5498 AMBOY ROAD,01,A1,JOHN CAYTON,2,1,1
6300,5066530008,SI,1 WRENN STREET,01,B2,"JOHN ANTOCI, JR.",2,1,1
6301,5067590029,SI,5970 AMBOY ROAD,01,A2,"PANEPINTO, MICHAEL",2,1,1
6302,5067880027,SI,24 STEVENSON PLACE,01,B2,MICHAEL LANZA,2,1,1
6303,5069750119,SI,16 MAGUIRE AVENUE,01,A1,"KOTOWSKI, GRZEGORZ",2,1,1
6304,5075340186,SI,6389 AMBOY ROAD,05,O7,"VENEZIA HOLDINGS, LLC",2,1,1
6305,5078180055,SI,108 BEDELL AVENUE,01,A1,NEBEL LINDA,2,1,1
6306,5078510029,SI,366 BREHAUT AVENUE,01,A1,CHAS & JANET KONIG,2,1,1
6307,5078670022,SI,90 SPRAGUE AVENUE,01,A1,"SYLVESTER, BARBARA",2,1,1
6308,1002810030,MN,64 EAST BROADWAY,04,C7,64 EAST BROADWAY REALTY,3,2,1
6309,1003480012,MN,120 SUFFOLK STREET,02,C4,THOMAS LOCICERO,2,1,1
6310,1004160001,MN,196 ELDRIDGE STREET,02,C1,NYC HOUSING AUTHORITY,3,2,1
6311,1005770071,MN,55 WEST 13 STREET,05,O3,NEW SCHOOL-SOCL RESEARCH,2,1,1
6312,1006150094,MN,269 WEST 12 STREET,02,C1,269 WEST 12 ST LLC,2,1,1
6313,1006360043,MN,398 WEST STREET,04,S3,CASPER R CALLEN TRUST,2,1,1
6314,1006400038,MN,763 WASHINGTON STREET,02,C1,THE DG 2005 FAMILY TRUST,2,1,1
6315,1007600003,MN,472 9 AVENUE,04,S3,472 NINTH AVENUE LLC,2,1,1
6316,1008060009,MN,145 WEST 30 STREET,05,O6,"CHALINE WEST 30TH STREET, LLC",2,1,1
6317,1008400070,MN,40 WEST 39 STREET,05,O5,174 ORCHARD ST REALTY,2,1,1
6318,1008600012,MN,15 EAST 30 STREET,04,D6,MADISON 30 31 OWNER LLC,2,1,1
6319,1012160044,MN,130 WEST 86 STREET,03,D4,130 WEST 86 APARTMENTS CORP.,2,1,1
6320,1014820001,MN,505 EAST 70 STREET,08,I4,ROYAL CHARTER ETAL,2,1,1
6321,1015610037,MN,416 EAST 82 STREET,08,M4,CH OF ST STEPHEN,3,2,1
6322,1019170040,MN,112 WEST 133 STREET,02,C0,"LIM, SOON L",2,1,1
6323,1020850001,MN,560 WEST 155 STREET,09,Z8,RECTOR CHURCHWARDNSETAL,3,2,1
6324,2023480045,BX,611 GRAND CONCOURSE,07,G5,"GTY-CPG (QNS/BX) LEASING, INC.",3,2,1
6325,2025830030,BX,900 EAST 132 STREET,06,F2,NYC INDUSTRIAL DEVELOPMENT AGENCY,2,1,1
6326,2027450030,BX,1175 HOE AVENUE,11,V0,"UNIQUE PEOPLE SERVICES, INC.",2,1,1
6327,2030010034,BX,1553 LONGFELLOW AVENUE,01,B2,"SIERRA, ERIC",2,1,1
6328,2031440038,BX,2099 TIEBOUT AVENUE,01,B3,"BARTLETT, VIVIAN A",2,1,1
6329,2035430001,BX, LAFAYETTE AVENUE,09,Q1,NYC DEPARTMENT OF PARKS AND RECREATION,2,1,1
6330,2036900040,BX,2261 LAFAYETTE AVENUE,01,A1,"ABREU, ADDYN",2,1,1
6331,2037690038,BX,1257 BRONX RIVER AVENUE,02,C3,JOSE TORRES,2,1,1
6332,2037730066,BX,1223 BOYNTON AVENUE,01,B1,"ZARUMA, RICARDO",2,1,1
6333,2038100082,BX,1141 CASTLE HILL AVENUE,07,G4,CASTLE HILL AVENUE CORP.,2,1,1
6334,2038130074,BX,2121 ELLIS AVENUE,01,A1,"RAMSAHAI, KHEMRAJ",2,1,1
6335,2039710047,BX,1556 GLOVER STREET,01,B1,"KALPUPERSAUD, KAWALL",2,1,1
6336,2039960062,BX,2409 BUCK STREET,01,A1,HECTOR ABREU,2,1,1
6337,2041020041,BX,1732 COLDEN AVENUE,01,B1,JULIE CIRA GARGIULO,3,2,1
6338,2041110047,BX,1614 WILLIAMSBRIDGE ROAD,05,O2,"KLEIN, JEFFREY D.",2,1,1
6339,2041420006,BX,1486 BLONDELL AVENUE,10,G0,"MIELE, FILOMENA/IND",2,1,1
6340,2041570077,BX,1625 PILGRIM AVENUE,02,C0,"LIN, ZENG",2,1,1
6341,2042050002,BX,1925 EASTCHESTER ROAD,08,W9,ALBERT EINSTEIN COLLEGE OF MEDICINE,7,6,1
6342,2043520026,BX,778 WARING AVENUE,01,B1,"FERDOUS, HIMEL YOUSUF",2,1,1
6343,2045320054,BX,2741 FENTON AVENUE,01,B1,"WILLIAMS, ANA C",2,1,1
6344,2045640093,BX,2941 DEWITT PLACE,01,A2,CARRILES CARMEN,2,1,1
6345,2046050030,BX,804 SOUTH OAK DRIVE,01,B1,"RAMIREZ, SANDY F",2,1,1
6346,2046080006,BX,905 BURKE AVENUE,01,A2,LOIS CESARANO,2,1,1
6347,2046220055,BX,3309 BARKER AVENUE,02,C0,"BUETI, JOSEPH",2,1,1
6348,2046420001,BX,641 EAST GUN HILL ROAD,07,G3,"BLUE HILLS FUELS, LLC",2,1,1
6349,2046540083,BX,643 EAST 219 STREET,01,B1,"CASTELLANOS, MIGUEL",2,1,1
6350,2046610015,BX,718 EAST 214 STREET,01,B1,BH EAST 214 LLC,2,1,1
6351,2046610087,BX,751 EAST 213 STREET,02,C2,FELIPE RODRIGUEZ,3,2,1
6352,2046650039,BX,725 EAST 217 STREET,02,C0,"JOSEPH MCLEARY, SANDRA",2,1,1
6353,2046810001,BX,967 EAST GUN HILL ROAD,05,O2,"967 EAST GUN HILL ROAD, LLC",2,1,1
6354,2046880072,BX,3729 PAULDING AVENUE,01,A5,"WILKERSON, TANYA",2,1,1
6355,2047280035,BX,3563 BOSTON ROAD,05,K1,CARMAR 55 LLC,2,1,1
6356,2048040050,BX,2740 WICKHAM AVENUE,01,A1,"VELEZ, BRENDA",2,1,1
6357,2048370022,BX,749 EAST 223 STREET,04,S5,360 WAKEFIELD LLC,2,1,1
6358,2048540062,BX,822 EAST 230 STREET,02,C2,822 EAST 230 REALTY CORP.,2,1,1
6359,2048710059,BX,1040 EAST 225 STREET,01,B1,"PAUL , ARLETTE",2,1,1
6360,2048970065,BX,1238 EAST 223 STREET,01,A1,FREDERICK ARCHER,2,1,1
6361,2049410047,BX,3673 VARIAN AVENUE,01,B2,KENROY AMOS,2,1,1
6362,2050030060,BX,4154 DIGNEY AVENUE,01,B1,AMADO LAMBERT JR,2,1,1
6363,2050260073,BX,4132 MURDOCK AVENUE,01,B9,JERRYLYN REID,2,1,1
6364,2050500002,BX,4304 BOYD AVENUE,01,A1,"MARTINEZ, IRIS",2,1,1
6365,2050850027,BX,724 EAST 241 STREET,05,K5,"BAKKER RLTY CO, INC",2,1,1
6366,2051180029,BX,810 ST OUEN STREET,01,B1,"GRAHAM, AVA-MARIE E",2,1,1
6367,2053560011,BX,2810 CODDINGTON AVENUE,04,K4,JDJJM INC,2,1,1
6368,2053730017,BX,2816 HARRINGTON AVENUE,02,C0,"MASTROPIETRO, TRUSTEE  , JANICE",2,1,1
6369,2054290041,BX,859 HOLLYWOOD AVENUE,01,B2,"VEGA, HECTOR R",2,1,1
6370,2054720044,BX,826 THROGS NECK EXPWY SR,01,B1,MICHELINA DAVANZO & CATHERINE ALVINO REV OCABLE TRU,3,2,1
6371,2054730032,BX,807 WILCOX AVENUE,01,A5,"RODRIGUEZ, HERMAN",2,1,1
6372,2054840007,BX,620 VINCENT AVENUE,01,A2,"WEST, RAYMOND",2,1,1
6373,2055800135,BX,340 BRINSMADE AVENUE,01,A5,"SJOGREN, STEVEN",2,1,1
6374,2056060140,BX,195 GRAFF AVENUE,01,A1,"DETTMER, PAMELA",2,1,1
6375,2056260380,BX,69 WINTERS STREET,01,B3,DENNIS MURPHY,2,1,1
6376,2056320015,BX,32 TIER STREET,01,B3,"CHRISTINA ROGONE, TRUSTEE",4,3,1
6377,2056360045,BX,653 MINNIEFORD AVENUE,01,A5,ZHENG HUI,2,1,1
6378,2057120066,BX,3010 IRWIN AVENUE,07,G5,3010 RIVERDALE LLC,3,2,1
6379,3003370014,BK,198 SACKETT STREET,02,C2,"MALLARDI, NICHOLAS",2,1,1
6380,3004140061,BK,299 DEGRAW STREET,08,Y1,NYC DEPARTMENT OF CULTURAL AFFAIRS,2,1,1
6381,3005120013,BK,41 RICHARDS STREET,06,E9,41 RICHARD STREET LLC,2,1,1
6382,3005130006,BK,367 COLUMBIA STREET,04,K4,1311 LINCOLN LLC,2,1,1
6383,3005880018,BK,39 DIKEMAN STREET,01,B9,CARMEN HULBERT,2,1,1
6384,3007090044,BK,3920 5 AVENUE,04,S9,AI GUANG CHAN,2,1,1
6385,3008200036,BK,5434 2 AVENUE,08,I6,NYU LANGONE HOSPITALS,2,1,1
6386,3008730016,BK,254 17 STREET,01,B2,RAMON PACHECO,2,1,1
6387,3009350009,BK,63 5 AVENUE,04,S2,TORANZO REALTY CORP,2,1,1
6388,3009477505,BK,51 LINCOLN STREET,02,R1,"PARK SLOPE TOWNHOUSE, LLC",2,1,1
6389,3010270029,BK,198 12 STREET,01,A5,"RENZ, SANDYE",2,1,1
6390,3012850075,BK,1307 CARROLL STREET,01,A4,DRIZIN CHAIM,2,1,1
6391,3013690035,BK,1620 PROSPECT PLACE,02,C3,PROSPECT RESIDENTS LLC,2,1,1
6392,3013690068,BK,1613 PARK PLACE,02,C3,1613 PARK PLC LLC,2,1,1
6393,3014020064,BK,1651 PRESIDENT STREET,01,B1,CAPLAN FAMILY TRUST,2,1,1
6394,3014070020,BK,1574 PRESIDENT STREET,01,A5,WOONTEILER FAMILY TRUST,2,1,1
6395,3014080060,BK,1619 CARROLL STREET,01,B1,"BORENSTEIN, YEHUDA",2,1,1
6396,3014080061,BK,1617 CARROLL STREET,01,B1,"REZNIKOV, ILYA",2,1,1
6397,3014140079,BK,717 CROWN STREET,01,B1,"WEINGARTEN, SCHNEUR ZALMEN",2,1,1
6398,3014150082,BK,813 CROWN STREET,02,C3,"DELACRUZ, SILVESTRE",2,1,1
6399,3014677501,BK,430 SARATOGA AVENUE,04,RM,UNAVAILABLE OWNER,2,1,1
6400,3015910050,BK,323 HART STREET,02,C0,HUGGINS LA VERNE M,2,1,1
6401,3016410050,BK,665 MADISON STREET,02,C0,TIMOTHY & PAMELA WHITE,2,1,1
6402,3017360014,BK,84 SANDFORD STREET,08,W2,"YISMACH MOSHE OF WILLIAMSBURGH, INC.",2,1,1
6403,3019700017,BK,84 LEXINGTON AVENUE,01,B3,"RODRIGUEZ, DINAH E",2,1,1
6404,3020950045,BK,653 FULTON STREET,05,J3,NYC DEPARTMENT OF CULTURAL AFFAIRS,3,2,1
6405,3022400013,BK,52 MIDDLETON STREET,02,C3,MAZAH,2,1,1
6406,3024440026,BK,804 DRIGGS AVENUE,02,C3,"MTC ASSOC, LLC",2,1,1
6407,3027670062,BK,87 AINSLIE STREET,02,C0,"FRANZESE, CARMINE S JR",2,1,1
6408,3030580001,BK,30 MONTROSE AVENUE,03,D4,LINDSAY PARK HGS CORP,4,3,1
6409,3032260003,BK,743 BUSHWICK AVENUE,02,C0,"ROSADO, BELINDA",2,1,1
6410,3032657501,BK,57 HIMROD STREET,02,R1,57 HIMROD LLC,2,1,1
6411,3033500045,BK,131 WOODBINE STREET,01,B2,"OKUNEFF, ANDREW",2,1,1
6412,3034120042,BK,283 ELDERT STREET,02,C3,ELDERT PROPERTIES NY LLC,2,1,1
6413,3035960024,BK,855 SARATOGA AVENUE,08,M1,HOLY REDEEMER BAPTIST CHURCH INC,2,1,1
6414,3037970001,BK,393 POWELL STREET,03,D3,NYC HOUSING AUTHORITY,2,1,1
6415,3040460035,BK,550 WARWICK STREET,02,C3,"LONDON, JUNE A",2,1,1
6416,3040760022,BK,864 DUMONT AVENUE,01,B2,"GARCIA, YESSENIA",2,1,1
6417,3042840119,BK,713 HEMLOCK STREET,01,A5,MATTHIAS LEROY,2,1,1
6418,3043600011,BK,820 ELTON STREET,01,B2,"MCKIE, CHARLENE",2,1,1
6419,3045000001,BK,2372 LINDEN BOULEVARD,05,O7,THE ROGOSIN INSTITUTE INC,2,1,1
6420,3045050015,BK,854 EUCLID AVENUE,01,B3,"MUKAILA , FAUZIATU",2,1,1
6421,3045980079,BK,35 EAST 95 STREET,02,C3,"DWYER, LOLA LEE",2,1,1
6422,3046270028,BK,260 EAST 92 STREET,02,C0,NYS DORM AUTH,2,1,1
6423,3046590039,BK,227 EAST 53 STREET,02,C0,RHODEN GERALD,2,1,1
6424,3046820064,BK,147 EAST 56 STREET,02,C0,PIERRE GABRIEL,2,1,1
6425,3047190029,BK,540 EAST 48 STREET,01,A1,CHARLES A GORDON JR,2,1,1
6426,3047710013,BK,704 EAST 51 STREET,02,C0,CARL B LASHLEY,2,1,1
6427,3048630031,BK,565 LINDEN BOULEVARD,01,B2,"REBECCA, TRUSTEE, MARIE MARGARETTE",2,1,1
6428,3048840063,BK,1469 NOSTRAND AVENUE,04,S2,1469 LLC,2,1,1
6429,3049480032,BK,360 EAST 32 STREET,01,B3,"LASHLEY, ONEIL R",2,1,1
6430,3049490035,BK,1286 NEW YORK AVENUE,02,C0,1286 NEW YORK ESTATES LLC,2,1,1
6431,3051450005,BK,1416 BEVERLEY ROAD,01,A3,"INTRATER, ZACHARY A",2,1,1
6432,3053640060,BK,1547 41 STREET,01,B1,"1330 REALTY, LLC",2,1,1
6433,3053790081,BK,1617 44 STREET,01,B1,"BIRNBAUM, RESI",2,1,1
6434,3054320043,BK,4406 17 AVENUE,01,B1,KOLLEL DERECH HCHAIMOHEL ALTE FAIGE,2,1,1
6435,3054340068,BK,1647 46 STREET,11,V0,"TEMPLER, SYLVIA",2,1,1
6436,3054690025,BK,1954 51 STREET,01,A5,MINZER BARRY,2,1,1
6437,3054730064,BK,1735 53 STREET,01,B1,HELLER MIRIAM,2,1,1
6438,3054740068,BK,1831 53 STREET,01,B1,"FRIEDMAN, JACOB",2,1,1
6439,3054787501,BK,1607 54 STREET,02,R3,NAME NOT ON FILE,2,1,1
6440,3055040019,BK,1730 58 STREET,01,A9,"FRIEDMAN, HERSCHEL",2,1,1
6441,3055080060,BK,2143 59 STREET,01,A9,"STERLING, HANA RONIT",2,1,1
6442,3055200068,BK,1927 61 STREET,01,B3,EL MAADAWY MOUSSA,2,1,1
6443,3055820007,BK,3801 NEW UTRECHT AVENUE,07,U7,NYC TRANSIT AUTHORITY,2,1,1
6444,3056070021,BK,936 44 STREET,01,B1,"DAVID A. ORLANDER, AS TRUSTEE",2,1,1
6445,3056540016,BK,1122 51 STREET,01,B1,YEHUDA RUBENSTEIN,2,1,1
6446,3056700011,BK,1314 53 STREET,02,C0,MEISELS CHAYA,2,1,1
6447,3056740022,BK,1056 54 STREET,08,W9,CONGREGATION TORAS YUFA,2,1,1
6448,3056820011,BK,1114 55 STREET,04,S1,1114 55 STREET LLC,2,1,1
6449,3056970028,BK,1260 57 STREET,02,C0,ABRAHAM KLEIN,2,1,1
6450,3057030015,BK,1134 58 STREET,01,B1,PERLSTEIN BARRY,2,1,1
6451,3057650057,BK,1065 68 STREET,01,B2,"JIANG, CAI HUA",2,1,1
6452,3058560028,BK,520 67 STREET,01,B3,"GAO, GONG JIAN",2,1,1
6453,3059390020,BK,238 BAY RIDGE PARKWAY,02,C1,RIDGECREST REALTY LLC,6,5,1
6454,3059750043,BK,41 80 STREET,01,A1,"TZIVAS, ODYSSEAS",2,1,1
6455,3060300003,BK,8415 10 AVENUE,01,B3,"IBRAHIM, MAHMOUD I",2,1,1
6456,3060520014,BK,11 GELSTON AVENUE,01,B1,URSULA E GIKAS,2,1,1
6457,3061420075,BK,240 BATTERY AVENUE,01,A5,"CILENTO, STEPHEN  A",2,1,1
6458,3061910033,BK,1562 72 STREET,01,B3,MICHELL LU INCORPORATED,2,1,1
6459,3062020028,BK,1552 73 STREET,02,C0,"MEI, MU XUE",2,1,1
6460,3062400060,BK,2043 77 STREET,01,B2,MEI QIN CHEN,2,1,1
6461,3062930029,BK,1448 81 STREET,01,A1,"GIBBIA, PAUL",2,1,1
6462,3063250036,BK,1666 84 STREET,01,B1,MCCARTHY PETER,2,1,1
6463,3063800055,BK,8628 BAY PARKWAY,01,B9,"LI, QIAO JIANG",2,1,1
6464,3064000057,BK,8695 17 AVENUE,02,C2,"WONG, ERIC",2,1,1
6465,3065210055,BK,993 EAST 8 STREET,01,A1,"SILVERA, ISAAC",2,1,1
6466,3065260003,BK,306 AVENUE J,01,B2,BENJAMIN WYGODA,2,1,1
6467,3065280069,BK,1143 EAST 7 STREET,01,A3,"MOSSERY, SHERENE",2,1,1
6468,3065400010,BK,424 AVENUE L,01,A9,"SHAMAH, SAMUEL",2,1,1
6469,3065430054,BK,705 AVENUE M,01,B3,"LEVY, EZRA",2,1,1
6470,3065460007,BK,1542 CONEY ISLAND AVENUE,08,M1,CONGREGATION KEHAL IMREI SHAUL,2,1,1
6471,3065720070,BK,1349 EAST 9 STREET,01,A1,HIRSCH RAYMOND,2,1,1
6472,3066000006,BK,118 AVENUE O,02,C0,"JOA, RAMON",2,1,1
6473,3066100032,BK,1668 EAST 4 STREET,02,C2,COLUCCIO JOSEPH,2,1,1
6474,3066150013,BK,1522 EAST 9 STREET,01,A1,"ERANI, FREDDIE",2,1,1
6475,3066450035,BK,1766 WEST 11 STREET,01,B3,"NOVINI, WILLIAM",2,1,1
6476,3066630087,BK,1711 OCEAN PARKWAY,01,B1,"KASSAB, MORRIS",2,1,1
6477,3066640017,BK,1722 EAST 8 STREET,01,B3,"RUDY, STEVEN",2,1,1
6478,3067050058,BK,977 EAST 12 STREET,04,S5,MAZAL 57 LLC,2,1,1
6479,3067210037,BK,1043 EAST 19 STREET,01,A1,TZVI SCHECHTER,2,1,1
6480,3067220028,BK,1162 EAST 12 STREET,08,M1,CONGREGATION RABBINECAL INSTITUTE BETH M EDRASH LAT,2,1,1
6481,3067500065,BK,1479 EAST 12 STREET,01,A9,"COHEN, AVROHOM Y",2,1,1
6482,3067970041,BK,1772 EAST 15 STREET,01,B2,KZM PROPERTY GROUP INC.,2,1,1
6483,3068070022,BK,3842 BEDFORD AVENUE,01,A1,"SKABA, JACK M",2,1,1
6484,3069170083,BK,135 BAY 49 STREET,01,B3,LING C CHEUNG,2,1,1
6485,3069980010,BK,4019 MANHATTAN AVENUE,01,A1,"TESLYA, VYACHESLAV",3,2,1
6486,3070110071,BK,2849 WEST 29 STREET,01,A5,LEARIE P GOMES,2,1,1
6487,3071040128,BK,1914 EAST 1 STREET,01,A1,RHONDA CHABBOTT,2,1,1
6488,3071160045,BK,2125 WEST 11 STREET,01,B1,MANTELLO MARIA,2,1,1
6489,3071280017,BK,2162 EAST 2 STREET,02,C0,"ARAMAN, SOLLY",2,1,1
6490,3071300019,BK,2192 EAST 4 STREET,01,A5,ROBERT FALACK 2015 REVOCABLE TRUST,2,1,1
6491,3071330052,BK,2147 OCEAN PARKWAY,01,A3,"GINDI, MOUSSA",2,1,1
6492,3071340055,BK,2219 EAST 7 STREET,01,A9,"MIZRAHI, MOISE",2,1,1
6493,3071530034,BK,2284 EAST 2 STREET,01,A5,"CHAKALO, SELIM",2,1,1
6494,3071590066,BK,720 GRAVESEND NECK ROAD,01,B2,HASSOUN SAUL A,2,1,1
6495,3072050061,BK,2543 STILLWELL AVENUE,06,E1,2543 STILLWELL AVENUE,4,3,1
6496,3072950004,BK,1614 AVENUE S,01,B2,"DANESHPANAHI, BIJAN D",2,1,1
6497,3073180071,BK,2025 EAST 13 STREET,01,A3,"JARADA, ZAKI",2,1,1
6498,3073780040,BK,2282 EAST 18 STREET,01,A2,"LEE, GARY",2,1,1
6499,3074130065,BK,2453 EAST 12 STREET,01,A9,"KOROLEV, YURIY",2,1,1
6500,3074160072,BK,2413 EAST 14 STREET,02,C0,CRUZ ISRAEL,3,2,1
6501,3074220317,BK,2424 EAST 23 STREET,01,B1,MARTIN KORNBERG,2,1,1
6502,3075570035,BK,2808 GLENWOOD ROAD,01,B2,"AIKEN, JEROME",2,1,1
6503,3075910052,BK,916 EAST 28 STREET,01,A9,"MAGID, ABIGAIL",2,1,1
6504,3076030029,BK,1169 EAST 21 STREET,01,A1,"GOLDBRENNER, ISAAC",2,1,1
6505,3076070081,BK,1074 EAST 26 STREET,01,A1,"EHRMAN, ABRAHAM J",2,1,1
6506,3076340078,BK,1276 EAST 35 STREET,01,A1,"WEISS, JODI MICHELLE",2,1,1
6507,3076460073,BK,1266 EAST 29 STREET,01,A1,BENZION FRANKEL,2,1,1
6508,3076490035,BK,1223 EAST 31 STREET,01,B2,GREENFIELD BENJAMIN,2,1,1
6509,3076530018,BK,1351 EAST 35 STREET,01,B9,"ABRAMOWITZ, DOV M",2,1,1
6510,3076610034,BK,3427 BEDFORD AVENUE,01,A1,KLEINMAN MARTIN,2,1,1
6511,3076650025,BK,1351 EAST 29 STREET,01,A1,"FELSENSTEIN, YAEL",2,1,1
6512,3076750047,BK,1539 EAST 21 STREET,01,A1,"LATI, GEORGE",2,1,1
6513,3076760012,BK,2230 OLEAN STREET,01,A2,S.C.L. LLC,2,1,1
6514,3076950013,BK,1565 EAST 33 STREET,01,B1,"D'AMATO, ANGELINA",2,1,1
6515,3077000044,BK,3818 FLATLANDS AVENUE,01,B2,"BACHAN GIBSON, INDRA",2,1,1
6516,3077080032,BK,1627 EAST 35 STREET,01,A9,"MAYLEAS, ROLF",2,1,1
6517,3077220039,BK,3802 GLENWOOD ROAD,02,C1,GLENWOOD ROAD PROPERTIES LLC,2,1,1
6518,3077430056,BK,968 EAST 40 STREET,01,B2,"HAGLEY, NIGEL",2,1,1
6519,3077440038,BK,961 EAST 40 STREET,01,A9,ALBERT MOORE,2,1,1
6520,3080090043,BK,714 EAST 89 STREET,01,A9,"JEANTY,JR, REMY",2,1,1
6521,3080610020,BK,1251 EAST 82 STREET,01,B1,DA VINCI DEVELOPMENT CORP,2,1,1
6522,3081730005,BK,10413 GLENWOOD ROAD,01,B2,"GONZALEZ, RUBEN",2,1,1
6523,3082110050,BK,918 EAST 104 STREET,01,B2,EDITH FIRMIN IRREVOCABLE TRUST,2,1,1
6524,3082610056,BK,1804 ROCKAWAY PARKWAY,01,B1,JANNAH PROPERTIES INC.,2,1,1
6525,3082750015,BK,1559 EAST 91 STREET,01,A1,"BRYAN, LETECHIA",2,1,1
6526,3084050004,BK,6216 AVENUE T,01,A1,"SCANDIFFIO, ANN",2,1,1
6527,3084870016,BK,2281 SCHENECTADY AVENUE,04,O8,"ADAMS, ROGER",2,1,1
6528,3085040028,BK,1937 EAST 37 STREET,01,A9,"HO, PO YEE",2,1,1
6529,3085230045,BK,3722 AVENUE S,01,B1,ROCCO LOCCISANO,2,1,1
6530,3087480172,BK,118 FALMOUTH STREET,01,B3,"KOGAN , BEATA",2,1,1
6531,4003310002,QN,11-03 36 AVENUE,04,S2,"UZ-PLUS, LLC",2,1,1
6532,4004050013,QN,40-29 27 STREET,05,O5,40-29 27TH STREET ASSOCIATES CORP,3,2,1
6533,4005960033,QN,26-17 28 STREET,03,D9,VICTORIO PACE LLC,2,1,1
6534,4007170029,QN,44-02 ASTORIA BOULEVARD S,07,G5,"GTY-CPG(QNS/BX)LEASING, INC.",2,1,1
6535,4007460063,QN,24-22 49 STREET,06,E1,3E REALTY CORP.,2,1,1
6536,4007560073,QN,20-60 HAZEN STREET,01,A1,"ABUALLAN, AHMAD",2,1,1
6537,4008080055,QN,21-56 38 STREET,01,A5,"FOX, JEFFERY",2,1,1
6538,4008240031,QN,35-04 21 AVENUE,02,C0,"GIANNAKIDIS, MARGARETA",2,1,1
6539,4009030043,QN,26-28 12 STREET,02,C2,26-28 12TH STREET REALTY LLC,2,1,1
6540,4010640002,QN,86-01 23 AVENUE,08,W3,COLLEGE OF AERONAUTICS,2,1,1
6541,4010880027,QN,23-48 95 STREET,01,A2,A EPPS,2,1,1
6542,4011560030,QN,32-42 55 STREET,02,C1,32-42 55TH STREET REALTY LLC,2,1,1
6543,4012100020,QN,37-26 56 STREET,01,B2,HORHOUZ 56TH STREET LLC,2,1,1
6544,4012310001,QN, ROOSEVELT AVENUE,07,U7,LIRR,2,1,1
6545,4013050044,QN,40-32 74 STREET,04,S4,"RAHMANIA PROPERTIES, LLC",2,1,1
6546,4013130004,QN,41-55 73 STREET,01,B2,"CHOZOM, DICKEY",2,1,1
6547,4014140023,QN,32-38 85 STREET,01,A5,"PHUNTSOK, TSERING",2,1,1
6548,4014640015,QN,35-18 91 STREET,01,B1,"RAMAUTAR, URCILLA",2,1,1
6549,4016720010,QN,108-14 DITMARS BOULEVARD,01,B3,"RODOLPHE, MONIQUE T",2,1,1
6550,4017620017,QN,37-24 100 STREET,01,B2,"ROBINSON, MARY",2,1,1
6551,4017740039,QN,37-56 108 STREET,04,K4,37-56 108TH STREET CORP.,2,1,1
6552,4018520075,QN,90-17 51 AVENUE,01,B3,"OO AUNG, WIN",2,1,1
6553,4018530030,QN,90-44 51 AVENUE,01,A5,"DONG, QINGQI",2,1,1
6554,4018770036,QN,94-47 50 AVENUE,02,C0,IRMA SERRANO,2,1,1
6555,4019510052,QN,57-36 PENROD STREET,01,B9,PATRICK WARDERS,2,1,1
6556,4019520045,QN,57-43 PENROD STREET,02,C2,"TSI PROPERTIES I, INC.",2,1,1
6557,4019710017,QN,59-17 VAN DOREN STREET,02,C0,"CARDENAS , HENRY",2,1,1
6558,4019920018,QN,104-38 48 AVENUE,01,B3,INDIANA LIRIANO,2,1,1
6559,4019960063,QN,108-53 41 AVENUE,01,B3,PENA TEOFILO,2,1,1
6560,4020030180,QN,108-21 48 AVENUE,01,B1,"CHEN, QIUFANG",2,1,1
6561,4020070086,QN,108-15 52 AVENUE,02,C0,LAI W CHAN,2,1,1
6562,4020930001,QN,61-15 98 STREET,03,D4,PARK CITY ESTATES TENANTS CORP,5,4,1
6563,4022210059,QN,108-19 70 AVENUE,01,A3,"KANDOV , VIOLETA",2,1,1
6564,4022460031,QN,71-11 112 STREET,08,M1,TEMPLE SINAI,3,2,1
6565,4024030002,QN,53-31 66 STREET,01,A1,"LEGGIO, DORI-ANN",2,1,1
6566,4025010042,QN,69-43 GRAND AVENUE,04,S2,ANTZOULIS FAMILY LIMITED PARTNERSHIP,2,1,1
6567,4027260049,QN,60-19 59 AVENUE,01,B2,"ZHU, QIN",2,1,1
6568,4027620053,QN,62-94 60 DRIVE,01,B2,62-94 60TH DRIVE LLC,2,1,1
6569,4028190104,QN,73-10 58 AVENUE,01,B2,"DELLILUNE, DONNA M",2,1,1
6570,4028670017,QN,86-40 55 AVENUE,01,B1,"CHEN, MARGARET W",2,1,1
6571,4028970045,QN,58-11 84 PLACE,02,C0,ANNA MARIA DELLIGATTI LIVING TRUST,2,1,1
6572,4029720021,QN,62-30 83 PLACE,01,A1,"FANG, WEI",2,1,1
6573,4030360060,QN,75-26 FURMANVILLE AVENUE,01,B2,"SCIMEMI, PIETRO G",2,1,1
6574,4030410055,QN,65-12 79 PLACE,01,B3,"POSPISHIL, FRANK E",2,1,1
6575,4032220028,QN,70-48 MANSE STREET,01,A1,"GRODZKI, BOGUSLAW",2,1,1
6576,4032650037,QN,201 ASCAN AVENUE,01,B3,"FITZGERALD, CHRISTINE",2,1,1
6577,4033050018,QN,24 ROCKROSE PLACE,01,A1,"HUANG, JOSEPH",2,1,1
6578,4033550126,QN,83-38 TALBOT STREET,02,C0,8338 TALBOT INC.,2,1,1
6579,4034350055,QN,18-11 MENAHAN STREET,11,V0,565 SENECA LLC,3,2,1
6580,4035290013,QN,66-41 60 PLACE,02,C2,DJONA VUCIC,3,2,1
6581,4035520094,QN,16-29 STEPHEN STREET,10,G1,"GRAB, FRANCISZEK",3,2,1
6582,4035530097,QN,1613 NORMAN STREET,02,C0,HENRYKA GORZELSKA,2,1,1
6583,4035540016,QN,1616 NORMAN STREET,01,B1,"BENEDICTO, RYAN",2,1,1
6584,4035640004,QN,17-03 STEPHEN STREET,01,B3,DURKALEC GRAZYNA,2,1,1
6585,4036000060,QN,74-54 CYPRESS HILLS STREET,07,G4,LEENULTS PETROLEUM INC,2,1,1
6586,4036080078,QN,64-48 ADMIRAL AVENUE,01,B2,"NAVAS, CHRISTOPHER J",2,1,1
6587,4037320126,QN,80-07 64 LANE,01,A1,"GURUJAN, DOMENICA",2,1,1
6588,4037700008,QN,73-02 METROPOLITAN AVENUE,04,S2,7304 METRO LLC,2,1,1
6589,4038050011,QN,76-07 79 PLACE,01,B2,"KOENIG, MICHAEL M",3,2,1
6590,4038830029,QN,90-01 MYRTLE AVENUE,07,G4,"METRO NY DEALER STATIONS, LLC",3,2,1
6591,4039650039,QN,7-33 123 STREET,01,A1,"BREEN, GUY",2,1,1
6592,4039670030,QN,123-12 9 AVENUE,01,B1,SUMIN LIN,2,1,1
6593,4040950030,QN,128-02 14 AVENUE,07,G4,SMITHTOWN LAND CORP,2,1,1
6594,4041630030,QN,20-18 121 STREET,01,B1,"GUO, XIN XU",2,1,1
6595,4041650008,QN,21-01 COLLEGE POINT BLVD,05,K2,TIT HOW TSUI,2,1,1
6596,4044640143,QN,13-15 146 STREET,01,A1,EVANGELINE JOCSON,2,1,1
6597,4046620045,QN,149-42 CROSS ISLAND PARKWAY,05,K2,20-02 UTOPIA PKWY LLC,2,1,1
6598,4047050059,QN,151-30 18 AVENUE,01,B1,"TOTINO, RAE",2,1,1
6599,4047080064,QN,151-17 21 AVENUE,01,A1,"FANELLI, SAVERIO",2,1,1
6600,4048720001,QN,159-15 32 AVENUE,01,A1,"LIU, YUHAN",2,1,1
6601,4049630200,QN,36-30 COLLEGE POINT BLVD,06,E7,"AREC 8, LLC",2,1,1
6602,4050530033,QN,147-12 BARCLAY AVENUE,02,C0,"LIN, MIN",2,1,1
6603,4050590015,QN,150-12 BARCLAY AVENUE,08,M9,1ST PRESBY CH FLUSHIN,2,1,1
6604,4051190032,QN,135-14 ELDER AVENUE,01,B2,ANTHONY T CANNIZZARO,2,1,1
6605,4051190061,QN,56-64 136 STREET,02,C1,"COLU MANAGEMENT, LLC",2,1,1
6606,4051470034,QN,45-40 KISSENA BOULEVARD,01,B2,NAIK FAMILY TRUST U/A/D,2,1,1
6607,4053680030,QN,42-11 192 STREET,04,S1,JOHN P. FORTINI REVOCABLE TRUST,3,2,1
6608,4054270056,QN,43-32 170 STREET,01,A1,"DIMITRAKOPOULOS, PETER",2,1,1
6609,4054400081,QN,161-15 46 AVENUE,07,G4,LIPPERT  CHARLES,2,1,1
6610,4057600062,QN,166-29 21 ROAD,01,A0,"SOULOPULOS, MARION",2,1,1
6611,4059940067,QN,30-19 CORPORAL KENNEDY ST,01,A2,MARVIN J. GOLOMB,2,1,1
6612,4060220008,QN,29-04 200 STREET,01,B1,"TORRES, AS TRUSTEE, CAROLYN",2,1,1
6613,4061740014,QN,35-14 214 PLACE,02,C0,"WOOTEN, LOUIS D",2,1,1
6614,4063710030,QN,57-10 138 STREET,01,B1,SUPPLEMENTAL NEEDS TRUST FOR JOSEPH CHAN,2,1,1
6615,4063780130,QN,138-30 58 ROAD,01,B3,"ZHANG, RUI",2,1,1
6616,4063810011,QN,138-12 59 AVENUE,02,C0,"LIANG, YUXUN",2,1,1
6617,4065010022,QN,63-50 136 STREET,01,A5,"TAJES, JOSE",2,1,1
6618,4067320094,QN,154-28 59 AVENUE,01,A1,"AHMAD, DOR",2,1,1
6619,4067330028,QN,59-17 155 STREET,01,A1,STUART DRUCKER,2,1,1
6620,4067370023,QN,59-25 159 STREET,01,B3,"ZHENG, DE ZHU CHENG",2,1,1
6621,4069090056,QN,65-36 169 STREET,01,A2,"TURRIGIANO, GIOVANNI",2,1,1
6622,4070030041,QN,77-33 167 STREET,01,A0,"HOMES 26, INC.",2,1,1
6623,4073780017,QN,50-26 202 STREET,01,A1,"MARIANNE URSO TRUST DATED MAY 4, 2018",2,1,1
6624,4081480031,QN,39-55 GLENWOOD STREET,01,A1,DREW & LOIS S LEVY,2,1,1
6625,4081870059,QN,242-17 51 AVENUE,01,A1,JIAN M ZHOU,2,1,1
6626,4082470039,QN,51-08 BROWVALE LANE,01,A1,"MOSHOURIS, ANN V",2,1,1
6627,4086710080,QN,7745 268 STREET,01,A0,MARILYN LEVY TRUST,2,1,1
6628,4086790084,QN,77-26 263 STREET,01,A1,"MIFSUD, MARY D",3,2,1
6629,4089540001,QN,92-07 78 STREET,01,A5,SERGIO D ACOSTA,2,1,1
6630,4090880003,QN,86-06 102 AVENUE,02,C0,"GONZALEZ, MICHAEL  A",2,1,1
6631,4092350016,QN,84-16 120 STREET,01,B1,"LEE, ALYSSA",2,1,1
6632,4092680005,QN,85-09 122 STREET,01,A1,"SCHECHTER, MICHAEL",2,1,1
6633,4092790101,QN,86-37 125 STREET,01,B2,MOHABEER,2,1,1
6634,4092990001,QN,87-44 110 STREET,01,A1,"PENA, WILLIAM",2,1,1
6635,4093970004,QN,111-12 ATLANTIC AVENUE,05,K6,111-16 ATLANTIC REALTY CORP,2,1,1
6636,4094180103,QN,100-08 101 AVENUE,04,S2,100-08 HOLDING CORPORATION,2,1,1
6637,4094250021,QN,101-38 108 STREET,01,A1,"HETES, VEERAMAH",2,1,1
6638,4094990017,QN,101-30 132 STREET,01,A1,"ALI, CAMEEL",2,1,1
6639,4095280016,QN,104-24 106 STREET,01,B2,"TOU, LEI UN",2,1,1
6640,4095490067,QN,107-29 111 STREET,01,B2,SOOKRAJIE RAMPERSAUD,2,1,1
6641,4095600046,QN,103-23 123 STREET,01,B2,"DAS, CHANDRALEKHA",3,2,1
6642,4095880023,QN,134-11 105 AVENUE,01,A1,"OZONE QUEENS CORP.,",2,1,1
6643,4096070010,QN,127-20 107 AVENUE,01,A1,"PERSAUD, ANDREW D",2,1,1
6644,4096100038,QN,130-09 109 AVENUE,01,A1,"GORDILLO DE MEDINA, ANA A",2,1,1
6645,4096310075,QN,134-09 86 ROAD,01,A5,"ARA, BILKIS A",2,1,1
6646,4098110027,QN,91-13 175 STREET,02,C0,"UDDIN, TAHER",2,1,1
6647,4100250010,QN,95-10 WALTHAM STREET,01,B2,SABITA PALANIANDI,2,1,1
6648,4100440001,QN,144-02 105 AVENUE,01,A1,"SAVARESE, MICHAEL",2,1,1
6649,4101100019,QN,150-30 LIBERTY AVENUE,07,G2,LIBERTY TUCK NY LLC,2,1,1
6650,4102150035,QN,92-33 175 STREET,01,B2,UNAVAILABLE OWNER,2,1,1
6651,4102360062,QN,168-27 106 AVENUE,01,B3,"NEMBHARD, KENNETH MIC",2,1,1
6652,4102410028,QN,171-42 105 AVENUE,01,B2,"SANDERS, ETHEL A",2,1,1
6653,4102520058,QN,106-44 RUSCOE STREET,01,B1,"ROBINSON, JENE",2,1,1
6654,4102870001,QN,171-01 LINDEN BOULEVARD,07,G4,ALLIANCE ENERGY LLC,2,1,1
6655,4103100014,QN,114-14 179 STREET,01,A1,"WATKINS, MAKEDA C",2,1,1
6656,4103870043,QN,115-55 MEXICO STREET,01,A1,"ARCHER, TERRY D.",2,1,1
6657,4103990006,QN,187-11 TIOGA DRIVE,01,B2,BING  JAMES C,2,1,1
6658,4105260111,QN,86-41 MARENGO STREET,01,A2,"HAMMAD, OMAR",2,1,1
6659,4105620043,QN,91-18 211 STREET,01,A1,EVELYNE A MURAT,2,1,1
6660,4105690016,QN,211-30 90 COURT,01,A1,"MENDEZ, JESSICA M",2,1,1
6661,4106630074,QN,89-46 219 STREET,01,A1,"SPROUSE, MARIO E",2,1,1
6662,4106640025,QN,89-49 219 STREET,01,A1,KRALJ VICTORIO R,2,1,1
6663,4108290033,QN,198-28 CARPENTER AVENUE,01,B9,GAIL HOLLOWAY,2,1,1
6664,4108570032,QN,20934 99 AVENUE,01,A1,MASJID AR- RAHMAN INC,2,1,1
6665,4108670001,QN,200-02 100 AVENUE,01,A1,"MUKTADIR, SIKDER",2,1,1
6666,4109030029,QN,104-44 204 STREET,01,B3,"WOODALL, CONSTANCE",2,1,1
6667,4109430213,QN,109-68 204 STREET,01,B3,"WOODS, RENE SEKETHA",2,1,1
6668,4109680108,QN,112-13 FARMERS BOULEVARD,04,S1,"SCHRADER, ERIC",2,1,1
6669,4109860024,QN,209-06 112 AVENUE,01,A1,"WILLIS-FLOWERS, MARSHA A",2,1,1
6670,4109870046,QN,191-17 113 ROAD,01,A1,"STEPHENS, DUAYJAN",2,1,1
6671,4110170011,QN,114-12 201 STREET,01,A5,"WILLIAMS-LEWIS, ALTHIA",2,1,1
6672,4110270293,QN,114-07 208 STREET,01,A1,RUTH E THOMPSON,2,1,1
6673,4111060016,QN,218-19 103 AVENUE,01,A1,JOCELYN MARGARET,2,1,1
6674,4111250028,QN,112-11 COLFAX STREET,01,A1,"COMAS, CAROLE CHERUBIN",2,1,1
6675,4113550014,QN,133-18 76 STREET,01,A1,"11318 76TH AVE, CORP",2,1,1
6676,4113630043,QN,133-25 83 STREET,01,A5,"GUZMAN, ANA MARIA",2,1,1
6677,4114040128,QN,137-30 REDDING STREET,05,H3,PATKIN HOLDING LLC,2,1,1
6678,4116340061,QN,111-15 130 STREET,01,B3,"ROJAS, CESAR",2,1,1
6679,4116580051,QN,114-41 132 STREET,01,A1,"GHANNIAIMAN, JAMEEL A",2,1,1
6680,4117560006,QN,121-12 133 STREET,01,A1,"SINGH, RANJIT",2,1,1
6681,4117570073,QN,122-42 134 STREET,01,A1,HELENA  D. ISAAC,2,1,1
6682,4120440050,QN,120-41 146 STREET,01,A1,"SINGH , RENEKA",2,1,1
6683,4120500209,QN,123-44 147 STREET,01,B3,"HAND, CLIFTON",2,1,1
6684,4120500221,QN,123-66 147 STREET,01,A1,"BIGGS, MICHAEL P",2,1,1
6685,4121830018,QN,161-24 MATHIAS AVENUE,01,B3,"MORRIS-WINNINGHAM, KAMEISHA N",2,1,1
6686,4121910006,QN,115-35 155 STREET,01,B2,NICHOLAS GODFREY C,2,1,1
6687,4121980055,QN,115-33 158 STREET,01,B3,"CRUZ, LUIS YANEZ",2,1,1
6688,4122040164,QN,15348 FOCH BOULEVARD,01,A9,"HAMMOND, ERIC M",2,1,1
6689,4123320145,QN,114-14 169 STREET,01,A1,"BERCY, JOEL",2,1,1
6690,4123480121,QN,116-11 166 STREET,01,B3,YVONNE NEWELL,2,1,1
6691,4123760021,QN,119-56 MERRILL STREET,01,A2,"DAVIS, PEARL ETTA",2,1,1
6692,4126300058,QN,118-19 201 STREET,01,A1,"HETT, ROSALIE",2,1,1
6693,4126640005,QN,120-05 FARMERS BOULEVARD,01,A2,"THOMPSON, ROBERT",2,1,1
6694,4126650061,QN,189-17 121 AVENUE,01,A5,WILSON LEONA,2,1,1
6695,4127030025,QN,187-02 122 AVENUE,01,A1,"HARPER, KARL",2,1,1
6696,4128580040,QN,231-07 126 AVENUE,01,A2,JOHNSTON EULA,2,1,1
6697,4128940068,QN,130-58 219 STREET,01,A2,"ZEPHYRIN, EDDY",2,1,1
6698,4129620085,QN,223-15 MERRICK BOULEVARD,06,E1,MERRICK BOULEVARD ACQUISITIONS LLC,2,1,1
6699,4130230022,QN,137-20 THURSTON STREET,01,A1,ANTENOR BRUTUS,2,1,1
6700,4131690001,QN,228-17 138 AVENUE,01,A1,"SANDERMAN , JOAN",2,1,1
6701,4131780039,QN,230-14 138 AVENUE,01,A1,"OLIVERA, JASON",3,2,1
6702,4131810047,QN,138-20 233 STREET,01,A1,"CAMPBELL, LETONIA J.",2,1,1
6703,4132810021,QN,163-34 145 ROAD,01,A2,"BENNETT, JR., GEORGE",2,1,1
6704,4133030009,QN,146-70 FARMERS BOULEVARD,01,A5,"LETT, KEVIN",2,1,1
6705,4133510054,QN,179-12 146 ROAD,01,B3,"DUMAY, CHARLEMAGNE",2,1,1
6706,4135020019,QN,144-11 231 STREET,01,B2,"JEAN HENRITH PITTER, TRUSTEE OF THE JEAN  HENRITH",2,1,1
6707,4137500064,QN,148-14 HUXLEY STREET,01,A2,AVANIE SCANTLEBURY,2,1,1
6708,4139110105,QN,155-61 BROAD STREET,01,A2,DIANE KIRCHNER,2,1,1
6709,4141480045,QN,156-33 CROSS BAY BOULEVARD,05,K7,156-33 CROSS BAY BOULEVARD LLC,2,1,1
6710,4153210052,QN,17 WEST 17 ROAD,01,A2,"ROEHLING, MICHAEL",2,1,1
6711,4155710033,QN,7-91 CORNAGA AVENUE,01,A1,"RAPFOGEL , JONATHAN",2,1,1
6712,4161190065,QN,3-60 BEACH 88 STREET,02,C3,"SHAH, PADMINI",3,2,1
6713,4161680038,QN,186 BEACH 96 STREET,02,C0,"GLASS, DANIEL",3,2,1
6714,4161890050,QN,158 SHOREFRONT PARKWAY,09,Q4,NYC DEPARTMENT OF PARKS AND RECREATION,7,6,1
6715,4162220020,QN,231 BEACH 126 STREET,01,B3,"MUNDAY, MARY",2,1,1
6716,4162290073,QN,178 BEACH 120 STREET,02,C0,"KARALIS, JOHN",2,1,1
6717,4162710033,QN,2-29 BEACH 137 STREET,08,M9,CONGREGATION BAIS Y/B/H,2,1,1
6718,4163180018,QN,175 BEACH 144 STREET,01,A1,FRIEDLANDER SOLOMON,2,1,1
6719,5000250076,SI,73 CORSON AVENUE,02,C0,"PALOMA, MITCHELL I",2,1,1
6720,5000370050,SI,17 SCRIBNER AVENUE,01,B2,"STADLER, SIDNEY",2,1,1
6721,5001030043,SI,251 CORSON AVENUE,01,A1,251 CORSON AVENUE LLC,2,1,1
6722,5001550123,SI,432 PELTON AVENUE,01,A2,"SANTILLAN, FRANCES",2,1,1
6723,5001600017,SI,222 BEMENT AVENUE,01,B2,YEPEZ MARIA,2,1,1
6724,5001970102,SI,136 ALASKA STREET,10,G0,HARRY SANTANA,2,1,1
6725,5002150256,SI,871 POST AVENUE,04,S2,"871 POSTAVENUE REALTY, LLC",2,1,1
6726,5002380124,SI,182 DUBOIS AVENUE,01,B2,"PALAFOX, HIGINIO",2,1,1
6727,5002950070,SI,778 PELTON AVENUE,01,A1,SALVATORE TIRRO,2,1,1
6728,5003520020,SI,237 DUBOIS AVENUE,01,B9,JOHN PULICE,2,1,1
6729,5003730123,SI,98 CHANDLER AVENUE,01,A5,"CORDERO , JOSE A",2,1,1
6730,5004280005,SI,295 DEEMS AVENUE,01,A1,KEVIN NASH,2,1,1
6731,5004320028,SI,224 WILLARD AVENUE,01,A1,"BRUNO REV TRUST-JOHN R. BRUNO, TRUSTEE",2,1,1
6732,5004400009,SI,211 DEMOREST AVENUE,01,A1,"MICHAEL RYAN, TRUSTEE",2,1,1
6733,5004770042,SI,323 STEWART AVENUE,01,B2,"LIN, JIAN CHAI",2,1,1
6734,5005330014,SI,44 QUINN STREET,01,A1,HORACE DOUGLAS GREEN,4,3,1
6735,5006240003,SI,551 RICHMOND ROAD,01,A2,JOHN&MARIA KIRPAN,2,1,1
6736,5006310154,SI,60 STARBUCK STREET,01,B3,"LI, FRANKIE",2,1,1
6737,5007050337,SI,19 LA GUARDIA AVENUE,01,B2,"CHAUDHARY, SIBT U",2,1,1
6738,5007250068,SI,104 QUINLAN AVENUE,01,A2,"VILLAGE DEVELOPMENT CORP. OF S.I., INC.",2,1,1
6739,5007500001,SI,2402 VICTORY BOULEVARD,05,K2,WIESNER REALTY LLC,10,9,1
6740,5007600078,SI,193 GANSEVOORT BOULEVARD,01,A2,"ARGENZIANO, DANIEL",2,1,1
6741,5007850006,SI,653 WOOLLEY AVENUE,01,A2,"EMILIO, JENNIFER",2,1,1
6742,5008110040,SI,102 WELLBROOK AVENUE,01,A5,SUSAN J. CACCHETTI,2,1,1
6743,5008250023,SI,68 FILLMORE AVENUE,01,A5,"DOGALI, SUSAN",2,1,1
6744,5008840032,SI,51 EAST LOOP ROAD,01,A3,"VOZEOLAS, AMY",2,1,1
6745,5010090022,SI,8 AVENUE B,01,A1,CARLOS A CALDERON,2,1,1
6746,5011260093,SI,109 HOOKER PLACE,01,B3,AUDREY VASQUEZ,2,1,1
6747,5012550077,SI,65 DAVIDSON STREET,01,A5,MATTURA EDWARD,2,1,1
6748,5012570057,SI,188 GRANDVIEW AVENUE,01,B2,MIMIDINOVSKI SAKET,2,1,1
6749,5012610058,SI,202 BRABANT STREET,01,A5,"LIM, YULIYA",2,1,1
6750,5014400087,SI,381 LATHROP AVENUE,01,A2,"BENDER, CHRISTOPHER",2,1,1
6751,5015970201,SI,321C HILLMAN AVENUE,01,A5,ANTHONY VELEZ,2,1,1
6752,5020700001,SI,1779 RICHMOND AVENUE,05,O2,1779 RICHMOND AVE LLC,2,1,1
6753,5021130009,SI,127 GARY PLACE,01,B2,AUGUSTO SALARIS,2,1,1
6754,5022420081,SI,3191 RICHMOND ROAD,04,S2,"UASMBDY, LLC",2,1,1
6755,5022720050,SI,247 NUGENT STREET,01,A3,JARED S. BOBCHIN,2,1,1
6756,5022870044,SI,396 EDINBORO ROAD,01,A2,DONALD DEROSA,2,1,1
6757,5023790004,SI,375 TRAVIS AVENUE,01,A5,"TULUMELLO, RAFFAELLA",2,1,1
6758,5024017502,SI,150 RICHMOND HILL ROAD,02,R3,HONEY BEE CONDOMINIUMI,46,45,1
6759,5027760053,SI,99 CANNON AVENUE,01,B2,99 CANNON AVENUE CORP,2,1,1
6760,5028270089,SI,22 SYLVA LANE,02,C1,KITTIE FLATS LLC,7,6,1
6761,5028310153,SI,116 ABBOTT STREET,01,B3,MARY GRACE RUFFO,2,1,1
6762,5028490007,SI,511 TOMPKINS AVENUE,04,K4,DAO AND DAD LLC,2,1,1
6763,5028590088,SI,53 ST JOHNS AVENUE,01,A5,JIAN PING LI,2,1,1
6764,5028840048,SI,24 STEUBEN STREET,01,A1,"ILAHI, MAZHAR",2,1,1
6765,5029830049,SI,215 ST JOHNS AVENUE,01,A3,MAZZILLI PAUL,2,1,1
6766,5031200005,SI,69 WINDOM AVENUE,01,B2,"SHI, JIZU",2,1,1
6767,5032740022,SI,5 PIAVE AVENUE,01,B2,"LEI , JIAN HONG",2,1,1
6768,5033210054,SI,91 LIBERTY AVENUE,01,B2,"LIBERTY AVE CONSTRUCTION, INC.",3,2,1
6769,5033260049,SI,158 BATH AVENUE,01,B9,"CHEN, JIANG FEN",2,1,1
6770,5033420073,SI,239 SEAVIEW AVENUE,01,B2,"NAPOLETANO, DOMINICK",3,2,1
6771,5033760016,SI,347 CROMWELL AVENUE,01,B9,GRACE CHIRICOLLA TTSEE OF GRACE CHIRICOL LA REV. TR,2,1,1
6772,5033970028,SI,32 VULCAN STREET,02,C0,"SHALEESH, LUANE G",2,1,1
6773,5035320500,SI,1700 RICHMOND ROAD,03,D1,NYC HOUSING AUTHORITY,10,9,1
6774,5036040007,SI,151 GREELEY AVENUE,01,A1,"VELLIOS, DEMITRA",2,1,1
6775,5036460020,SI,293 BURBANK AVENUE,01,A0,VINCENT MOSOMILLO,2,1,1
6776,5036500029,SI,324 LIBERTY AVENUE,01,B9,ILYA KOZLOVSKY AS TRUSTEE,2,1,1
6777,5037540067,SI,305 SLATER BOULEVARD,01,B2,"TROVATO, ROBERT JR",2,1,1
6778,5038120004,SI,603 MIDLAND AVENUE,01,A6,"SBC NEW YORK, LLC",2,1,1
6779,5042030016,SI,113 NEW DORP PLAZA,04,O8,113 NEW DORP PLAZA LLC,2,1,1
6780,5042110008,SI,29 10 STREET,01,A5,"DIAZ, ANNIE",2,1,1
6781,5042470058,SI,118 LINDBERGH AVENUE,01,A1,"STROBEL , JOSEPH",2,1,1
6782,5046210005,SI,242 DEWEY AVENUE,01,A2,MICHAEL M ONER,2,1,1
6783,5051450008,SI,47 NELSON AVENUE,01,A2,ANTHONY/PATRICIA  PALAGONIA,2,1,1
6784,5052820011,SI,118 WILLIAM AVENUE,01,A2,"CUSICK, MICHAEL",2,1,1
6785,5053060093,SI,101 GOODALL STREET,01,A5,"YUDANOV, ALEKSEY",2,1,1
6786,5054180036,SI,66 WAKEFIELD ROAD,01,A2,GAIL FRANCIS,2,1,1
6787,5054330125,SI,2 HARDY PLACE,01,A1,HAROLD ERWOOD,2,1,1
6788,5054410100,SI,36 WOODLAND AVENUE,01,A1,"WOELKER, CHRISTIAN G",2,1,1
6789,5056260020,SI,106 PETRUS AVENUE,01,B2,"ANTONINA STARRIN, TRUSTEE",2,1,1
6790,5062490161,SI,35 ELY AVENUE,01,A1,"COTTONE, SANDRA",2,1,1
6791,5062760040,SI,330 DETROIT AVENUE,01,B2,"CULOTTA, JOSEPHINE",2,1,1
6792,5063330008,SI,676 EDGEGROVE AVENUE,01,B2,"RUTIGLIANO, DOMINICK",2,1,1
6793,5064530018,SI,9 ZEPHYR AVENUE,01,B2,"AMATO, FRANK",2,1,1
6794,5067840026,SI,28 VAIL AVENUE,01,B2,CUNNINGHAM GERALD,2,1,1
6795,5068100081,SI,122 LATOURETTE STREET,01,A1,"DAY, IRENE F",2,1,1
6796,5068730023,SI,455 DARLINGTON AVENUE,01,A1,"GOLDSTEIN, WAYNE",2,1,1
6797,5069980024,SI,1870 DRUMGOOLE ROAD EAST,08,W7,MESIVTHA TIFERETH JERUSALEM OF AMERICA,6,5,1
6798,5078590048,SI,671 YETMAN AVENUE,11,V0,SS YETMAN LLC,2,1,1
6799,5078830059,SI,393 MANHATTAN STREET,01,A5,MURACA THOMAS,2,1,1
6800,5079300006,SI,14 ASPINWALL STREET,01,A1,ANGELA ROCCANOVA,2,1,1
6801,5080500068,SI,546 CRAIG AVENUE,01,A1,MARIO AMOROSO,2,1,1
6802,1004080001,MN,68 ORCHARD STREET,04,C7,GRAND ORCHARD CORP.,2,1,1
6803,1004730010,MN,478 BROADWAY,04,K4,VNO BROOME STREET LLC,2,1,1
6804,1004760042,MN,23 THOMPSON STREET,04,C7,KENNETH ROSENBLUM,2,1,1
6805,1005520024,MN,35 WASHINGTON SQUARE W,08,H8,NEW YORK UNIVERSITY,2,1,1
6806,1006080068,MN,157 WEST 12 STREET,01,A4,12TH STREET TOWNHOUSE LLC,2,1,1
6807,1006910039,MN,508 WEST 20 STREET,05,K1,SHERWOOD 20 ASSOCIATES LLC,2,1,1
6808,1009660001,MN,400 EAST 35TH STREET,04,D7,UDR RIVERGATE LLC,2,1,1
6809,1010570141,MN,414 WEST 48 STREET,02,C4,414-24 WEST 48 ST ETAL,7,6,1
6810,1010600021,MN,419 WEST 50 STREET,01,B9,"MINOR,ROBERT",2,1,1
6811,1011220023,MN,11 WEST 69 STREET,03,D4,11 69 OWNERS CORPORATION,2,1,1
6812,1013260015,MN,235 EAST 52 STREET,08,Z4,GOVERNMENT OF REP ZAMBIA,2,1,1
6813,1017240131,MN,7 WEST 126 STREET,02,C5,FINNHAMN LLC,2,1,1
6814,1019010055,MN,148 WEST 117 STREET,02,C0,JOSEPH R LITTLE,2,1,1
6815,1020510121,MN,222 EDGECOMBE AVENUE,02,C5,"DUNKLEY, JULIETTE",2,1,1
6816,1021800095,MN,4275 BROADWAY,07,G4,RAGHEB RADWAN RLTY CORP.,2,1,1
6817,2022760001,BX,560 BROOK AVENUE,08,Y3,NYC ADMINISTRATION FOR CHILDRENS SERVICES,2,1,1
6818,2023980001,BX,614 COURTLANDT AVENUE,04,S3,"KAMBER, MICHAEL",2,1,1
6819,2024080016,BX,386 EAST 162 STREET,01,B9,"BLOOMFIELD, AS TRUSTEE, STEVEN JOEL",2,1,1
6820,2025720006,BX,346 POWERS AVENUE,02,C1,NYC DEPARTMENT OF HOMELESS SERVICES,2,1,1
6821,2027970031,BX,1789 MONROE AVENUE,04,S9,"216 E 175, LLC",2,1,1
6822,2033000075,BX,2663 BRIGGS AVENUE,01,B2,POLLARD LUCILLE,2,1,1
6823,2034980051,BX,440 SOUNDVIEW AVENUE,07,G3,"MCCOMBS, WILLIAM",2,1,1
6824,2036850033,BX,2152 HERMANY AVENUE,01,A1,"MEDFORD, FREDERICK",2,1,1
6825,2039180134,BX,1545 ST LAWRENCE AVENUE,01,B2,"PANIAGUA, JOVANNY",2,1,1
6826,2039680007,BX,2208 GLEBE AVENUE,01,B2,NILSA C. LLIBRE,2,1,1
6827,2040240047,BX,1612 TAYLOR AVENUE,02,C0,1612 TAYLOR AVENUE LLC,2,1,1
6828,2040650004,BX,1056 PIERCE AVENUE,01,B2,ANNA GALLO,2,1,1
6829,2040950034,BX,1716 FOWLER AVENUE,01,B2,1716 FOWLER LLC,2,1,1
6830,2041200025,BX,1710 TENBROECK AVENUE,01,B1,PMC REO FINANCING TRUST,2,1,1
6831,2041670005,BX,1634 PLYMOUTH AVENUE,01,A1,"SANCHEZ, VIELCA",2,1,1
6832,2041780018,BX,3533 BRUCKNER BOULEVARD,11,V0,PARK VIEW BAY LLC,3,2,1
6833,2044810114,BX,1536 ALLERTON AVENUE,01,A5,NELSON MONTERO,2,1,1
6834,2046230044,BX,3343 OLINVILLE AVENUE,01,B2,"HERRERA, FREDIS",2,1,1
6835,2046550074,BX,653 EAST 220 STREET,01,B2,"WILLIE, O'NIEKA KENDRA",2,1,1
6836,2046630189,BX,717 EAST 215 STREET,01,B1,"KNIGHT, BERTRAM",2,1,1
6837,2046710031,BX,3520 BARNES AVENUE,01,B2,"HARRIOTT , DELROY",2,1,1
6838,2047440011,BX,3337 MICKLE AVENUE,02,C0,ENYIEMA JULIE,2,1,1
6839,2048680012,BX,955 EAST 232 STREET,02,C0,JENNIFER S HANIFF,2,1,1
6840,2048860070,BX,3409 EDSON AVENUE,01,A9,3409 EDSON PROPERTY LLC,2,1,1
6841,2049500077,BX,3728 DYRE AVENUE,01,A5,YOUNG BX 597 LLC,2,1,1
6842,2049800006,BX,4018 GRACE AVENUE,01,B3,"RAMHARAK, RAJENDRADAT",2,1,1
6843,2049840038,BX,4088 WILDER AVENUE,01,B9,"OSUOHA, STANLEY",2,1,1
6844,2050120007,BX,1812 PITMAN AVENUE,01,A1,HENRY SMITH,2,1,1
6845,2050500014,BX,4328 BOYD AVENUE,01,B3,"POLANCO, GAUDY",2,1,1
6846,2050590070,BX,4319 MURDOCK AVENUE,01,B2,"NELSON, ALICIA E",2,1,1
6847,2050970001,BX,2091 NEREID AVENUE,02,C0,UNITED PLAZA OF BRONX LLC,2,1,1
6848,2053250019,BX,1160 VINCENT AVENUE,01,A1,RIVIECCIO KATHERINE,2,1,1
6849,2053320030,BX,1232 PURITAN AVENUE,01,B2,"MARTINEZ, JOSE E",2,1,1
6850,2053620039,BX,3207 BRUCKNER BOULEVARD,01,A5,"LIN, FANG",2,1,1
6851,2053730046,BX,2841 CODDINGTON AVENUE,01,B2,"PALCHIZACA TENEZACA, JOSE W",2,1,1
6852,2053930009,BX,2924 ZULETTE AVENUE,02,C0,"REGINA, FRANK  R",2,1,1
6853,2054110275,BX,1536 DWIGHT PLACE,01,A1,"CAMPIONE, JOSEPH",3,2,1
6854,2054140114,BX,3288 RADIO DRIVE,01,B1,"HUANG, SHENG",2,1,1
6855,2054170176,BX,1649 BAY SHORE AVENUE,02,C0,"MASIELLO, CAROL",2,1,1
6856,2054530138,BX,2909 SCHURZ AVENUE,01,B1,SCHURZ 9 LLC,2,1,1
6857,2055190036,BX,272 BLAIR AVENUE,01,A5,"MCCORMACK, JEANNETTE",2,1,1
6858,2055800124,BX,318 BRINSMADE AVENUE,01,A1,"REYES, LUIS E",2,1,1
6859,2056260300,BX,75 EARLEY STREET,01,B3,"TREIBER , DANIEL  B",2,1,1
6860,2056280143,BX,77 SCHOFIELD STREET,01,A1,PANZA MARIA A,2,1,1
6861,2056440274,BX,320 KING AVENUE,01,A2,"CARMAN, CHARLES W.",2,1,1
6862,2058680681,BX,357 WEST 259 STREET,01,B1,"KLEIMAN,EPHRAIM",2,1,1
6863,3001210023,BK,184 CONCORD STREET,02,C0,184 CONCORD REALTY LLC,2,1,1
6864,3003390050,BK,271 UNION STREET,02,C2,271 UNION LLC,2,1,1
6865,3006390041,BK,684 4 AVENUE,01,B9,"QUISPE, FERNANDO",2,1,1
6866,3006810051,BK,217 33 STREET,01,B9,"ROSARIO, JORGE",2,1,1
6867,3006810115,BK,184 32 STREET,01,A5,CHERYL JAGGERNAUTH,2,1,1
6868,3007600008,BK,4603 8 AVENUE,04,D7,ZHONG GENG GROUP LLC,2,1,1
6869,3007780007,BK,4807 8 AVENUE,04,S2,WALLACE YU,2,1,1
6870,3008730050,BK,299 18 STREET,01,B2,MARGARET O'CONNELL,2,1,1
6871,3008860056,BK,357 20 STREET,01,B2,BIEN-AIME SACHA M,4,3,1
6872,3010280021,BK,246 12 STREET,01,B2,"WHITTAKER FAMILY TRUST, DATED JULY 11, 2 011",2,1,1
6873,3010340041,BK,524 5 AVENUE,04,K4,M.S. REALTY 524 HOLDINGS LLC,2,1,1
6874,3012920062,BK,455 CROWN STREET,01,B1,"BEN-ABOU, YIZHAK",2,1,1
6875,3013480006,BK,103 SCHENECTADY AVENUE,01,A9,"LI, MIN",2,1,1
6876,3013720036,BK,1386 PARK PLACE,01,B3,"COOPER, BEVERLY",2,1,1
6877,3014130015,BK,1552 CARROLL STREET,04,S1,CHEVRA MACHZIKET H'SHECHONA,2,1,1
6878,3014130016,BK,1556 CARROLL STREET,01,B1,BRUMMEL ELLEN,2,1,1
6879,3014460034,BK,2132 DEAN STREET,08,M1,NEW FRONTIER BAPTISTCHURCH INC,2,1,1
6880,3016000010,BK,1086 BROADWAY,04,D7,"AML BROADWAY, LLC",2,1,1
6881,3018220025,BK,160 MADISON STREET,01,A4,ST HILAIRE AUGUSTINE,2,1,1
6882,3019660047,BK,51 LEXINGTON AVENUE,06,F5,53 LEXINGTON ASSOCIATES LLC,2,1,1
6883,3019990015,BK,2 SPENCER PLACE,02,C1,IMPACCT HOUSING DEVELOPMENT FUND CORPORA TION,2,1,1
6884,3020000040,BK,1193 FULTON STREET,05,K1,MEGHNA REALTY CORP.,2,1,1
6885,3024370131,BK,351 SOUTH 4 STREET,01,B2,GITTY KREMER,2,1,1
6886,3024620002,BK,306 RODNEY STREET,08,M1,ST PAULS EVAN 6 CHUR,2,1,1
6887,3025660009,BK,88 MILTON STREET,02,C0,KATHLEEN QUIGLEY,2,1,1
6888,3027390026,BK,415 GRAHAM AVENUE,04,S9,415 GRAHAM AVENUE LIMITED PARTNERSHIP,4,3,1
6889,3027470010,BK,62 JACKSON STREET,01,B9,"CASAIS, KRISTEN",2,1,1
6890,3027730041,BK,41 POWERS STREET,01,B9,"HIGA, IRENE",2,1,1
6891,3029420001,BK,222 MORGAN AVENUE,06,F4,"ROLLING FRITO-LAY SALES,LP",5,4,1
6892,3032850026,BK,72 HARMAN STREET,01,B3,"CAMPOS, BELKIS",2,1,1
6893,3033770041,BK,291 CORNELIA STREET,02,C2,"291 CORNELIA, LLC",2,1,1
6894,3034220050,BK,133 SCHAEFER STREET,08,M3,PILGRIM BAPTIST CHURCH,3,2,1
6895,3035650030,BK,24 DUMONT AVENUE,07,G3,TOMORROW LLC,2,1,1
6896,3035800032,BK,292 GRAFTON STREET,01,B1,"GILGEOURS, MARLON",2,1,1
6897,3035960017,BK,873 SARATOGA AVENUE,01,B1,CUMMINGS RITA,2,1,1
6898,3036390017,BK,687 WATKINS STREET,02,C3,"SILVA, GRACE PICKETT",2,1,1
6899,3037240004,BK,247 WYONA STREET,01,B2,"WILLIAMS, HARRY L",2,1,1
6900,3038090015,BK,509 WYONA STREET,01,B1,"HINDS, SELWYN W.A.",2,1,1
6901,3039530033,BK,250 CLEVELAND STREET,01,B3,"CASTILLO, REYNA",2,1,1
6902,3039580013,BK,185 SHEPHERD AVENUE,02,C0,"RODRIGUEZ, VICTOR",2,1,1
6903,3039810005,BK,321 BARBEY STREET,01,B2,"LARA , JOHNNY",2,1,1
6904,3039810020,BK,272 JEROME STREET,01,B3,"BUDHU, HEMCHAN",2,1,1
6905,3039990016,BK,674 GLENMORE AVENUE,07,G9,DAVID B HOLDER,2,1,1
6906,3040660025,BK,650 LINWOOD STREET,01,B2,NNATUBENGO IKECHUKWU,2,1,1
6907,3041080118,BK,63 AUTUMN AVENUE,01,B3,CRUZ JULIO,3,2,1
6908,3041230017,BK,152 ELDERT LANE,01,A5,"WOO, LESBIA",2,1,1
6909,3041670007,BK,317 CRESCENT STREET,04,K4,3386 ATLANTIC REALTY LLC,2,1,1
6910,3042460036,BK,290 FOUNTAIN AVENUE,02,C0,"SAUNDERS, NANNIE MAE",2,1,1
6911,3044560033,BK,452 MILFORD STREET,02,C3,"SEABROOK, GREGORY",3,2,1
6912,3045970015,BK,14 EAST 95 STREET,01,B1,"SMITH, ALAMA BOYKE",2,1,1
6913,3046060073,BK,55 EAST 52 STREET,01,B1,"DIXON, JULIAN",2,1,1
6914,3046450034,BK,348 EAST 91 STREET,02,C3,MCLEOD LEROY F,3,2,1
6915,3046460018,BK,318 EAST 92 STREET,02,C3,"GEORGE, PATRICIA",3,2,1
6916,3046470001,BK,279 EAST 92 STREET,02,C1,279 E 92ND ST ASSOC,2,1,1
6917,3046720057,BK,369 ROCKAWAY PARKWAY,02,C3,JACQUET JOSEPH P,2,1,1
6918,3046980047,BK,925 UTICA AVENUE,04,S5,"BETHEA, SARAH",2,1,1
6919,3047800072,BK,823 EAST 49 STREET,02,C0,GERALDINE C OKORO,2,1,1
6920,3047960043,BK,572 NEW YORK AVENUE,01,A5,"PUTTER, SHRAGA",2,1,1
6921,3048990007,BK,4510 CHURCH AVENUE,08,M1,CHURCH OF GOD ECCLESIA ASSEMBLY INC,2,1,1
6922,3051080046,BK,2919 SNYDER AVENUE,06,E1,SNYDER HOLDINGS LLC,2,1,1
6923,3051410112,BK,1027 CORTELYOU ROAD,04,D6,1027-1035 CORTELYOU LLC,6,5,1
6924,3051990017,BK,556 RUGBY ROAD,01,B2,JUNE M HENDRICKS,2,1,1
6925,3053300031,BK,130 EAST 8 STREET,01,B2,"SAGEER, ABDUL K",2,1,1
6926,3053610006,BK,566 CONEY ISLAND AVENUE,05,H9,HALPERTS HOLDINGS LLC,3,2,1
6927,3054010064,BK,697 EAST 7 STREET,01,B2,"RIVLIN, EVA",2,1,1
6928,3054240029,BK,250 NEWKIRK AVENUE,08,M1,ST ROSE OF LIMA'S RC C,4,3,1
6929,3054550037,BK,1772 49 STREET,01,B2,"1772, LLC",2,1,1
6930,3054550055,BK,1739 50 STREET,01,B1,"PASKUS, MIRIAM L.",2,1,1
6931,3054580003,BK,5015 15 AVENUE,08,M1,CONGREGATION CHASIDEI BELZ OF BORO PARK  INC,2,1,1
6932,3054660032,BK,1654 51 STREET,01,B1,"DREW, BENJAMIN",2,1,1
6933,3056090060,BK,1163 45 STREET,02,C0,"1163-45, LLC",2,1,1
6934,3056177502,BK,1317 46 STREET,03,R4,UNAVAILABLE OWNER,3,2,1
6935,3056217509,BK,4620 12 AVENUE,02,R3,UNAVAILABLE OWNER,2,1,1
6936,3056340058,BK,1247 49 STREET,02,C0,"CHAIM LANDAU, TRUSTEE",2,1,1
6937,3056560026,BK,1348 51 STREET,02,C0,"SRULOVIC, ISRAEL",2,1,1
6938,3056610070,BK,1105 53 STREET,01,B1,"SAUL RAPAPORT, AS TRUSTEE",2,1,1
6939,3056780025,BK,1450 54 STREET,01,A1,"KLEIN, BARRY",2,1,1
6940,3056980051,BK,1364 57 STREET,02,C0,CONGREGATION ERECH SHAI BAIS YOSEF,2,1,1
6941,3057110007,BK,1206 59 STREET,02,C0,12/59 LLC,2,1,1
6942,3057460060,BK,1245 65 STREET,11,V0,1245 65TH LLC,2,1,1
6943,3057670079,BK,1217 OVINGTON AVENUE,01,B2,"DONNIACUO, LUISA",2,1,1
6944,3059050023,BK,94 72 STREET,01,A5,"BUENCAMINO, CHRISTOPHER A",2,1,1
6945,3059630019,BK,632 77 STREET,02,C0,RANDA RABAH,2,1,1
6946,3061860035,BK,2172 71 STREET,01,B1,"MATZA, MARILYN",2,1,1
6947,3062550009,BK,7803 12 AVENUE,01,A9,"PALAZZOLO , FARO",2,1,1
6948,3062660001,BK,7923 11 AVENUE,01,A1,"DE LUCA, ANTHONY",2,1,1
6949,3062930022,BK,1434 81 STREET,01,A1,"ZHENG, YONG",2,1,1
6950,3063340034,BK,2070 84 STREET,02,C1,2070 84TH STREET LLC,2,1,1
6951,3064250071,BK,236 BAY 8 STREET,02,C0,"RAO, SALVATORE",2,1,1
6952,3064600209,BK,8860 16 AVENUE,01,B9,"ANDERSON, STEPHEN",2,1,1
6953,3065060015,BK,1008 EAST 4 STREET,01,A1,"SALGO, STEVEN M",2,1,1
6954,3065200033,BK,984 EAST 8 STREET,01,A1,"NAKASH-SENIOR, MIRIAM",2,1,1
6955,3065320039,BK,1266 EAST 7 STREET,01,B2,"GINDI, DAVID",2,1,1
6956,3065410082,BK,1317 EAST 5 STREET,01,A5,"BEYDA, RALPH J",2,1,1
6957,3065460073,BK,1235 EAST 10 STREET,01,A9,"JOSEPH WEISS, TRUSTEE",2,1,1
6958,3065577501,BK,2370 62 STREET,02,R1,UNAVAILABLE OWNER,2,1,1
6959,3065660062,BK,1451 EAST 3 STREET,01,B3,GOLDSTEIN DAVID,2,1,1
6960,3065860039,BK,1564 EAST 5 STREET,01,A3,BEYDA FRANCES,2,1,1
6961,3065880035,BK,1546 EAST 7 STREET,02,C0,"BALDINGER, HARRY M",2,1,1
6962,3065990159,BK,1581 WEST 8 STREET,01,A5,"HE, NANCY ZHOU NAI",2,1,1
6963,3066050053,BK,1551 WEST 2 STREET,01,A9,"MOONEY , JOHN",2,1,1
6964,3066130091,BK,1515 OCEAN PARKWAY,01,A9,YVETTE ESSES,2,1,1
6965,3066600019,BK,1808 EAST 4 STREET,01,A3,"SOUDRY, ARIEL Y",2,1,1
6966,3066750017,BK,1828 WEST 5 STREET,01,B2,"LIAO, ZHUO ZHEN",2,1,1
6967,3066810029,BK,40 COLIN PLACE,01,A3,"DWECK, ERICA",2,1,1
6968,3066970017,BK,826 EAST 14 STREET,02,C0,"WANG, SOLOMON",2,1,1
6969,3067250066,BK,1153 EAST 14 STREET,01,A9,"BAKST, SHAUL",2,1,1
6970,3067840041,BK,2115 QUENTIN ROAD,01,B2,KAREN TUACHI,2,1,1
6971,3067900023,BK,1668 EAST 28 STREET,01,B3,"MARMURSTEIN , RENEE",2,1,1
6972,3068280031,BK,1860 EAST 23 STREET,01,A1,DLP FAMILY TRUST,2,1,1
6973,3068300030,BK,3960 BEDFORD AVENUE,01,A1,"DABAH, SHLOMO",2,1,1
6974,3070890023,BK,1940 EAST 8 STREET,02,C3,"HASBANI, NASIM KHABIEH DIT",2,1,1
6975,3070900016,BK,1924 EAST 9 STREET,01,A1,JACQUES SALAMA,2,1,1
6976,3071310017,BK,2192 EAST 5 STREET,01,B2,ESSES ELI,2,1,1
6977,3071340069,BK,2177 EAST 7 STREET,01,B1,JENNIFER HALFON,2,1,1
6978,3073040080,BK,4017 BEDFORD AVENUE,01,B1,RAHMAN DANIEL,2,1,1
6979,3073050075,BK,1931 EAST 26 STREET,01,B2,"MENDLOWITZ, LEAH",2,1,1
6980,3073050078,BK,1923 EAST 26 STREET,01,A1,"FATIHA, JACK",2,1,1
6981,3073150031,BK,2060 EAST 12 STREET,01,B2,"HASBANI, JAMIL",2,1,1
6982,3073270038,BK,2078 EAST 23 STREET,01,A1,MATASCI DENA,2,1,1
6983,3075910027,BK,945 EAST 27 STREET,01,B1,945 E27 LLC,2,1,1
6984,3076100072,BK,1066 EAST 29 STREET,01,B3,"LIPSCHITZ, ALAN",2,1,1
6985,3076260065,BK,1148 EAST 27 STREET,01,A1,"HAGER, DAVID",2,1,1
6986,3076440044,BK,2610 AVENUE L,01,A1,MEILECH FASTAG,2,1,1
6987,3076530037,BK,1307 EAST 35 STREET,01,A1,JENNIFER BROWN,2,1,1
6988,3076620080,BK,1368 EAST 27 STREET,01,A1,ARYEH SCHWIMMER,2,1,1
6989,3076790074,BK,1452 EAST 26 STREET,01,A1,SARA HAIA TALER,2,1,1
6990,3077460063,BK,972 EAST 43 STREET,01,A9,"RHUDD, WINSOME N",2,1,1
6991,3077490077,BK,4593A KINGS HIGHWAY,01,A5,HOO ASTON,3,2,1
6992,3078610025,BK,1501 HENDRICKSON STREET,08,M1,ST THOMAS AQUINAS,4,3,1
6993,3078790013,BK,1555 EAST 54 STREET,01,B3,"WINTER, ANDREA",2,1,1
6994,3078960059,BK,1694 EAST 52 STREET,01,A1,"FENG, PUIYOOK",2,1,1
6995,3079020058,BK,1464 EAST 58 STREET,01,A2,"UKACHUKWU, CHRISTINA",2,1,1
6996,3079940006,BK,8911 GLENWOOD ROAD,04,S1,"8911 GLENWOOD GROUP, INC.",2,1,1
6997,3080630075,BK,1276 EAST 85 STREET,01,B9,"DALMIDA, NORINE P",2,1,1
6998,3081470062,BK,948 EAST 98 STREET,01,A1,"PATRICK, ROXANNE",2,1,1
6999,3082740029,BK,1565 REMSEN AVENUE,01,B3,"PETIT HOMME, DUKINS",2,1,1
7000,3084560037,BK,2416 EAST 70 STREET,01,A5,"BETESH, ANTONELLA LIA",2,1,1
7001,3084701206,BK,5800 AVENUE U,05,K1,KINGS BAY MARINA LLC,3,2,1
7002,3085250024,BK,2037 RYDER STREET,01,A1,"MULLINS, KENNETH",2,1,1
7003,3085270064,BK,2050 HENDRICKSON STREET,01,B3,VERDEROSA STEVEN S,3,2,1
7004,3085950052,BK,2744 EAST 64 STREET,01,B2,"2744 E 64TH ST, LLC",2,1,1
7005,3086730030,BK,302 OCEAN VIEW AVENUE,01,B3,LOUIS VALENTIN,2,1,1
7006,3087270034,BK,79 AMHERST STREET,01,A1,"KUPFERMAN, MATTHEW",2,1,1
7007,3088100087,BK,1104 LAWN COURT,01,B1,ARSHAD MAHMOOD,2,1,1
7008,3089550312,BK,107 EBONY COURT,01,B3,"ADAMIK, THOMAS JR",2,1,1
7009,4000280003,QN,46-42 VERNON BOULEVARD,04,S3,TLL REALTY LLC,2,1,1
7010,4002120015,QN,50-17 38 STREET,02,C0,"CAMPOS, RODOLFO",2,1,1
7011,4002680015,QN,26-14 JACKSON AVENUE,04,D6,DEERWOOD JACKSON AVENUE LLC,2,1,1
7012,4004070001,QN,40-40 CRESCENT STREET,07,G4,RED D CAR MANAGEMENT CORP,2,1,1
7013,4005160009,QN,30-54 14 STREET,02,C0,"BASIT, ABDUL",2,1,1
7014,4005860051,QN,32-28 30 STREET,01,B2,"VALENCIA, JOSE ARLES",2,1,1
7015,4006150083,QN,30-89 31 STREET,04,S5,"EMPIRE REALTY OF QUEENS,",2,1,1
7016,4006530049,QN,37-16 ASTORIA BOULEVARD S,04,S2,VITO VACCARO,2,1,1
7017,4007290043,QN,47-04 30 AVENUE,02,C2,"47-04 30TH AVENUE REALTY ,LLC",2,1,1
7018,4007990041,QN,20-22 41 STREET,02,C0,2022 41ST REALTY LLC,2,1,1
7019,4008060067,QN,37-15 23 AVENUE,04,S9,"KELLY & CALLY ASSOCIATES,",2,1,1
7020,4008080010,QN,21-59 37 STREET,01,A5,"LI, MINGYU",2,1,1
7021,4008100013,QN,37-09 20 ROAD,01,B1,"DELSIGNORE, DELMA",2,1,1
7022,4008190111,QN,23-63 36 STREET,01,B1,"TAYLOR, MICHAEL",2,1,1
7023,4008210019,QN,22-35 36 STREET,01,A5,JI YOUNG KIM,2,1,1
7024,4008290053,QN,20-52 33 STREET,01,B1,23RD & 33RD STREET REALTY LLC,2,1,1
7025,4008420006,QN,29-19 24 AVENUE,08,P2,BOHEMIAN BEN SOCY,4,3,1
7026,4008820053,QN,20-06 23 STREET,01,B1,MALLQUI MAXIMO,2,1,1
7027,4008900065,QN,19-24 23 ROAD,02,C0,"TSOUKALAS, ANDY",2,1,1
7028,4009690021,QN,21-34 74 STREET,01,B2,LEONARDO DIMARCO,2,1,1
7029,4012250007,QN,54-11 WOODSIDE AVENUE,02,C0,"MOHAMMAD IQBAL LIVING TRUST DATED JUNE 2 1, 2005",3,2,1
7030,4012570032,QN,70-05 35 AVENUE,08,I6,JACKSON HEIGHTS REALTY ASSOCIATES,2,1,1
7031,4013020024,QN,70-02 ROOSEVELT AVENUE,04,K4,EV ENTERPRISES LIMITED,2,1,1
7032,4014040066,QN,31-15 92 STREET,01,A5,"NEVIN PAHLAD, TRUSTEE",2,1,1
7033,4014900015,QN,40-20 80 STREET,02,C0,"RODRIGUEZ, TRANSITO",2,1,1
7034,4015140026,QN,41-40 GLEANE STREET,01,B3,"QIU, XIN YAO",2,1,1
7035,4015580003,QN,86-04 ELMHURST AVENUE,02,C0,"MOY, LINA",2,1,1
7036,4016570104,QN,108-19 DITMARS BOULEVARD,01,B3,"WHITE, PAULA M",2,1,1
7037,4017030079,QN,32-15 108 STREET,01,B1,"GABRIEL, YVONNE",2,1,1
7038,4017550031,QN,34-44 112 STREET,02,C0,JUANITA BANKS,2,1,1
7039,4018790043,QN,48-12 98 STREET,01,B2,"CALLE, LUIS G",2,1,1
7040,4019420041,QN,104-20 51 AVENUE,01,B3,"PEREZ, JESUS A",2,1,1
7041,4019420084,QN,103-37 52 AVENUE,01,B3,TORRES LUVIA,2,1,1
7042,4020040068,QN,108-41 49 AVENUE,02,C0,"CAI, QINDI",2,1,1
7043,4021260014,QN,63-35 102 STREET,08,W1,NYC DEPARTMENT OF EDUCATION,2,1,1
7044,4023700019,QN,54-35 64 STREET,01,A1,"O'SHAUGHNESSY-WALSH , ORLA P",2,1,1
7045,4026110001,QN,46-25 METROPOLITAN AVENUE,06,E1,NYC TRANSIT AUTHORITY,2,1,1
7046,4026110093,QN,47-03 METROPOLITAN AVENUE,06,E1,CACTUS 47-05 METROPLITAN LLC,4,3,1
7047,4027310051,QN,59-66 60 LANE,01,A1,"KOUROUNIS, JOHN",2,1,1
7048,4027530252,QN,64-44 58 ROAD,01,A5,"BRADY, MARTIN",2,1,1
7049,4027570061,QN,62-53 60 ROAD,01,B2,"VASQUEZ, ANGEL",2,1,1
7050,4027600023,QN,64-30 60 AVENUE,01,A5,ALBERTO GONZALEZ,2,1,1
7051,4027990166,QN,69-71 QUEENS MIDTOWN EXPWY,01,A5,NICHOLSON JAMES,2,1,1
7052,4028050014,QN,74-10 GRAND AVENUE,08,I9,JAMAICA HALPERN REALTY LLC,2,1,1
7053,4028150062,QN,57-32 78 STREET,02,C0,"HU, CHUN YAN",2,1,1
7054,4028910010,QN,84-28 GRAND AVENUE,01,B2,MOLLIN PATRICK,2,1,1
7055,4029040016,QN,53-40 82 STREET,02,C0,YUNG LAI WAH,2,1,1
7056,4029060006,QN,54-02 83 STREET,01,B2,"DANIELA MASSARO, TRUSTEE",2,1,1
7057,4029740117,QN,61-60 WOODHAVEN BOULEVARD,07,G4,"GTY-CPG (QNS/BX) LEASING, INC.",2,1,1
7058,4032310013,QN,69 DARTMOUTH STREET,01,A3,VELONSKIS SIMAS,2,1,1
7059,4033290047,QN,83-66 ABINGDON ROAD,01,B3,"NOROWITZ, DANIEL",2,1,1
7060,4034530035,QN,684 SENECA AVENUE,05,K1,GOLDEN CHOI REALLY CORP,8,7,1
7061,4034540032,QN,658 ONDERDONK AVENUE,10,G0,"SCHNEIDER, ARNOLD",2,1,1
7062,4034870017,QN,65-08 FOREST AVENUE,01,B2,MOU PING LEE,2,1,1
7063,4035780043,QN,1833 DECATUR STREET,01,B2,"ENG, SUSAN",2,1,1
7064,4035890024,QN,59-44 SUMMERFIELD STREET,01,B1,"BASZYNSKA, ALEKSANDRA",2,1,1
7065,4036000023,QN,65-32 MYRTLE AVENUE,04,S3,GANGI LEONARD,2,1,1
7066,4036000041,QN,72-42 65 PLACE,01,B2,"SIERRA, ELVIN",3,2,1
7067,4036040008,QN,65-67 ADMIRAL AVENUE,01,B2,"BARROS, ARCELIA G",2,1,1
7068,4036580028,QN,69-07 69 STREET,01,A9,MOORE JOANNE,2,1,1
7069,4037710030,QN,73-38 67 ROAD,01,A1,TIMOTHY C MCREADY,2,1,1
7070,4037830001,QN,68-19 79 STREET,01,B2,FINEGAN GLORIA J,2,1,1
7071,4040950009,QN,15-35 128 STREET,05,O1,PHILIP DAMICO,2,1,1
7072,4041300007,QN,18-31 124 STREET,02,C3,BALJIT ATWAL,2,1,1
7073,4041960011,QN,22-23 120 STREET,01,B1,LUCIA VANUSKA,2,1,1
7074,4044560030,QN,145-84 7 AVENUE,01,A1,ANTHONY CARDILLO,2,1,1
7075,4045270070,QN,151-27 11 AVENUE,01,A1,"MARTELLO, MARK",2,1,1
7076,4045310013,QN,7-35 152 STREET,01,B3,"LI , BETTY BEI",3,2,1
7077,4045870093,QN,14-55 161 STREET,01,A2,"MCMANUS, AUSTIN",2,1,1
7078,4046000006,QN,14-74 166 STREET,01,A2,STELLA DILEONARDO,2,1,1
7079,4048550033,QN,32-32 155 STREET,01,A1,"DUH, LINDA",2,1,1
7080,4049310036,QN,27-37 170 STREET,01,B3,"LIN, JIYU",2,1,1
7081,4049340026,QN,29-42 172 STREET,01,B1,"MOLLA, NURI",2,1,1
7082,4049880013,QN,33-33 148 STREET,01,A1,"CORDOVA, CARLOS",2,1,1
7083,4050040012,QN,146-10 35 AVENUE,04,D7,"E HOME REAL ESTATE, LLC",2,1,1
7084,4050270012,QN,147-31 41 AVENUE,02,C0,JEN YOUNG LLC,2,1,1
7085,4050610006,QN,131-20 41 AVENUE,10,G1,EASLE REALTY CORP.,2,1,1
7086,4051180001,QN,56-46 135 STREET,01,B2,"LIN, XUE FEI",2,1,1
7087,4051927505,QN,43-12 UNION STREET,02,R1,UNAVAILABLE OWNER,2,1,1
7088,4052460026,QN,33-33 161 STREET,01,A1,JOHN M WATCH,2,1,1
7089,4052550010,QN,33-65 170 STREET,01,A1,"VASSILIOU, ANASTASIS",2,1,1
7090,4053560020,QN,40-12 192 STREET,02,C1,SAMARAS STELLA,2,1,1
7091,4054200015,QN,43-37 162 STREET,04,S2,"AHMAD, KHALIDA P",2,1,1
7092,4054600053,QN,46-40 162 STREET,01,B1,162 STAR LLC,2,1,1
7093,4055140018,QN,189-24 43 ROAD,01,A1,"JIMENEZ, RUBEN",2,1,1
7094,4056950001,QN,58-11 192 STREET,01,B1,"KIM, CHANG HYUN",2,1,1
7095,4059720024,QN,28-48 201 STREET,01,A2,KENNETH RIEBOLD,2,1,1
7096,4060220040,QN,29-17 JORDAN STREET,01,B1,218-11 REALTY LLC,2,1,1
7097,4060270036,QN,200-09 33 AVENUE,01,A5,"TIRELLA, KAREN",2,1,1
7098,4062520028,QN,219-07 39 AVENUE,01,A1,"LAW, SIN WAI",2,1,1
7099,4063910003,QN,135-08 63 AVENUE,10,G0,CEDAR GROVE CEMETARY ASSN,2,1,1
7100,4063980052,QN,138-72 62 ROAD,01,A1,"WARDAK, MOHAMMED  H",2,1,1
7101,4065850044,QN,136-02 76 ROAD,01,A2,"MOSKOVITS, TOBY",2,1,1
7102,4067170072,QN,150-06 GRAND CENTRAL PKWY,01,A5,"MARTINEZ, FRANCIS",2,1,1
7103,4069150014,QN,174-03 67 AVENUE,01,A2,LEE SOOK J,2,1,1
7104,4069610055,QN,70-28 174 STREET,01,B1,NIKOLAY ISKHAKOV,2,1,1
7105,4070390001,QN,82-48 165 STREET,01,A5,FLORENCE EMEROLE,2,1,1
7106,4071670011,QN,73-31 179 STREET,01,A1,"KAZAKOV, IGOR",2,1,1
7107,4073610015,QN,48-18 203 STREET,01,A5,ANTONIO GIAIMO,2,1,1
7108,4074440019,QN,56-34 BELL BOULEVARD,01,A0,"THAPI, DHARMARAO",2,1,1
7109,4079670046,QN,88-56 SABRE STREET,01,B3,"ISLAM, KAZI",2,1,1
7110,4079710033,QN,88-04 LYMAN STREET,01,B3,"ROBINSON, HOWARD III",2,1,1
7111,4080230045,QN,341 RICHMOND ROAD,01,A1,"YAN, JANET",2,1,1
7112,4083060053,QN,245-65 63 AVENUE,01,A0,"PI, JIAN",2,1,1
7113,4088300103,QN,87-78 256 STREET,01,A1,"LOOMBA, POOJA ROHIT",2,1,1
7114,4089940029,QN,91-46 98 STREET,02,C0,"BORJA, MARIA",2,1,1
7115,4091480059,QN,107-31 87 STREET,01,A1,"NOGUERAS, RAFAEL",2,1,1
7116,4092790115,QN,86-07 125 STREET,01,B2,"GUIDA, RAYMOND",2,1,1
7117,4093200128,QN,112-23 ATLANTIC AVENUE,01,A5,"RAHMAN, MOHAMMED",2,1,1
7118,4093230016,QN,89-26 116 STREET,01,B3,"SEERAMSINGH, BHANMATTIE",2,1,1
7119,4094410054,QN,94-13 124 STREET,01,A1,"BRIJLALL, MANSARAM",2,1,1
7120,4095490062,QN,107-39 111 STREET,01,B3,"IFTIKHAR, JAVAID",2,1,1
7121,4096310015,QN,86-36 VAN WYCK EXPRESSWAY,01,B2,"ARCE, JUAN C",2,1,1
7122,4096760051,QN,89-39 146 STREET,01,A1,"HARNARAIN, PARBATIE",2,1,1
7123,4096830042,QN,139-14 88 ROAD,01,A1,"BONILLA, ANNA BELLE",2,1,1
7124,4097020086,QN,144-15 HILLSIDE AVENUE,04,S2,144 HILLSIDE LLC,2,1,1
7125,4098450146,QN,87-27 KINGSTON PLACE,01,B1,ESPINOSA HUMBERTO,2,1,1
7126,4099020104,QN,91-26 183 STREET,01,B2,"MONGAL, LISA S",2,1,1
7127,4099080085,QN,90-42 187 STREET,01,B2,MOHAMED A KHAN,3,2,1
7128,4099380016,QN,179-14 DALNY ROAD,08,W2,PASSIONIST MONASTERY OF THE IMMACULATE C ONCEPTION,3,2,1
7129,4099920052,QN,143-23 95 AVENUE,02,C0,"COLLADO, ADELINDA",2,1,1
7130,4101230034,QN,155-01 107 AVENUE,01,B1,"SETAL, ZOE L",2,1,1
7131,4101490076,QN,160-13 109 AVENUE,01,B2,LIYA HOMES INC.,2,1,1
7132,4101640038,QN,104-15 165 STREET,01,A9,"BOODHOO, ALBERT B",2,1,1
7133,4102010014,QN,163-38 CLAUDE AVENUE,01,A1,"RUCKER, JAMES MOSES",2,1,1
7134,4102090213,QN,92-22 168 PLACE,01,A5,"SAHADEO, BIBI YASIMIN",2,1,1
7135,4102200015,QN,170-36 DOUGLAS AVENUE,06,E9,"170 DOUGLAS AVENUE, LLC",2,1,1
7136,4103350066,QN,106-53 RUSCOE STREET,01,B1,"HOQUE, ENAMUL M",2,1,1
7137,4104010108,QN,114-51 DUNKIRK STREET,01,B3,"WRIGHT , MARIE",2,1,1
7138,4105530052,QN,211-12 93 ROAD,01,A1,SALVATORE LOUAGLIO,2,1,1
7139,4106970053,QN,218-31 94 ROAD,01,A1,"BOOJRAJ, DHANIRAM",2,1,1
7140,4107030046,QN,92-74 SPRINGFIELD BLVD,01,A1,"SHIEVDAYAL, HEEMA D",2,1,1
7141,4107350021,QN,221-25 EDMORE AVENUE,01,A1,DAWKINS ARZOLIA,2,1,1
7142,4107360019,QN,221-35 DAVENPORT AVENUE,01,A1,ENRQUETA SANCHEZ,2,1,1
7143,4108560053,QN,99-09 208 STREET,01,A1,"WHITE, MARILYN",2,1,1
7144,4108650016,QN,100-20 199 STREET,10,G0,HIBBERT  WINSOME,2,1,1
7145,4113200025,QN,116-17 219 STREET,01,A1,"HOGARTH,  EMMANUEL",2,1,1
7146,4113690039,QN,88-51 PITKIN AVENUE,02,C0,"CALM PROPERTIES, LLC",2,1,1
7147,4116020060,QN,109-15 121 STREET,01,B3,"RIOS, LARRY",2,1,1
7148,4116240063,QN,111-01 LEFFERTS BOULEVARD,05,K2,BOPARAI REALTY CORP.,2,1,1
7149,4116490056,QN,114-13 122 STREET,01,A1,WILLIAM LARRY REYNOLDS,2,1,1
7150,4116500058,QN,114-23 123 STREET,01,A1,"BHAGWANDEEN, KRISHNA",2,1,1
7151,4116590014,QN,114-18 LINCOLN STREET,01,A1,NAZIR YUSAF,2,1,1
7152,4116900006,QN,134-12 116 AVENUE,01,B2,LAWSON BESSIE,2,1,1
7153,4117600236,QN,126-18 VAN WYCK EXPRESSWAY,01,B3,"LALCHAN, VINDA",2,1,1
7154,4117610015,QN,130-41 123 STREET,01,B2,"BRUCE A. GIARRAFFA, TRUSTEE",2,1,1
7155,4119250068,QN,139-17 GLASSBORO AVENUE,01,A1,"CONSTANZA, CARLOS A",2,1,1
7156,4119260084,QN,139-08 GLASSBORO AVENUE,01,A1,"OVIEDO, MARLON",2,1,1
7157,4119330015,QN,109-16 PINEGROVE STREET,01,B3,"SETAL, STEPHEN",2,1,1
7158,4119540007,QN,138-14 111 AVENUE,01,A1,"PERSAUD, GUNASWARIE",2,1,1
7159,4120000007,QN,142-14 116 AVENUE,01,A1,ABMST LLC,2,1,1
7160,4120080052,QN,116-41 148 STREET,01,A1,"DEWAR, KECIA",2,1,1
7161,4121030069,QN,148-17 SUTTER AVENUE,01,A1,"RAMNARINE, VISHNU",2,1,1
7162,4121310047,QN,151-73 135 AVENUE,01,A1,"BROWN, ERROL K",2,1,1
7163,4121910030,QN,155-48 115 ROAD,01,A1,"DESINCE, LISANDRA S",2,1,1
7164,4121960022,QN,114-06 BEDELL STREET,11,V0,114-06 BEDELL STREET LLC,2,1,1
7165,4121990052,QN,115-33 159 STREET,11,V0,PYTHON PROPERTIES INC.,2,1,1
7166,4122450046,QN,161-15 119 ROAD,01,A1,"ELLIS, PETER",2,1,1
7167,4123550062,QN,164-03 119 AVENUE,02,C2,LILINE INVESTORS LLC,2,1,1
7168,4123700059,QN,169-09 120 AVENUE,01,A2,"JOSEPH, MONEL",2,1,1
7169,4125410069,QN,178-35 130 ROAD,01,A1,K E PRETLOW,3,2,1
7170,4125800014,QN,137-51 174 STREET,01,B3,"BARNES, KAMILA",2,1,1
7171,4128250143,QN,226-10 FRANCIS LEWIS BLVD,08,M9,CONGREGATION OHEL,3,2,1
7172,4128250213,QN,121-20 FRANCIS LEWIS BLVD,01,A2,ROWAN HELLENA WADE,2,1,1
7173,4128890016,QN,129-15 BROOKVILLE BOULEVARD,01,A1,"DEPRE, LUNY",3,2,1
7174,4129050030,QN,130-15 227 STREET,01,A5,"SPRUILL, TERARD",2,1,1
7175,4130130033,QN,134-47 SPRINGFIELD BLVD,04,K4,SPRINGFIELD HOLDING CORP.,2,1,1
7176,4130750050,QN,143-12 181 STREET,01,B2,GRP PEBBLE BEACH LLC,2,1,1
7177,4130980031,QN,220-22 MERRICK BOULEVARD,07,G2,CRILIS REALTY CORP,2,1,1
7178,4134690062,QN,145-70 222 STREET,01,A2,"PALMER, SANDRA C",2,1,1
7179,4134720027,QN,145-51 224 STREET,01,A2,"DICKENS, SARAH",2,1,1
7180,4134950014,QN,144-51 225 STREET,01,A1,SUSAN S LEWIS,2,1,1
7181,4135940032,QN,141-05 250 STREET,01,B1,"HOULDER, ERROL",2,1,1
7182,4141430044,QN,155-33 100 STREET,01,A1,"RAD, JONATHAN",2,1,1
7183,4142340575,QN,102 BRIDGE STREET,02,C0,"SCHMIDT, SHEILA A",6,5,1
7184,4155700124,QN,7-31 HENRY ROAD,01,A1,"BLOOM, MOSHE M.",2,1,1
7185,4156600044,QN,13-81 PINSON STREET,01,A1,"ADAMS, PETER",2,1,1
7186,4160350073,QN,68-10 ELIZABETH AVENUE,01,B2,"OROYEMI, ANTHONY",2,1,1
7187,4160400030,QN,462 BEACH 67 STREET,02,C0,"BACTAWAR, VICTOR",2,1,1
7188,4160700022,QN,419 BEACH 72 STREET,11,V1,"NORTON, JOHN",2,1,1
7189,4160780029,QN,73-02 BEACH CHANNEL DRIVE,10,G1,73-02 BEACH CHANNEL DRIVE REALTY CORP,2,1,1
7190,4161220050,QN,3-31 BEACH 88 STREET,01,A2,"CORPUS, KRISTINE",2,1,1
7191,4162210012,QN,249 BEACH 125 STREET,01,B2,"STACKPOLE, KAITLYN",2,1,1
7192,4162210046,QN,220 BEACH 126 STREET,01,B1,"HORGAN, THOMAS F JR",3,2,1
7193,4162540029,QN,425 BEACH 131 STREET,10,G0,"TELLONE, MICHAEL J",2,1,1
7194,4162820035,QN,1-45 BEACH 137 STREET,01,A1,"LEVENSON, JEFFREY R",2,1,1
7195,4162950014,QN,453 BEACH 144 STREET,01,A1,"MESSINA, JOSEPH",2,1,1
7196,5000380063,SI,33 WINTER AVENUE,01,A1,"SERRANO , ISAI",2,1,1
7197,5000410042,SI,21 TAFT AVENUE,01,B3,FAY LAUREL E,2,1,1
7198,5000760200,SI,1000 RICHMOND TERRACE,08,P7,NYC DEPARTMENT OF CULTURAL AFFAIRS,14,13,1
7199,5001010572,SI,84 VALENCIA AVENUE,01,A3,"FORMICA, KENNETH L",2,1,1
7200,5001190046,SI,184 STANLEY AVENUE,01,A2,SILVER LAKE REALTY A,2,1,1
7201,5001440055,SI,55 DEKAY STREET,01,A2,"COPPOLO, JAROD J",2,1,1
7202,5001480005,SI,262 DELAFIELD AVENUE,02,C3,"RAFFONE , DAVID",2,1,1
7203,5001570033,SI,32 BEMENT AVENUE,01,A1,"MCGHIE, ROBERT P",2,1,1
7204,5001610028,SI,208 ELM STREET,01,B3,ACOSTA JOSE,2,1,1
7205,5001790018,SI,52 SOUTH STREET,01,A1,"MASOUD, MOSA",2,1,1
7206,5001970129,SI,1151 CASTLETON AVENUE,04,S9,JOHN FRANK 1149-1151 LLC,2,1,1
7207,5002000036,SI,14 DONGAN STREET,01,A1,"JACOBS, KENNETH",2,1,1
7208,5002180053,SI,106 CAROLINE STREET,02,C3,"AHMED, SAMEH",2,1,1
7209,5002540046,SI,659 METROPOLITAN AVENUE,01,A1,CAROL A LANDORNO CHAKWIN,2,1,1
7210,5002980062,SI,766 OAKLAND AVENUE,01,A1,MICHAEL A BILOTTO,2,1,1
7211,5003350041,SI,85 FAIRVIEW AVENUE,01,A0,"DI CHIARO, ANTHONY J",2,1,1
7212,5003650134,SI,60 MAINE AVENUE,01,B3,JOHN ROSA,2,1,1
7213,5003690169,SI,90 GOODWIN AVENUE,01,A0,ROSA ALMA A ADIA,2,1,1
7214,5006360018,SI,344 TARGEE STREET,01,A5,344 TARGEE ST. VENTURES LLC,2,1,1
7215,5006470020,SI,333 HILLSIDE AVENUE,01,A1,"WILMINGTON SAVINGS FUND SOCIETY,FSB, D/B /A CHRIST",2,1,1
7216,5006840024,SI,511 OCEAN TERRACE,01,A3,"HUANG, ZHAOWEN",3,2,1
7217,5007680058,SI,44 LIVINGSTON AVENUE,01,A6,GARY SOPER,2,1,1
7218,5008140012,SI,367 BRADLEY AVENUE,01,B2,"GUKASYAN, ARTHUR",2,1,1
7219,5009080250,SI,1 CLIFFWOOD AVENUE,08,W7,COPTIC ORTHODOX PATRIARCHATE,7,6,1
7220,5010050008,SI,97 PORT RICHMOND AVENUE,05,K9,"97 PORT RICHMOND AVE, LLC",2,1,1
7221,5010880013,SI,1665 CASTLETON AVENUE,01,A1,"HAIG, ROBERT R",2,1,1
7222,5012130048,SI,51 UNION AVENUE,01,B3,REGINA KUJENYA,2,1,1
7223,5012340033,SI,319 HARBOR ROAD,01,B3,"CASIANO, SAUL",2,1,1
7224,5012900230,SI,432 NORTHFIELD AVENUE,01,A9,NORTHFIELD ALLIANCE LLC,2,1,1
7225,5014350053,SI,21 CRYSTAL AVENUE,01,A1,"PEROSI, GARY",2,1,1
7226,5014400075,SI,54 BRYSON AVENUE,01,A1,"HIGGINS-HAJDARAGIC, KAREN A",3,2,1
7227,5015010095,SI,5 HAWTHORNE AVENUE,01,A1,"NIEVES, CESAR O JR",2,1,1
7228,5016900039,SI,2140 FOREST AVENUE,01,A1,"SHAKKOUR, OMAR",2,1,1
7229,5021560096,SI,24 TIMOTHY COURT,01,A5,JERZY SZMIT,2,1,1
7230,5022580004,SI,3325 RICHMOND ROAD,01,A1,"BOUGAEV, VADIM",2,1,1
7231,5027800063,SI,9 MEREDITH AVENUE,01,A1,"WEYERSHAUSEN, MARY ROSE",2,1,1
7232,5029880001,SI,76 FLETCHER STREET,01,A1,"D AGOSTO JR, DONATO",2,1,1
7233,5031020016,SI,31 HASTINGS STREET,01,B3,"BOCI, OMER",2,1,1
7234,5031200044,SI,64 OCEAN AVENUE,04,S3,MARK COZZOLINO,2,1,1
7235,5032730001,SI,1 DIAZ STREET,01,A2,WAEL KHALIL,2,1,1
7236,5033320014,SI,278 BURGHER AVENUE,01,A1,"CELMETA, SHKELQIM",2,1,1
7237,5033360020,SI,306 RARITAN AVENUE,01,B3,LOUIS LOCASTO,2,1,1
7238,5033620042,SI,231 EVERGREEN AVENUE,01,A2,"LEE, YING CHOI",2,1,1
7239,5033950093,SI,270 NORWAY AVENUE,02,C0,"WELLS FARGO BANK, N.A",2,1,1
7240,5035350089,SI,33 STOBE AVENUE,01,A5,"PROVIDENZA, CUZZAPIA",2,1,1
7241,5035610068,SI,2041 HYLAN BOULEVARD,07,G2,BOBBY G LLC,3,2,1
7242,5035630057,SI,30 BARTON AVENUE,01,A1,COLLETTI RICHARD,2,1,1
7243,5035800025,SI,1075 NORTH RAILROAD AVE,01,B2,"MARTONE, DONNA",2,1,1
7244,5036420046,SI,122 BACHE AVENUE,01,A1,RYAN KONKOSKI,2,1,1
7245,5038100034,SI,781 PATTERSON AVENUE,01,A6,"YUTSIS, TANYA",2,1,1
7246,5040460016,SI,74 MILTON AVENUE,01,A1,U.S. BANK NATIONAL ASSOCIATION,2,1,1
7247,5040800006,SI,37 CEDAR GROVE AVENUE,01,A1,PABLO HERNANDEZ,2,1,1
7248,5043080043,SI,79 DALE AVENUE,01,A1,JOSEPH R CLLENTO,2,1,1
7249,5043350155,SI,47 BELFAST AVENUE,01,A2,CLARISTINA JIMENEZ,2,1,1
7250,5051120036,SI,27 KEATS STREET,01,B2,"MUFFALETTO, SALVATORE",2,1,1
7251,5052740053,SI,75 DRIGGS STREET,01,B2,"ROYZEN, BORIS",2,1,1
7252,5053070037,SI,54 GOODALL STREET,01,B3,"FANNING, DAVID",3,2,1
7253,5055500001,SI,417 ARTHUR KILL ROAD,09,Q1,NYC DEPARTMENT OF SANITATION,3,2,1
7254,5056440034,SI,62 PERKIOMEN AVENUE,01,B2,ANNETTE ALESSIO,2,1,1
7255,5056580009,SI,572 ANNADALE ROAD,01,A1,AUGUST D TORNQUIST,2,1,1
7256,5057270090,SI,190 KENILWORTH AVENUE,01,A5,ELINOR MELA,2,1,1
7257,5062300001,SI,195 JEFFERSON BOULEVARD,08,M1,MESSIAH EVANGEL LUTH,3,2,1
7258,5062730024,SI,12 HOLCOMB AVENUE,01,B2,JOHN A CAMPANELLI,2,1,1
7259,5072070300,SI,115 JOHNSON STREET,06,E1,115 JOHNSTON STREET INC,3,2,1
7260,5074200020,SI,15 SARCONA COURT,01,B2,XU CHENG,2,1,1
7261,5077100533,SI,418 RICHARD AVENUE,01,A1,"IUCCI, GERARD III",2,1,1
7262,5078640003,SI,246 LORETTO STREET,01,A1,ERGUR ESREF,2,1,1
7263,5078660007,SI,428 GEORGE STREET,01,A6,STEVEN D'ALESSIO,2,1,1
7264,5080260133,SI,154 JOHNSON AVENUE,01,A1,WILLIAM D MONTEMARANO,2,1,1
7265,5080330001,SI,7725 AMBOY ROAD,01,A1,"CUCCHIARA, JOSEPH",2,1,1
7266,5080460048,SI,197 JOHNSON AVENUE,01,A1,"AYLWARD, MICHAEL",2,1,1
7267,1002410013,MN,270 SOUTH STREET,07,T2,NYC DEPARTMENT OF SMALL BUSINESS SERVICES,4,3,1
7268,1003860007,MN,49 AVENUE B,04,S2,45-51 AVENUE B LLC,2,1,1
7269,1005510007,MN,19 WASHINGTON SQUARE N,05,O2,NEW YORK UNIVERSITY,3,2,1
7270,1008300074,MN,46 WEST 29 STREET,03,D0,FLOWER TENANTS CORP,2,1,1
7271,1008330042,MN,308 5 AVENUE,05,O5,"KAM HING REALTY-NYC,",2,1,1
7272,1010070005,MN,151 WEST 54TH STREET,05,H1,BLACK PUMICE D 2015 LLC,2,1,1
7273,1010350037,MN,302 WEST 45 STREET,05,J4,JUJAMCYN THEATERS LLC,2,1,1
7274,1011220026,MN,9 WEST 69 STREET,02,C5,9 WEST 69TH STREET CO,2,1,1
7275,1014890008,MN,509 EAST 77 STREET,02,C6,CHEROKEE OWNERS CORP,3,2,1
7276,1018670042,MN,1125 AMSTERDAM AVENUE,08,W5,TRUSTEES OF COLUMBIA UNIVERSITY,2,1,1
7277,1018890052,MN,319 WEST 101 STREET,02,C2,"319 WEST 101ST STREET, LLC",2,1,1
7278,1021360005,MN,609 WEST 158 STREET,04,C7,RESTORING COMMUNITIES HOUSING DEVELOPMEN T FUND,2,1,1
7279,1021890060,MN,401 WEST 207 STREET,07,G3,HESS RETAIL STORES LLC,2,1,1
7280,2022980101,BX,230 ALEXANDER AVENUE,08,M1,UNAVAILABLE OWNER,4,3,1
7281,2023140066,BX,314 EAST 140 STREET,01,B9,ALOHA REAL ESTATE LLC,2,1,1
7282,2023310034,BX,332 EAST 150 STREET,10,G7,FIRE DEPARTMENT OF NEW YORK,2,1,1
7283,2023800035,BX,409 EAST 158 STREET,11,V0,407 E158 STREET LLC,2,1,1
7284,2025800003,BX,498 CONCORD AVENUE,02,C0,498 CONCORD AVENUE R,2,1,1
7285,2027270026,BX,1100 SIMPSON STREET,01,A5,SAMAROO PARBHOO,2,1,1
7286,2027280070,BX,1156 SIMPSON STREET,01,B2,"RODRIGUEZ, JOSE  A",2,1,1
7287,2027690064,BX,525 LONGFELLOW AVENUE,06,F4,525 LONGFELLOW LLC,2,1,1
7288,2030350017,BX,4288 PARK AVENUE,10,G1,"TRIPLE R. STABLE, LL",4,3,1
7289,2030880044,BX,2309 CAMBRELENG AVENUE,01,B3,"DUENO, RICARDO CRUZ",2,1,1
7290,2031290033,BX,947 EAST 181 STREET,02,C0,SANKHI SONNY B,2,1,1
7291,2031650022,BX,2414 CRESTON AVENUE,02,C6,CRESTON HEIGHTS HOUSING DEVELOPMENT FUND,2,1,1
7292,2031710026,BX,2271 CRESTON AVENUE,01,B2,"EISNER, CHANA",2,1,1
7293,2031920022,BX,2080 DAVIDSON AVENUE,01,B1,"FACEY, MAURICE",2,1,1
7294,2032600049,BX,2875 HEATH AVENUE,01,B1,"KASIOTAKIS, MICHAIL",2,1,1
7295,2033530058,BX,3133 WEBSTER AVENUE,06,E1,WEBSTER ASSOCIATES,2,1,1
7296,2033760025,BX,234 EAST 236 STREET,11,V0,CERBINO LAWRENCE,2,1,1
7297,2034350018,BX,157 BRONX RIVER AVENUE,,Z9,NYC DEPARTMENT OF PARKS AND RECREATION,2,1,1
7298,2034470050,BX,133 HUSSON AVENUE,01,A1,HR 227 LLC,2,1,1
7299,2034570019,BX,226 NEWMAN AVENUE,01,A9,"GUERRERA, JOSEPH",2,1,1
7300,2036820001,BX,2010 BRUCKNER BOULEVARD,03,D3,STELLAR 2020 LLC,3,2,1
7301,2038230039,BX,1271 HAVEMEYER AVENUE,02,C3,GARACE VITO A,2,1,1
7302,2038290005,BX,1168 HAVEMEYER AVENUE,01,B2,"MARTINEZ, JUAN",2,1,1
7303,2038720035,BX,1706 EAST 174 STREET,01,B1,EASTHERS BEATRICE,2,1,1
7304,2039340172,BX,1321 PURDY STREET,02,C1,1325 PURDY STREET LLC,2,1,1
7305,2040440001,BX,800 MORRIS PARK AVENUE,08,M1,GREATER NEW YORK CORP,2,1,1
7306,2040640005,BX,1034 PIERCE AVENUE,01,A1,"GEISSLER-VERA, PAMELA K.",2,1,1
7307,2040950004,BX,930 MORRIS PARK AVENUE,01,B2,"PEREZ-GONZALES, SUSAN",2,1,1
7308,2042940042,BX,2013 MULINER AVENUE,01,A1,"HERNANDEZ, DENISE",2,1,1
7309,2044810120,BX,2557 WOODHULL AVENUE,01,A5,"CASTILLO, LISSETTE M",2,1,1
7310,2045550010,BX,2910 PAULDING AVENUE,01,B2,2910 PAULDING CORP.,2,1,1
7311,2045640065,BX,2816 SEXTON PLACE,02,C3,"FEOLA, SALVATORE",2,1,1
7312,2045740023,BX,3194 BRONXWOOD AVENUE,02,C0,"CONTRERAS, EDWIN",2,1,1
7313,2046570077,BX,3537 HOLLAND AVENUE,05,K1,"SANTIAGO, ARTHUR",2,1,1
7314,2046730050,BX,802 EAST 215 STREET,02,C0,"VASQUEZ, FRANCISCO",2,1,1
7315,2046730068,BX,838 EAST 215 STREET,01,B2,RUBEN FELIPE,2,1,1
7316,2046820046,BX,914 EAST 212 STREET,02,C0,CAMPBELL LINDSAY,3,2,1
7317,2047870028,BX,2801 TIEMANN AVENUE,07,G4,BARTOW HOLDINGS LLC,2,1,1
7318,2048240080,BX,686A EAST 223 STREET,01,B2,"BMAZ MANAGEMENT, INC.",2,1,1
7319,2048340024,BX,667 EAST 231 STREET,01,B2,"SIEUNARINE, PERMANAND",2,1,1
7320,2048380020,BX,757 EAST 224 STREET,02,C1,DOUGERT REALTY ROUND II LLC,2,1,1
7321,2048530039,BX,819 EAST 228 STREET,01,A2,MAJOR DEVELOPMENT 52 CORP.,3,2,1
7322,2048550038,BX,817 EAST 230 STREET,10,G0,"GREER, GEORGE A JR.",2,1,1
7323,2048980049,BX,1208 EAST 224 STREET,02,C0,COLLETTE JOHNSON,2,1,1
7324,2049290017,BX,3929 ELY AVENUE,01,A1,"OKEKE, AHAMEFULA DANIEL",2,1,1
7325,2049720026,BX,3960 MERRITT AVENUE,06,F5,CASTRO REALTY DEVELOPMENT LLC,2,1,1
7326,2049750006,BX,955 EAST 233 STREET,02,C2,RY DEVELOPMENT I LLC,3,2,1
7327,2049950066,BX,666 EAST 235 STREET,01,B3,"TEMPLE-HALL, CANCHETTA R",2,1,1
7328,2051030010,BX,4706 BRONX BOULEVARD,01,B2,"PENA, IDELSA",2,1,1
7329,2053860027,BX,2836 MIDDLETOWN ROAD,02,C0,"PEPGJONAJ, LUKA",2,1,1
7330,2054130036,BX,1608 KENNELLWORTH PLACE,01,A2,NOCERINO SALVATORE,2,1,1
7331,2055800113,BX,2787 MILES AVENUE,01,B1,"CORNIELES, JOSE A",2,1,1
7332,2056260133,BX,82 REYNOLDS STREET,01,A1,FRACASSI FRAN,2,1,1
7333,2056290026,BX,40 FORDHAM STREET,01,B2,CASAS  GWEN M,2,1,1
7334,2056390014,BX,156 MARINE STREET,01,A1,"SCAVELLO, GABRIEL",4,3,1
7335,2056480224,BX,185 TERRACE STREET,02,C2,ELIZABETH O'LEARY,6,5,1
7336,2057120070,BX,3014 IRWIN AVENUE,10,G1,"T.K. MANAGEMENT, LLC",2,1,1
7337,2057310836,BX,2705 ARLINGTON AVENUE,01,A1,"FEIT, DANIEL Y",2,1,1
7338,3001997501,BK,90 FURMAN STREET,04,RM,UNAVAILABLE OWNER,2,1,1
7339,3002510026,BK,40 REMSEN STREET,02,C6,40 REMSEN STREET OWNERS CORP,2,1,1
7340,3003960012,BK,278 WARREN STREET,03,D1,TABLE OF 9 LLC,2,1,1
7341,3003990036,BK,504 WARREN STREET,01,B9,"504 WARREN STREET, LLC",2,1,1
7342,3004330052,BK,569 UNION STREET,04,S5,"ATTOINESE, DENISE",2,1,1
7343,3004707502,BK,191 LUQUER STREET,03,R4,UNAVAILABLE OWNER,2,1,1
7344,3005640001,BK,43 FERRIS STREET,06,F5,EDWARD R BUTLER CO INC,3,2,1
7345,3006850017,BK,190 33 STREET,01,B3,"ROLNICK, KAREN",2,1,1
7346,3011130172,BK,455 PROSPECT AVENUE,02,C0,455 PROSPECT AVENUE LLC,2,1,1
7347,3011510001,BK,619 CARLTON AVENUE,02,C0,STRICKLAND HAROLD A III,2,1,1
7348,3011527505,BK,272 ST MARKS AVENUE,02,R1,UNAVAILABLE OWNER,2,1,1
7349,3012490037,BK,226 BROOKLYN AVENUE,08,M1,ST GREGORYS RC CH,3,2,1
7350,3012950026,BK,168 CROWN STREET,01,A4,THOMAS HAYES JR,2,1,1
7351,3014090021,BK,1716 PRESIDENT STREET,01,B1,"DOMINGUE, MICHEL",2,1,1
7352,3014530026,BK,1980 BERGEN STREET,02,C0,"JOHNSON , KENNETH H SR",2,1,1
7353,3015300019,BK,1891 FULTON STREET,05,K1,"1891 FULTON STREET, LLC",2,1,1
7354,3015380134,BK,122 ROCKAWAY AVENUE,01,B2,"SOLOMON, JANELLE R",2,1,1
7355,3016190010,BK,237 MARCUS GARVEY BLVD,02,C4,732 GREENE AVENUE LLC,2,1,1
7356,3017630060,BK,238 WALWORTH STREET,02,C0,"PAVEL, MENDEL",2,1,1
7357,3018730025,BK,170 FLUSHING AVENUE,07,G5,"168-170 FLUSHING AVENUE,LLC",2,1,1
7358,3018940005,BK,89 STEUBEN STREET,06,E1,UNAVAILABLE OWNER,5,4,1
7359,3019800064,BK,993 FULTON STREET,04,K4,"WIDDI, ROCKY",2,1,1
7360,3020320046,BK,38 CLERMONT AVENUE,01,A9,GONZALEZ LUISA,2,1,1
7361,3020337501,BK,130 FLUSHING AVENUE,04,RM,NAVY GREEN R1 LLC,2,1,1
7362,3021190029,BK,138 LAFAYETTE AVENUE,01,A5,"KOTEEN, LUCY",2,1,1
7363,3023360013,BK,172 NORTH 6 STREET,01,B1,"KLEM, KATHERYN/INDIV",2,1,1
7364,3023990019,BK,383 SOUTH 1 STREET,04,D6,E&D MANAGEMENT GROUP LLC,2,1,1
7365,3024200037,BK,223 SOUTH 3 STREET,02,C1,TIFERETH RLTY CORP,2,1,1
7366,3024960001,BK,1068 MANHATTAN AVENUE,04,S3,"LUU, LIENG",2,1,1
7367,3025230025,BK,206 GREEN STREET,04,S2,VERONICA RAMCHARAN,2,1,1
7368,3027350038,BK,177 FROST STREET,01,B9,SGRIZZI LEWIS,2,1,1
7369,3027480001,BK,330 LEONARD STREET,02,C1,NATALE FAMILY TRUST,4,3,1
7370,3027520010,BK,62 SKILLMAN AVENUE,02,C2,62 SKILLMAN AVENUE LLC,2,1,1
7371,3027640039,BK,129 DEVOE STREET,01,B9,"FRANCINE PISANI, AS TRUSTEE",2,1,1
7372,3028690011,BK,366 FROST STREET,06,E1,LESWYS REALTY CORP,5,4,1
7373,3028840010,BK,234 JACKSON STREET,01,B9,"MARCANO, RICHARD M",2,1,1
7374,3029240014,BK,342 DEVOE STREET,01,B2,"SERRANO, BERNICE",2,1,1
7375,3030767501,BK,14 BOERUM STREET,04,RM,UNAVAILABLE OWNER,4,3,1
7376,3031720033,BK,104 CENTRAL AVENUE,02,C1,104 CENTRAL LLC,2,1,1
7377,3031740051,BK,219 TROUTMAN STREET,02,C2,219 TROUTMAN LLC,2,1,1
7378,3031870007,BK,221 KNICKERBOCKER AVENUE,04,S4,"TANG, HONG QING",2,1,1
7379,3032150020,BK,80 SUYDAM STREET,02,C0,"CHEN, JIAN REN",2,1,1
7380,3032520046,BK,23 KOSSUTH PLACE,11,V0,"CAMPBELL, LUZZANNA",2,1,1
7381,3032750004,BK,305 EVERGREEN AVENUE,01,B2,"COVERT, GEOFFREY DANIEL",2,1,1
7382,3034350028,BK,610 WILSON AVENUE,02,C1,"SDM ENTERPRISES, INC.",2,1,1
7383,3035140051,BK,542 SARATOGA AVENUE,08,M1,I AM THE WAY CHURCH,2,1,1
7384,3035210054,BK,460 ROCKAWAY AVENUE,04,K4,460 ROCKAWAY AVENUE ASSOCAITES LLC,2,1,1
7385,3035520019,BK,171 GRAFTON STREET,01,B1,"HAMILTON, ROHAN",2,1,1
7386,3035830035,BK,94 LIVONIA AVENUE,02,C0,"BARROW, CEDRIC A",2,1,1
7387,3037540029,BK,302 PENNSYLVANIA AVENUE,01,B2,"BRIDET, ROBERT",2,1,1
7388,3038370017,BK,559 ALABAMA AVENUE,01,B1,"FRANCIS , SONIA",2,1,1
7389,3039390023,BK,210 CLEVELAND STREET,01,B2,"RAMPHAUL, OMDAT",2,1,1
7390,3039790005,BK,299 HENDRIX STREET,01,B2,"OLAWOLE, OLUWATOYIN T",2,1,1
7391,3040650038,BK,570 ELTON STREET,01,B1,"HARGRAVES, KYLE T",2,1,1
7392,3040760148,BK,648 BARBEY STREET,01,A5,LENNOX SCOTT,2,1,1
7393,3041190055,BK,302 ETNA STREET,01,B3,"PEREZ, RAMON LIUIS",2,1,1
7394,3041280001,BK,3247 FULTON STREET,04,S4,TJA REALTY LLC,2,1,1
7395,3041530073,BK,352 LOGAN STREET,02,C0,"ALEXANDER, ANGUS",2,1,1
7396,3041540094,BK,909 LIBERTY AVENUE,04,S3,"VITUCCI, DOMINICK",2,1,1
7397,3041740076,BK,406 GRANT AVENUE,01,B1,LEE ELSA,2,1,1
7398,3041940010,BK,19 DOSCHER STREET,01,A1,"DESIR, ROSELUCE",2,1,1
7399,3042300030,BK,512 CHESTNUT STREET,01,B2,PAMELA SMALLS,2,1,1
7400,3042460027,BK,258 FOUNTAIN AVENUE,01,B2,"WILLIAMS, PHILOMENA",2,1,1
7401,3043020033,BK,694 BRADFORD STREET,02,C0,"PHILIP, THERESA",2,1,1
7402,3043180046,BK,89 LOUISIANA AVENUE,01,B2,"SIERRA JR, RADAMES",2,1,1
7403,3044830042,BK,2526 LINDEN BOULEVARD,04,K4,HOLLY STREET HOLDING CORP,2,1,1
7404,3045270026,BK,858 PINE STREET,01,B2,HELEN J SEPULVEDA,2,1,1
7405,3046140037,BK,154 EAST 96 STREET,02,C3,MARSHALL CLAUDE,2,1,1
7406,3047040031,BK,5698 KINGS HIGHWAY,01,B3,THE ADMINISTRATOR OF VETERANS AFFAIRS,2,1,1
7407,3047740073,BK,629 EAST 53 STREET,01,A9,"PHILLIPS, DEBRA",2,1,1
7408,3047780021,BK,830 EAST 48 STREET,01,A5,JEAN O FELISME,2,1,1
7409,3047980073,BK,473 MIDWOOD STREET,01,B1,WALDRUN GLADYS,2,1,1
7410,3048640014,BK,774 TROY AVENUE,01,A9,"GAUTHIER, FRITZ",2,1,1
7411,3049120016,BK,506 EAST 45 STREET,01,B2,HERMENIA MATHIAS,2,1,1
7412,3050370044,BK,84 RUTLAND ROAD,01,A4,"YEATON, GREER",2,1,1
7413,3050950014,BK,91 RUGBY ROAD,01,A1,"PRISANT, M. BARDEN",2,1,1
7414,3051080050,BK,2911 SNYDER AVENUE,01,A1,"KNIGHT, ROBIN",2,1,1
7415,3051360055,BK,187 LOTT STREET,01,A9,GLENDA  ALEXANDER,2,1,1
7416,3051810061,BK,497 EAST 17 STREET,01,A1,"OFFENGEYM, ROMAN",2,1,1
7417,3052710017,BK,30 EAST 3 STREET,01,A2,"LIANG, LI FU",2,1,1
7418,3052860014,BK,33 EAST 7 STREET,01,B1,JAMES RANDALL STROHM,2,1,1
7419,3052870044,BK,210 PROSPECT PARK SW,05,O1,PARK CIRCLE REALTY ASSOCIATES,2,1,1
7420,3053650030,BK,1554 39 STREET,01,B1,"FRIED, MORDECHAI",2,1,1
7421,3053680013,BK,334 DAHILL ROAD,02,C1,334 DAHILL REALTY LLC,2,1,1
7422,3054050011,BK,1712 43 STREET,01,B2,LEAH UNGER,2,1,1
7423,3054320032,BK,1662 44 STREET,01,B3,"RICHARD, MOSHE",2,1,1
7424,3054320047,BK,4416 17 AVENUE,01,B1,CHAIM MOSKOVITS,2,1,1
7425,3054330023,BK,1542 45 STREET,01,B1,"ZABLOTSKY, MORDECHAI",2,1,1
7426,3054390074,BK,13 WEBSTER AVENUE,02,C0,WELLSTONE HOUSE,2,1,1
7427,3054480078,BK,1629 49 STREET,01,A9,"KLEIN, MORDECHAI",2,1,1
7428,3054600003,BK,5017 17 AVENUE,01,B3,WEST CRESCENT REALTY LLC,2,1,1
7429,3055020014,BK,1520 58 STREET,01,B2,"SCHAYA, ISRAEL",2,1,1
7430,3055050034,BK,1866 58 STREET,01,A3,"IZSAK, MONICA",2,1,1
7431,3055220069,BK,2127 61 STREET,01,A5,"DREW, YAAKOV",2,1,1
7432,3055460065,BK,1753 65 STREET,02,C0,THE LEON SMATT IRREVOCABLE TRUST,3,2,1
7433,3055500078,BK,2103 65 STREET,01,B3,JIAN T XIAO,2,1,1
7434,3056340057,BK,1249 49 STREET,01,A5,"ISRAEL GLUCK, AS TRUSTEE",2,1,1
7435,3056680010,BK,1112 53 STREET,01,B1,1112 53 ST LLC,2,1,1
7436,3057330015,BK,1320 62 STREET,02,C2,"62 ST,CORP",2,1,1
7437,3057610041,BK,6612 14 AVENUE,01,B1,"LIN, CUI YING",2,1,1
7438,3057620023,BK,1440 66 STREET,02,C0,TUEN MAN POON,2,1,1
7439,3058670037,BK,719 BAY RIDGE AVENUE,01,B1,"ZHU, HENG GUO",2,1,1
7440,3058980005,BK,7011 10 AVENUE,01,A1,"SKOUNTZOS, DIMITRA",2,1,1
7441,3059110016,BK,606 72 STREET,01,B1,"DONG, XULEI",2,1,1
7442,3059550036,BK,1070 76 STREET,01,A5,"POPINO, MARIE A",2,1,1
7443,3064320056,BK,8812 17 AVENUE,01,B2,"EL-KHATIB, MOHAMMED",2,1,1
7444,3064610086,BK,293 BAY 14 STREET,01,B1,DAVID YUSUPOV,2,1,1
7445,3065210069,BK,959 EAST 8 STREET,01,A3,"FLASTER, SAMI",2,1,1
7446,3065400037,BK,1370 EAST 5 STREET,01,A9,MISCHA GLUSTEIN,2,1,1
7447,3065440030,BK,1252 EAST 9 STREET,04,S1,RACHEL TEPLER FAMILY TRUST,2,1,1
7448,3065690040,BK,1462 EAST 7 STREET,01,B1,YONA ENGELMAN,2,1,1
7449,3065920078,BK,1449 EAST 10 STREET,01,B3,"COHEN, ROVI",2,1,1
7450,3066030056,BK,1587 WEST 4 STREET,03,D1,WEST 4TH REALTY LLC,2,1,1
7451,3066150078,BK,1545 EAST 8 STREET,01,B2,JOELLE COHEN,2,1,1
7452,3066370053,BK,509 QUENTIN ROAD,01,A9,"SALEM, ISAAC",2,1,1
7453,3066620059,BK,1793 EAST 5 STREET,01,A3,"SAIDEH, ISAAC",2,1,1
7454,3066640013,BK,1714 EAST 8 STREET,01,A5,DAVID LATI,2,1,1
7455,3066810458,BK,1882 OCEAN PARKWAY,01,A3,"AVITAL, JACK",2,1,1
7456,3066860037,BK,770 WESTMINSTER ROAD,01,B2,BERGER CARLOS,2,1,1
7457,3066880055,BK,779 ARGYLE ROAD,01,A1,"FRIEDMAN, DAVID",2,1,1
7458,3067220067,BK,1497 CONEY ISLAND AVENUE,04,K4,1497 CIA LLC,2,1,1
7459,3067580016,BK,1524 EAST 12 STREET,02,C3,1524 EAST 12 LLC,2,1,1
7460,3067650060,BK,1595 EAST 18 STREET,01,B1,1595 PARTNERS LLC,2,1,1
7461,3067680087,BK,1635 EAST 21 STREET,01,A1,CHAIM MOZES,2,1,1
7462,3067850035,BK,1670 EAST 23 STREET,01,A1,"MOUHADEB, RAYMOND",2,1,1
7463,3068000026,BK,1750 EAST 18 STREET,08,W9,FRIENDS OF TORAH,2,1,1
7464,3068040086,BK,1815 EAST 21 STREET,01,A1,"ZACCAI, KAREN",2,1,1
7465,3068190068,BK,1855 EAST 13 STREET,01,B2,CHAIM KATZ,2,1,1
7466,3069130003,BK,2715 CROPSEY AVENUE,01,A1,MAZZARA FRANK,2,1,1
7467,3069240084,BK,2566 WEST 16 STREET,01,A9,"STUTO, MARIA",2,1,1
7468,3069600045,BK,3815 CYPRESS AVENUE,02,C3,"SORVINO, PETER S",2,1,1
7469,3069750001,BK,3931 LYME AVENUE,01,B2,KAREN KOVACH,2,1,1
7470,3070210038,BK,2870 WEST 16 STREET,01,A2,"SMITH, ROSALIA J",2,1,1
7471,3070210058,BK,2871 WEST 17 STREET,04,D6,"1256 OCEAN AVENUE, LLC",3,2,1
7472,3070230036,BK,1403 MERMAID AVENUE,05,K5,MARC SMOUHA,2,1,1
7473,3070900037,BK,1974 EAST 9 STREET,01,A5,SION DADON,2,1,1
7474,3070910027,BK,928 HUTCHINSON COURT,01,A9,"DANIEL, YVETTE",2,1,1
7475,3071040397,BK,2066 EAST 1 STREET,01,B3,"SABBAGH, MORRIS",2,1,1
7476,3071040466,BK,2068 EAST 2 STREET,01,B2,"HEDAYA, KAREN E",2,1,1
7477,3071290029,BK,2210 EAST 3 STREET,01,B2,"CHKALO, REIM",2,1,1
7478,3071310013,BK,2182 EAST 5 STREET,01,B2,"ALLAHAM, MOUSSA",2,1,1
7479,3071320069,BK,2185 EAST 5 STREET,01,A9,BERTA KINDI NAFTALI,2,1,1
7480,3071840124,BK,716 CRAWFORD AVENUE,01,B3,"ABRAHAM, MOSHE",2,1,1
7481,3071970045,BK,465 AVENUE Y,01,B2,THOMAS DIBONA,2,1,1
7482,3071980033,BK,2486 EAST 3 STREET,01,B3,"NUNZIATA, ANTHONY V",2,1,1
7483,3072160071,BK,2517 WEST STREET,01,B3,"EBADI, SOUZI",2,1,1
7484,3073530063,BK,2579 OCEAN AVENUE,05,O7,"JOLIRO 25, LLLC",2,1,1
7485,3073710017,BK,2224 EAST 12 STREET,01,B2,"ARMOUT-LEVY, ELIE",2,1,1
7486,3073960064,BK,2333 EAST 12 STREET,01,B3,COHEN FAMILY TRUST,2,1,1
7487,3074660001,BK,2102 JEROME AVENUE,02,C3,BELLA KRATMAN,2,1,1
7488,3075710023,BK,2985 BEDFORD AVENUE,08,I7,"INDEPENDENCE RESIDENCES, INC.",2,1,1
7489,3075890011,BK,3109 BEDFORD AVENUE,01,A1,"NAFTALI, VERA",2,1,1
7490,3075900015,BK,971 EAST 26 STREET,01,B2,971 E 26TH ST LLC,2,1,1
7491,3075920031,BK,935 EAST 28 STREET,01,B2,"SCHNUR, CELIA",2,1,1
7492,3076110025,BK,1049 EAST 29 STREET,01,A9,"JOSELIT, SHERRY SHAINDY",2,1,1
7493,3076440038,BK,1217 EAST 26 STREET,01,A1,ESTHER EISENREICH,2,1,1
7494,3077150034,BK,1715 EAST 32 STREET,01,A9,VINCENT CLANCY,2,1,1
7495,3078520006,BK,5409 AVENUE M,01,A9,"EVERETT, STEPHANIE",2,1,1
7496,3081460060,BK,1340 ROCKAWAY PARKWAY,05,O7,SAPHIRSTEIN IRVING,2,1,1
7497,3081800062,BK,72 CONKLIN AVENUE,01,A2,"JONES , JUANITA",2,1,1
7498,3081810053,BK,77 CONKLIN AVENUE,04,S2,77 CONKLIN CORP,2,1,1
7499,3082200062,BK,1310 EAST 94 STREET,01,B2,"PHILLIP, KWASI",2,1,1
7500,3084050032,BK,2064 EAST 63 STREET,01,B1,"DALRYMPLE, EVERAD",2,1,1
7501,3084900030,BK,2291 UTICA AVENUE,01,A5,"HERNANDEZ, CARMEN",2,1,1
7502,3087130097,BK,84 WEST END AVENUE,02,C0,"IOFFE, DIMITRY",2,1,1
7503,3087330009,BK,137 AMHERST STREET,01,B3,ALEX BLUVSTEIN,2,1,1
7504,3087340049,BK,139 BEAUMONT STREET,01,B1,SEVERINOVSKIY AND LEONOVICH 2007 REVOC.  LIV. TRUST,2,1,1
7505,3087500357,BK,176 HASTINGS STREET,01,A1,"KREPOSTMAN, REVECCA",2,1,1
7506,3087530085,BK,181 JAFFRAY STREET,01,A1,MILANA PLOTNIK,2,1,1
7507,4002320067,QN,48-62 38 STREET,01,B3,VELTEN  JANICE M,2,1,1
7508,4002360004,QN,36-11 GREENPOINT AVENUE,01,B2,"YE, SHENG",2,1,1
7509,4002940335,QN, REVIEW AVENUE,07,U1,NEWTON CREEK PROPERTIES,2,1,1
7510,4003680022,QN,25-16 37 AVENUE,04,D7,25-16 37 AVE OWNERS LLC,3,2,1
7511,4003970010,QN,39-17 27 STREET,01,B9,MARTIN MARIN,2,1,1
7512,4005310033,QN,31-59 14 STREET,01,B2,"KUMAR, SURINDER",2,1,1
7513,4006090027,QN,32-02 34 AVENUE,04,C7,PISTILLI ASSOCIATES-1,2,1,1
7514,4006190028,QN,28-17 31 STREET,04,S2,LEVIS BROS INC,2,1,1
7515,4006530014,QN,25-57 37 STREET,01,B2,THEODORA PAPANTONIOU,2,1,1
7516,4006830076,QN,30-46 42 STREET,02,C0,"30-46 42ND STREET, LLC",2,1,1
7517,4007210012,QN,28-35 47 STREET,02,C0,"PIRRECA, FRANCESCA",3,2,1
7518,4007820046,QN,22-57 43 STREET,02,C2,"PHILOU PROPERTIES, LLC",2,1,1
7519,4008070123,QN,21-25 38 STREET,01,A5,"NIKOLAOU, GABRIEL",2,1,1
7520,4008200071,QN,23-80 36 STREET,01,B3,"SIRIODIS , MICHAEL",2,1,1
7521,4008440040,QN,22-06 31 STREET,05,K2,DITMARS 31ST STREET ASSOCIATES LLC,2,1,1
7522,4008560040,QN,22-20 27 STREET,01,B1,SIMELA BAXEVANIS,2,1,1
7523,4008630013,QN,24-53 24 STREET,01,B1,GERAGHTY PATRICK,2,1,1
7524,4008650035,QN,24-04 23 AVENUE,01,A5,VOJKO TURKOVIC,2,1,1
7525,4008670030,QN,24-04 DITMARS BOULEVARD,01,B1,ATHANASIA ETHEL SPERAKIS,2,1,1
7526,4008880012,QN,18-17 25 ROAD,02,C0,"HERNANDEZ, KEVIN",2,1,1
7527,4010910044,QN,97-01 24 AVENUE,01,B2,ALVINA HOME SALES CORP.,3,2,1
7528,4010920013,QN,23-16 99 STREET,01,B3,"BANK OF AMERICA, N.A.",2,1,1
7529,4011070034,QN,96-15 25 AVENUE,01,B1,96-15 25TH AVE. LIMITED,2,1,1
7530,4011720001,QN,32-01 76 STREET,02,C0,CHIN ALBERT S,2,1,1
7531,4012450027,QN,33-46 73 STREET,01,B1,"BELLINI, WALTER",2,1,1
7532,4012950047,QN,39-63 63 STREET,06,F9,GOLDEN SUN DEVELOPMENT LLC,2,1,1
7533,4013550061,QN,72-09 45 AVENUE,01,A5,72-09 45 INC.,2,1,1
7534,4014290053,QN,32-35 99 STREET,01,B1,SIAVICHAY WASHINGTON,2,1,1
7535,4017830029,QN,111-19 39 AVENUE,01,B3,"CALLE, JOSE F",2,1,1
7536,4018880020,QN,50-23 96 STREET,01,B2,"YANG, EMILY",2,1,1
7537,4018950035,QN,53-10 96 STREET,01,B3,KOK CHEUNG KWOK,2,1,1
7538,4019420069,QN,103-61 52 AVENUE,01,B2,"MENDEZ, OSCAR",2,1,1
7539,4019420072,QN,103-57 52 AVENUE,01,B2,"HERRERA, ALFONSO",2,1,1
7540,4019440129,QN,53-04 108 STREET,04,C7,"JLG QUEENS HOLDING, LLC",3,2,1
7541,4019900013,QN,104-32 46 AVENUE,01,B3,"LIN, GUI ZHEN",2,1,1
7542,4020090045,QN,109-47 54 AVENUE,01,B3,JOHN DURANTE LIVING TRUST,2,1,1
7543,4023280018,QN,48-31 58 LANE,01,A5,AHMED SHUEB,2,1,1
7544,4024480036,QN,48-03 72 STREET,01,A2,"BOGOSIAN, SARO",2,1,1
7545,4024650005,QN,72-00 51 ROAD,06,F9,72-00 51ST ST. ASSOCIATES,2,1,1
7546,4024840016,QN,52-47 72 PLACE,01,B1,GREGORY ACEVEDO,2,1,1
7547,4024850051,QN,73-23 52 AVENUE,01,B3,"LEE, MAN LEUNG",2,1,1
7548,4024970026,QN,69-34 53 ROAD,01,B2,KEVIN J. BROSI,2,1,1
7549,4024980019,QN,69-20 53 DRIVE,01,A5,"TIMKO, ALISON N",2,1,1
7550,4025350006,QN,53-05 44 STREET,02,C0,"KMZ ENTERPRISES, LLC",3,2,1
7551,4026110130,QN,50-00 GRAND AVENUE,06,F1,5000 GRAND LLC,2,1,1
7552,4026300079,QN,59-03 55 STREET,01,B2,MEMBRENO MARVIN R,2,1,1
7553,4026370049,QN,60-69 54 STREET,01,B2,"CANTOS, ROSANA",2,1,1
7554,4027090007,QN,61-55 56 ROAD,01,B3,"SADOWY, ANDREW",2,1,1
7555,4027280029,QN,60-42 59 AVENUE,01,B2,THOMAS NEMETH,2,1,1
7556,4027600028,QN,64-40 60 AVENUE,01,A5,"CUNI, BARDHOK",2,1,1
7557,4027620077,QN,64-23 ELIOT AVENUE,01,B2,"CORTES, JR., RAMON C",2,1,1
7558,4027710030,QN,62-42 64 STREET,01,B2,3099 VILLA AVE BRONX LLC,2,1,1
7559,4028710020,QN,86-36 57 ROAD,01,A1,JOHN VINCENT CURRY,2,1,1
7560,4031220010,QN,63-25 DIETERLE CRESCENT,01,A1,"HSI, CHEN JONG",2,1,1
7561,4031400060,QN,85-23 66 ROAD,01,A5,ANDREAS PARPAS,3,2,1
7562,4033280020,QN,8250 GRENFELL STREET,01,A3,"CONG, ANITA NG",2,1,1
7563,4033880055,QN,1921 GREENE AVENUE,01,B2,THOMAS ZAWALICH,2,1,1
7564,4035820040,QN,60-19 COOPER AVENUE,01,A5,ANTHONY MUNIZ,2,1,1
7565,4035980071,QN,74-66 64 LANE,01,B2,EVELYN MUNIZ,2,1,1
7566,4037090052,QN,73-48 71 PLACE,01,A1,DEVER JAMES J,2,1,1
7567,4037970025,QN,78-36 69 AVENUE,01,B2,"MARCIAL, DESTYNIE S",2,1,1
7568,4038340075,QN,78-63 83 STREET,01,B2,"NOCI, NIKOLA",2,1,1
7569,4039010015,QN,91-24 71 ROAD,01,A1,"LOMBANA, EFREN",2,1,1
7570,4039360035,QN,119-50 POPPENHUSEN AVENUE,01,A2,"EMMERICH, ROSEMARIE",2,1,1
7571,4040060079,QN,13-05 128 STREET,01,B1,"LIN, XIN WANG",2,1,1
7572,4046140011,QN,14-55 166 STREET,01,A2,"SKOUNTZOS, EMMANOUEL O",2,1,1
7573,4046690031,QN,19-14 150 STREET,01,B9,"REDDY, DANIEL",2,1,1
7574,4046700011,QN,149-15 20 ROAD,01,A1,D'ANGELO CARMELINA,2,1,1
7575,4047090007,QN,21-15 MURRAY STREET,01,B1,"PARK, SANGSOO",2,1,1
7576,4047210024,QN,15-30 153 PLACE,02,C0,"FRANKOVIC, GRACIJELA",2,1,1
7577,4049770088,QN,136-51 37 AVENUE,05,K2,136-51 37 AVENUE LLC,2,1,1
7578,4049910041,QN,33-32 150 PLACE,01,A1,"YANG, CHUL  S",2,1,1
7579,4050200008,QN,38-05 UNION STREET,05,K7,EAST WEST BANK & AFFILIATES,2,1,1
7580,4050270042,QN,147-32 ROOSEVELT AVENUE,08,M9,FIRST UNITED METHODIST CHURCH IN FLUSHIN G,2,1,1
7581,4051200034,QN,56-21 136 STREET,01,B1,"ZHANG, GEORGE GENGHONG",2,1,1
7582,4051470056,QN,137-33 HOLLY AVENUE,01,A5,CALVIN JEAN,2,1,1
7583,4051510022,QN,137-50 LABURNUM AVENUE,01,B1,"LIN, YAO GUI",2,1,1
7584,4052080026,QN,46-40 UNION STREET,01,B2,HUANG YUN Y,2,1,1
7585,4052520011,QN,33-61 167 STREET,01,A1,"PETSAS, SOFIA",2,1,1
7586,4053360012,QN,41-24 163 STREET,02,C0,SEUNG YOU BAI,2,1,1
7587,4053370027,QN,163-28 NORTHERN BOULEVARD,04,K4,"C&K INTERNATIONAL, LLC",2,1,1
7588,4053920023,QN,42-02 162 STREET,06,F5,TESTAMENTARY TRUST UNDER LWT OF VICTOR H . KESSLER,2,1,1
7589,4054600107,QN,46-31 161 STREET,02,C0,"CHEN, AI ZHU",2,1,1
7590,4054610010,QN,46-51 162 STREET,01,B2,OWENS JAMES P,2,1,1
7591,4055810053,QN,171-23 BAGLEY AVENUE,01,A1,"KANE, JOAN",2,1,1
7592,4056090036,QN,192-05 48 AVENUE,01,A1,K M TWO INC.,2,1,1
7593,4057990064,QN,199-07 26 AVENUE,01,A5,"MA, ZHEN",2,1,1
7594,4059000222,QN,211-32 23 AVENUE,02,C0,"LIN, YONGFEI",2,1,1
7595,4060960014,QN,34-18 208 STREET,01,A1,"KIRSCHHOFER, JOHN",2,1,1
7596,4062000043,QN,38-38 205 STREET,01,A1,"KAZALAS, JOHN D",2,1,1
7597,4062470027,QN,39-24 215 PLACE,01,A1,"ZHANG, TENG",2,1,1
7598,4062760050,QN,42-25 209 STREET,01,A1,"DANKNER, JENNIFER",2,1,1
7599,4065170250,QN,152-50 MELBOURNE AVENUE,08,W6,QUEENS COLLEGE,2,1,1
7600,4068910022,QN,174-02 HORACE HARDING EXPWY,07,G4,174-02 HORACE HARDING REALTY CORP,2,1,1
7601,4069220050,QN,67-16 169 STREET,01,A2,"HEIMANN, CAROLE",2,1,1
7602,4070190001,QN,168-02 UNION TURNPIKE,05,K1,90-33 153RD STREET ASSOCIATES,2,1,1
7603,4072430012,QN,182-24 ABERDEEN ROAD,01,A2,"ALISHAYEV, ALBERT",2,1,1
7604,4072500024,QN,182-24 80 DRIVE,01,A1,182-24 80TH DRIVE LLC,2,1,1
7605,4075210059,QN,57-38 228 STREET,01,B9,"SCHABHUTTL, MARY JO",2,1,1
7606,4076870066,QN,69-51 228 STREET,01,B3,"PRAINITO, JOSEPH",2,1,1
7607,4080240023,QN,346 RICHMOND ROAD,01,A0,"CHENG, JACK JIANCHAO",2,1,1
7608,4080670026,QN,30 OAK LANE,01,A1,"KARLYA, JEANNE",2,1,1
7609,4081030049,QN,240-16A CHERRY STREET,01,Z0,"POLLICINO, ANNA",2,1,1
7610,4081030058,QN,328 CHERRY STREET,01,A1,THOMAS J SEPE,2,1,1
7611,4081710019,QN,49-16 DOUGLASTON PARKWAY,02,C3,49-16 HOLDINGS LLC,2,1,1
7612,4083450067,QN,57-56 256 STREET,02,C0,"WU, WILLIAM",2,1,1
7613,4085010025,QN,76-25 250 STREET,01,A2,"NARULA, JASJIT K",2,1,1
7614,4087100045,QN,80-26 255 STREET,01,A1,ELENIS MARIA,2,1,1
7615,4087590168,QN,82-56 266 STREET,01,A0,GELLMAN EILEEN,3,2,1
7616,4088460007,QN,76-28 PARK LANE SOUTH,02,C0,"CAJAMARCA, LUIS FABIAN",2,1,1
7617,4089170020,QN,80-60 87 ROAD,01,A9,BINA RAZACK,2,1,1
7618,4089240034,QN,88-31 87 STREET,01,B3,"WONG, NELSON HING",2,1,1
7619,4089320001,QN,90-04 JAMAICA AVENUE,04,K4,"DOUROUNTOUDAKIS, MICHAEL",2,1,1
7620,4089860021,QN,92-21 92 AVENUE,01,A1,"SMITH, ROBERT ANTHONY",2,1,1
7621,4090840042,QN,84-23 102 AVENUE,02,C0,"YBR HOLDING, L.L.C.",2,1,1
7622,4093290043,QN,87-84 120 STREET,01,A1,87-84 120TH STREET LLC,2,1,1
7623,4093550124,QN,90-08 130 STREET,01,A1,91ST AVENUE LLC,2,1,1
7624,4093750157,QN,134-10 91 AVENUE,01,A9,"DAMON, DAVID R.",2,1,1
7625,4094140013,QN,95-12 113 STREET,02,C0,THEODORE C WITTING,3,2,1
7626,4094680020,QN,97-32 126 STREET,01,A1,"MOHAMED, INDRANIE",2,1,1
7627,4095160012,QN,103-18 112 STREET,01,B2,RICHARD M SINGH,2,1,1
7628,4095580008,QN,120-16 103 AVENUE,01,B3,"RUPNARAIN, PARMANAN",2,1,1
7629,4095760038,QN,104-74 123 STREET,01,B2,"CHANDARBALI, DEVICA",2,1,1
7630,4095910052,QN,105-05 131 STREET,01,B3,CHARLES HENRY SOLOMON,2,1,1
7631,4095910107,QN,131-07 107 AVENUE,01,A1,"IQBAL, MOHAMMED",2,1,1
7632,4096890029,QN,87-70 146 STREET,01,A1,"LEON, ELIZABETH",2,1,1
7633,4097050008,QN,148-18 87 AVENUE,01,A1,"DESAGUN, JOSE GARRY",2,1,1
7634,4097960025,QN,91-01 MERRICK BOULEVARD,05,K3,91-01 MERRICK BLVD ASSOCIATES LLC,2,1,1
7635,4098060055,QN,91-02 172 STREET,02,C0,"FERNANDO, PHILIPNERU M",2,1,1
7636,4098330032,QN,175-50 88 AVENUE,01,B3,"COYOC, ADRIAN",2,1,1
7637,4099050065,QN,184-08 90 AVENUE,01,A5,SAHEED KHAN,2,1,1
7638,4099790030,QN,139-03 91 AVENUE,01,B1,TARACHAND DEOLALL,2,1,1
7639,4100180020,QN,138-48 101 AVENUE,01,B1,"HERNANDEZ, MARIA",3,2,1
7640,4100490008,QN,145-56 LIBERTY AVENUE,06,E1,145-56 LLC,2,1,1
7641,4100760027,QN,144-15 SHORE AVENUE,01,A1,"GILL, ROBERT",2,1,1
7642,4100910009,QN,146-61 LAKEWOOD AVENUE,02,C0,"BROWN, PETER L",2,1,1
7643,4101020022,QN,92-36 GUY R BREWER BLVD,05,K2,S6 GUY BREWER 2 LLC,2,1,1
7644,4101290030,QN,106-46 GUY R BREWER BLVD,05,K2,US BANK NA,2,1,1
7645,4101940006,QN,110-47 166 STREET,01,A1,"CHAUCA CARDENAS, TELMO",2,1,1
7646,4102050054,QN,111-44 168 STREET,01,A1,"LEITCH, DESMOND",2,1,1
7647,4102100237,QN,92-15 168 PLACE,01,A9,APANAH IVAN,2,1,1
7648,4103520135,QN,187-30 JAMAICA AVENUE,05,K1,MINISTERIO INTERNACIONAL TIERRA DESEABLE  INC.,2,1,1
7649,4104660125,QN,197-19 91 ROAD,01,B2,RAMBHARAN ZABEEDA,2,1,1
7650,4105730047,QN,89-47 208 STREET,01,A5,"YUAN, ZHENHUA",3,2,1
7651,4106520024,QN,90-02 218 STREET,01,B3,"SILVA, DOMINGOS",2,1,1
7652,4109800044,QN,112-20 205 STREET,01,A5,"THOMPSON, PAULINE",2,1,1
7653,4110140053,QN,114-49 197 STREET,01,A5,"DELARNO, DUNCAN",2,1,1
7654,4110150057,QN,114-37 198 STREET,01,A5,"MCGEE-SAMOIS, KATHY",2,1,1
7655,4116700046,QN,115-41 126 STREET,01,A1,CLIFTON O. GUMBS,2,1,1
7656,4116700151,QN,115-33 126 STREET,01,A5,GREGOIRE JOSEPH,2,1,1
7657,4116720139,QN,128-03 116 AVENUE,01,A5,"RAJKUMAR, SAVITRI",2,1,1
7658,4116850025,QN,116-34 130 STREET,01,B3,"JACKSON, KHAYYAM S",2,1,1
7659,4117390039,QN,133-02 LEFFERTS BOULEVARD,01,B3,"SOMWARU, RAUL",3,2,1
7660,4117860024,QN,133-23 127 STREET,08,N9,KAD OF QUEENS LLC,2,1,1
7661,4118060012,QN,135-37 LEFFERTS BOULEVARD,04,K4,"JASO ENTERPRISES, INC.",2,1,1
7662,4118940023,QN,150-29 125 STREET,01,A1,"VIVAS, JR., MIGUEL",2,1,1
7663,4119410247,QN,145-48 FERNDALE AVENUE,01,B3,"SINGH, ANDREW Y",2,1,1
7664,4119640279,QN,111-53 LIVERPOOL STREET,01,A1,"DANIELS, THERESA",2,1,1
7665,4119770051,QN,114-47 146 STREET,01,A1,AKANDE NORMA,2,1,1
7666,4119790017,QN,114-24 149 STREET,01,A1,"RAMPERSAUD-BHOLA, PRAMRAJIE",2,1,1
7667,4120050015,QN,116-20 146 STREET,01,A1,"HARUN, MOHAMED R",2,1,1
7668,4120170019,QN,117-28 144 STREET,01,A1,"RAMNARINE , LALTA  P",2,1,1
7669,4121640056,QN,110-38 UNION HALL STREET,01,A1,"MORRISON, CHRISTINE",2,1,1
7670,4121840029,QN,114-03 AUGUSTA COURT,01,A1,"CRUZ-MATA, DONAL",2,1,1
7671,4122090158,QN,118-42 155 STREET,01,A9,"RIDDICK, SHARON",2,1,1
7672,4123480111,QN,166-18 116 AVENUE,01,A1,"SEEMUNGAL, ELIZABETH",2,1,1
7673,4123530424,QN,116-02 MERRICK BOULEVARD,04,S9,116-02 MERRICK LLC,2,1,1
7674,4123720218,QN,170-36 118 ROAD,01,A1,"NIRANJAN, ANGEL",2,1,1
7675,4123820107,QN,120-56 167 STREET,01,B2,"CANTERBURY, OSBORNE",2,1,1
7676,4123900121,QN,172-47 BAISLEY BOULEVARD,06,E9,BJM BAISLEY LLC,2,1,1
7677,4124480014,QN,118-25 RIVERTON STREET,01,A1,"ROLON, ZIGALLAH",2,1,1
7678,4125710049,QN,176-05 137 AVENUE,01,A1,CLAIRE GARRETT A/K/A,2,1,1
7679,4126150025,QN,118-36 195 STREET,01,A1,FRANK BOWLES,2,1,1
7680,4126450048,QN,119-43 189 STREET,01,A1,ISACSON FAMILY 2009 IRREVOCABLE TRUST,2,1,1
7681,4126580003,QN,201-46 119 AVENUE,01,A1,"MOORE-JACKSON, LETICIA",2,1,1
7682,4126910037,QN,120-25 201 STREET,01,B1,DAVIS BARBARA,2,1,1
7683,4127010009,QN,185-19 NASHVILLE BOULEVARD,01,B2,"MUHAMADU, HANIYFA",2,1,1
7684,4128180047,QN,120-44 234 STREET,01,A1,"SCOTT, MICHAEL A",2,1,1
7685,4129310111,QN,131-50 222 STREET,01,A1,"BATES-BENNETT, MARY F",2,1,1
7686,4130130061,QN,217-02 134 ROAD,01,B2,"HENLEY, MELVINA",2,1,1
7687,4130150024,QN,217-06 135 AVENUE,01,A1,DELROY PINNOCK,2,1,1
7688,4130410033,QN,183-25 141 AVENUE,01,B1,"HUNT, EDWARD",2,1,1
7689,4130550006,QN,184-11 143 AVENUE,01,A1,CLAUDETTE KING,2,1,1
7690,4132850086,QN,167-19 145 ROAD,01,B3,"CORYATT, DESMOND",2,1,1
7691,4133590022,QN,182-15 147 AVENUE,01,B3,"HARPER, JERMAR",2,1,1
7692,4134590017,QN,146-15 225 STREET,01,A1,SMITH JACQUES-SIMON,2,1,1
7693,4150130027,QN,158-18 ROCKAWAY BOULEVARD,06,E1,"IDLEWILD PROPERTIES, LLC",2,1,1
7694,4154000049,QN,526 CROSS BAY BOULEVARD,01,A1,"SUN, YUNZHONG",2,1,1
7695,4155450032,QN,1149 CENTRAL AVENUE,08,I7,PRIME HEALTH SERVICES,2,1,1
7696,4156590007,QN,13-54 PINSON STREET,01,B2,"FLETCHER, WILBURN",2,1,1
7697,4157390001,QN,29-03 BESSEMUND AVENUE,02,C9,"BAYSWATER, TERRACE CORP",5,4,1
7698,4162110060,QN,430 BEACH 130 STREET,01,A1,"SELMAN, JOHN",2,1,1
7699,4163070029,QN,216 BEACH 143 STREET,01,A1,"ZIS, DMITRY AS TRUSTEE",2,1,1
7700,5000550047,SI,56 EAST BUCHANAN STREET,01,A1,"NARINGI, DAVID",2,1,1
7701,5000780289,SI,19 DONALD PLACE,01,A1,KENNETH C SENK,2,1,1
7702,5001260007,SI,75 SILVER LAKE ROAD,01,A1,CHARLES MCLEAN JR,2,1,1
7703,5001340099,SI,420 HOYT AVENUE,02,C3,MRN420 LLC,2,1,1
7704,5001490269,SI,197 PELTON AVENUE,01,A1,BANKS BILLIE,2,1,1
7705,5001800028,SI,406 CARY AVENUE,01,B3,MARIA HALL,2,1,1
7706,5002080032,SI,27 CAROLINE STREET,01,A1,"KALEEM, SUMAIRA",2,1,1
7707,5002180011,SI,119 ELIZABETH STREET,01,A1,EDGARDO LOPEZ,2,1,1
7708,5002520019,SI,208 OAKWOOD AVENUE,01,B2,ROBERT PINTO JR,2,1,1
7709,5002540195,SI,47 EDSTONE DRIVE,01,A1,HEMMING WILLIAM,2,1,1
7710,5002540202,SI,37 EDSTONE DRIVE,01,A1,JOSEPH MANGIONE,2,1,1
7711,5002610001,SI,605 BARD AVENUE,01,A1,W EARL MIDDLETON,2,1,1
7712,5002850059,SI,119 HARVEST AVENUE,01,A2,DIANE BLUM,2,1,1
7713,5003520059,SI,184 GREENLEAF AVENUE,01,B2,"FRONGILLO, ANTHONY",2,1,1
7714,5004480043,SI,275 DICKIE AVENUE,01,A1,MARY J STOOPMAN,2,1,1
7715,5004620107,SI,6 MANN AVENUE,01,A1,JOHN GURRIERI JR,2,1,1
7716,5005200015,SI,534 VAN DUZER STREET,01,A1,OJR CORPORATION,2,1,1
7717,5005290009,SI,74 BROAD STREET,08,Y1,FIRE DEPARTMENT OF NEW YORK,2,1,1
7718,5005650084,SI,242 TARGEE STREET,02,C0,242 TARGEE LLC,2,1,1
7719,5005750016,SI,214 VICTORY BOULEVARD,01,B2,"ANDREA D. LEWIS, AS TRUSTEE",2,1,1
7720,5006220040,SI,73 WANDEL AVENUE,01,A1,OUSMANE DIALLO,2,1,1
7721,5006220080,SI,50 PLEASANT VALLEY AVE,01,A1,"DELBAGNO, GERALDINE",2,1,1
7722,5006490063,SI,499 VANDERBILT AVENUE,01,B3,"GALINDO, JOVITA",2,1,1
7723,5006750005,SI,72 NORTHERN BOULEVARD,01,A5,"BOSCO, LUKE",2,1,1
7724,5006940110,SI,350 SLOSSON AVENUE,05,O7,JG CASEY INC,4,3,1
7725,5007430008,SI,66 SHERADEN AVENUE,01,A5,"LUO, LI XIA",2,1,1
7726,5007440067,SI,83 MARTIN AVENUE,01,B2,"THOMAS, JINU",2,1,1
7727,5008490073,SI,121 HOLLY STREET,01,A2,DAVID BOCHICCHIO,2,1,1
7728,5008690613,SI,70 CHAPIN AVENUE,01,A3,"FIDA, SULEJMAN",2,1,1
7729,5010290021,SI,43 PALMER AVENUE,01,B2,"MORENO, JULIO",2,1,1
7730,5010650076,SI,102 SMITH PLACE,01,A1,"TAN, HUA JIN",2,1,1
7731,5010750018,SI,2184 RICHMOND TERRACE,01,B3,CHRISTINA CABALLERO,2,1,1
7732,5010850019,SI,90 HARRISON AVENUE,01,B2,"MARINO , ANTHONY",2,1,1
7733,5010960026,SI,1660 CASTLETON AVENUE,01,B2,MARCOS ALBER,2,1,1
7734,5011240047,SI,152 JOHN STREET,01,B2,NELSON PEREZ,2,1,1
7735,5012130060,SI,33 UNION AVENUE,01,A1,"IVELESSE, ALICEA",2,1,1
7736,5012370077,SI,12 LOCKMAN AVENUE,01,A1,"IYARE, NDIDI E",2,1,1
7737,5012370111,SI,78 LOCKMAN AVENUE,01,B3,"SERIEAUX-DEPEIZA, JOSEPHINE",2,1,1
7738,5012580028,SI,220 CONTINENTAL PLACE,01,A5,"LEWIS, TESSA",2,1,1
7739,5012700165,SI,2321 FOREST AVENUE,05,GW,2321 REALTY CORP,2,1,1
7740,5015010096,SI,3 HAWTHORNE AVENUE,01,A1,PETER E MARTINO,2,1,1
7741,5016050033,SI,4 ARLENE STREET,01,A2,"CHIAPPERINO, MATTHEW C",2,1,1
7742,5021720033,SI,3465 VICTORY BOULEVARD,09,P6,NANSEN PROP INC,6,5,1
7743,5026270018,SI,102 BURKE AVENUE,01,A1,"HYNDMAN, HAZEL",2,1,1
7744,5028500037,SI,3 ROSEBANK PLACE,01,A5,"WASHINGTON, ALISA",2,1,1
7745,5028540045,SI,147 MARYLAND AVENUE,01,A1,GABRIELLE ROZAN,2,1,1
7746,5028590121,SI,302 WINGHAM STREET,01,A5,"DEATS, CHRISTOPHER R",2,1,1
7747,5032060007,SI,96 LESLIE AVENUE,01,B1,JOHN GAMBINO,2,1,1
7748,5032530035,SI,219 OLYMPIA BOULEVARD,01,B2,"TITUANA, CARLOS",2,1,1
7749,5032840088,SI,242 SAND LANE,01,B2,"BORELLI, JOHN",2,1,1
7750,5033260041,SI,136 BATH AVENUE,01,A5,BERTO TERESA,2,1,1
7751,5033920031,SI,8 REID AVENUE,01,A5,"BENFANTE, VINCENZO",2,1,1
7752,5033950026,SI,47 NUGENT AVENUE,01,A5,ELIZABETH RIVERA,2,1,1
7753,5035520088,SI,869 NORTH RAILROAD AVE,01,B1,CHARLES SCALICI,2,1,1
7754,5035840043,SI,130 MIDLAND AVENUE,01,A1,RC CHUR ST CHRISTOPHE,2,1,1
7755,5036030037,SI,114 LINCOLN AVENUE,04,S9,"BAB 114, LLC",4,3,1
7756,5036880019,SI,284 HAMDEN AVENUE,01,A1,RICHARD HATTON,2,1,1
7757,5037350018,SI,180 MORELAND STREET,01,A2,"MORELAND REALTY, LLC",2,1,1
7758,5038210012,SI,320 MORELAND STREET,01,A5,320 MORELAND LLC,2,1,1
7759,5040370031,SI,136 MILL ROAD,01,A5,"JUNG  ENG, LARRY",2,1,1
7760,5042400042,SI,92 PRINCETON AVENUE,01,B2,THE DISCALA FAMILY IRREVOCABLE TRUST,2,1,1
7761,5044100001,SI,199 NATICK STREET,01,A3,ROBERT HIGGINS,2,1,1
7762,5044780448,SI,21A FULLER COURT,01,A5,GINGER JARAMILLO,2,1,1
7763,5046120084,SI,172 LEVERETT AVENUE,01,A5,"BRUNO, RICHARD",2,1,1
7764,5046680008,SI,455 MEDINA STREET,08,I7,UNITED CEREBRAL PALSY OF NYS INC,2,1,1
7765,5053630064,SI,1459 ARDEN AVENUE,01,A1,MARIO MARSILLO,2,1,1
7766,5056150067,SI,93 VAN BRUNT STREET,01,B2,"LORENZO, DANNY",2,1,1
7767,5056160024,SI,1097 ARDEN AVENUE,01,A5,AMUSO JOSEPHINE,2,1,1
7768,5062150004,SI,179 BARCLAY AVENUE,01,A1,"CATALDO, PATRICIA",2,1,1
7769,5062430029,SI,26 SHERIDAN PLACE,01,A1,"MORSELLINO, SALVATORE",2,1,1
7770,5064620037,SI,310 PHILIP AVENUE,01,B2,"REILLY, BRIAN",2,1,1
7771,5068340017,SI,772 IONIA AVENUE,01,A3,JULIO L MULKAY,2,1,1
7772,5075660153,SI,159 WEINER STREET,01,A1,THOMPSON-CHRISTINE,2,1,1
7773,5075840001,SI,249 RICHMOND VALLEY ROAD,05,K5,4850-52 ARTHUR KILL ROAD REALTY LLC,2,1,1
7774,5078510027,SI,362 BREHAUT AVENUE,01,A1,NORA BURGHER,2,1,1
7775,5078530122,SI,25 TRUMAN STREET,01,A1,"COOK, STEVEN",2,1,1
7776,5078540064,SI,332 BREHAUT AVENUE,01,A1,JEFFREY MATTHEWS,2,1,1
7777,5078620073,SI,587 YETMAN AVENUE,01,B2,GELLER GARY,2,1,1
7778,5078670115,SI,401 SLEIGHT AVENUE,01,A1,JOSEPH RICCA,2,1,1
7779,5080340070,SI,10 SIMON COURT,01,B2,"TREGLIA, ANNEMARIE",2,1,1
7780,5080430042,SI,225 WOOD AVENUE,01,B2,HAGAN JOHN M,2,1,1
7781,5080490061,SI,226 BUTLER AVENUE,01,A1,CHRISTOPHER CAROPOLO,2,1,1
7782,5080500004,SI,7631 AMBOY ROAD,01,A1,JEANNE GIORLANDO,2,1,1
7783,3061670032,BK,1362 70 STREET,01,B1,"HUANG, RAYMOND MING",2,1,1
7784,3061700045,BK,7012 17 AVENUE,01,B1,ANNIE LIU,2,1,1
7785,3061970035,BK,7210 BAY PARKWAY,01,B2,"BAO, CHI CHOI",2,1,1
7786,3062560001,BK,1301 79 STREET,05,O7,ANDREW TORREGROSSA REALTY,4,3,1
7787,3062970055,BK,1953 82 STREET,02,C0,SUET P CHAN AS TRUSTEE,2,1,1
7788,3063670071,BK,58 BAY 17 STREET,01,B3,"KO, MEI YUNG",2,1,1
7789,3064160063,BK,136 BAY 32 STREET,02,C2,G ZAPPULA,4,3,1
7790,3065100068,BK,957 EAST 7 STREET,01,A1,"COHEN, ADAM",2,1,1
7791,3065300045,BK,909 AVENUE K,01,A3,BMC 2002 DESCENDANTS TRUST,2,1,1
7792,3065360056,BK,1173 EAST 10 STREET,01,A9,BRODY FAMILY TRUST,2,1,1
7793,3065840010,BK,224 AVENUE N,01,B2,SEROR NISSIM,2,1,1
7794,3065880078,BK,1461 OCEAN PARKWAY,02,C0,EIDA FAMILY LLC,2,1,1
7795,3066100022,BK,1634 EAST 4 STREET,01,B1,1634 EAST 4TH STREET LLC,2,1,1
7796,3066110026,BK,1644 EAST 5 STREET,01,A9,"SHAMA, LEON I",2,1,1
7797,3066110085,BK,1611 EAST 4 STREET,01,A3,"SMOUHA, ALLEN",2,1,1
7798,3066600060,BK,1847 EAST 3 STREET,01,A5,"ZEITOUNI, DAVID M",2,1,1
7799,3066820024,BK,1904 EAST 7 STREET,01,A1,DAVID HADEF,2,1,1
7800,3066920039,BK,759 EAST 17 STREET,01,A1,GROSS ARTHUR,2,1,1
7801,3067410045,BK,1366 EAST 13 STREET,01,B2,SPIRA HIRSH,2,1,1
7802,3067630027,BK,1560 EAST 17 STREET,01,B2,"IZRAILOV, MIKHAIL",2,1,1
7803,3067640080,BK,1547 EAST 17 STREET,02,C0,AR3-19 TRUST,2,1,1
7804,3067720039,BK,1572 EAST 26 STREET,01,A1,"HERSKO, STEVEN",2,1,1
7805,3067980103,BK,1502 KINGS HIGHWAY,05,O5,CSG KINGS HIGHWAY REALTY LLC,2,1,1
7806,3069960035,BK,2719 WEST 16 STREET,02,C0,FNS & SONS LLC,2,1,1
7807,3070890077,BK,2001 EAST 7 STREET,08,W9,AHAVA VE AHABA YESHIVA KETANA INC,2,1,1
7808,3070940062,BK,2055 WEST 12 STREET,01,B2,"WU, WEI MING",2,1,1
7809,3071040203,BK,1971 EAST 1 STREET,01,A9,1971 EAST 1ST LLC.,2,1,1
7810,3071040522,BK,2053 EAST 1 STREET,01,A1,"SUTTON, HAROLD M",2,1,1
7811,3071050131,BK,1977 EAST 2 STREET,01,A3,"HAMAOUI, MARJORIE",2,1,1
7812,3071080131,BK,506 AVENUE S,01,A7,"CHEHEBAR, JOSEPH",2,1,1
7813,3071080143,BK,1916 OCEAN PARKWAY,01,B1,SOPHIA BILDIRICI,2,1,1
7814,3071450112,BK,2226 WEST 5 STREET,01,B3,CIANCI JOSEPH,3,2,1
7815,3071530044,BK,383 AVENUE W,01,B1,GUINDI MURAD,2,1,1
7816,3072030066,BK,2429 HUBBARD STREET,01,B1,KEBAEIL BARAKAT,2,1,1
7817,3072600089,BK,BANNER 3 ROAD,10,G0,KURTZ THOMAS,2,1,1
7818,3072920024,BK,1946 EAST 14 STREET,01,B3,"CHAAYA, DIB",2,1,1
7819,3072970068,BK,1951 EAST 18 STREET,01,A1,"ALCHKIFATI, MARKOU",2,1,1
7820,3075690008,BK,2301 AVENUE I,01,B2,"SINGER, BARRY",2,1,1
7821,3075850061,BK,1010 EAST 22 STREET,01,A1,"GREENWALD , TAMMY  Y",2,1,1
7822,3075900071,BK,960 EAST 27 STREET,01,B1,FRED E NUSSBAUM,2,1,1
7823,3075910025,BK,947 EAST 27 STREET,01,B1,HS CORTELYOU LLC,2,1,1
7824,3076400045,BK,2208 AVENUE L,01,B2,JAMSHID LALEHZARI,2,1,1
7825,3076510075,BK,1430 EAST 34 STREET,01,B2,"FRIED, SOLOMON",2,1,1
7826,3076780084,BK,3584 BEDFORD AVENUE,01,A1,"MENASHE, MARTIN",2,1,1
7827,3077030018,BK,1657 MARINE PARKWAY,01,A1,"BOORSTEIN, LIANA",2,1,1
7828,3078500020,BK,1529 EAST 52 STREET,01,A9,"GRIZZLE, CARL M",2,1,1
7829,3078710022,BK,1667 EAST 46 STREET,01,A9,PETER MCKENZIE,2,1,1
7830,3079270032,BK,807 EAST 51 STREET,01,A9,"FAJEMISIN, BRENDA A",2,1,1
7831,3081720017,BK,647 EAST 103 STREET,01,B2,"MAGANTI, AJAY",2,1,1
7832,3084702001,BK,11 BELL POINT DRIVE,01,A3,"WANG, YEMING",2,1,1
7833,3086627503,BK,35 BRIGHTON 2 PLACE,04,RM,UNAVAILABLE OWNER,2,1,1
7834,3087690046,BK,1523 EMMONS AVENUE,01,B1,MICHAEL HOFMAN,2,1,1
7835,3089390064,BK,60 EBONY COURT,01,A1,"KELLY , ROBERT",2,1,1
7836,4003830031,QN,30-03 39 AVENUE,02,C0,"FAROOQI, ABDUL R.",2,1,1
7837,4005150003,QN,30-14 14 STREET,02,C0,SINGH HEERALALL,2,1,1
7838,4005510019,QN,30-75 21 STREET,07,G4,KELLARAKOS REALTY CORP,2,1,1
7839,4005740022,QN,27-44 27 STREET,02,C0,MADDEN KEVIN,2,1,1
7840,4005990028,QN,36-05 30 STREET,08,M9,MASJID ELBER OF ASTORIA,2,1,1
7841,4006000111,QN,36-43 31 STREET,01,B9,"36-45 31ST STREET, LLC",2,1,1
7842,4006490069,QN,31-66 37 STREET,03,D1,37TH STREET REALTY LLC,2,1,1
7843,4006540084,QN,25-48 STEINWAY STREET,04,S2,"VOURDERIS, AS TRUSTEE, ADRIANE IRENE",2,1,1
7844,4006910039,QN,43-10 BROADWAY,04,S2,4308/10 BROADWAY LLC,2,1,1
7845,4007240024,QN,46-16 NEWTOWN ROAD,02,C2,NP DEVELOPMENT LLC,2,1,1
7846,4007830107,QN,42-18 DITMARS BOULEVARD,04,S1,"LIANDRIS, EFSTATHIOS",2,1,1
7847,4007860060,QN,43-11 21 AVENUE,01,B2,"BABBITT, MARIA",2,1,1
7848,4009460054,QN,19-83 77 STREET,02,C0,"KOKOSIS, PANAGIOTIS",2,1,1
7849,4010700001,QN,93-04 DITMARS BOULEVARD,01,B3,NANCY CUESTA,2,1,1
7850,4012140033,QN,37-33 59 STREET,02,C0,NUR NAZMUN,2,1,1
7851,4013550050,QN,72-25 45 AVENUE,01,A5,SCIATIC CORP,2,1,1
7852,4013670054,QN,26-16 94 STREET,01,A1,ALEX JONES JR,2,1,1
7853,4013670065,QN,26-40 94 STREET,01,A1,TONY D DIAZ,2,1,1
7854,4015480041,QN,51-17 VAN LOON STREET,01,A1,51-17 LOFT INC,2,1,1
7855,4015650043,QN,93-09 LAMONT AVENUE,01,B2,SPLENDID REALTY LLC,4,3,1
7856,4016230014,QN,45-16 97 STREET,01,B2,"VARGAS, JOHNNY J",2,1,1
7857,4016290070,QN,101-28 NICOLLS AVENUE,01,B1,S VASSILES,2,1,1
7858,4016630018,QN,27-24 CURTIS STREET,01,B2,KAISHENG REALTY THREE LLC,2,1,1
7859,4017180010,QN,103-16 NORTHERN BOULEVARD,04,K4,103 QUEENS REALTY LLC,3,2,1
7860,4017530084,QN,35-35 109 STREET,01,B2,"MAYANCELA, JOSE A",2,1,1
7861,4017550014,QN,34-12 112 STREET,02,C5,BEATRICE DUARTE,2,1,1
7862,4017690090,QN,37-31 103 STREET,04,S4,"JLB CORONA REAL PROPERTIES, LLC",2,1,1
7863,4018330215,QN,127-92 WILLETS POINT BLVD,06,E9,FODERA ENTERPRISES,4,3,1
7864,4018350234,QN,50-04 88 STREET,01,A1,VICENCIO EDGARDO,2,1,1
7865,4018960021,QN,53-15 96 STREET,01,B3,CHAI KEUNG YAU A/K/A,2,1,1
7866,4019050011,QN,55-29 97 STREET,01,B2,M LIQUORI,2,1,1
7867,4019330030,QN,50-38 103 STREET,01,B3,"YANG, WENGUANG",2,1,1
7868,4019760005,QN,41-15 103 STREET,04,K4,41-15 NATIONAL LLC,2,1,1
7869,4019990008,QN,108-30 43 AVENUE,01,B3,"SALAZAR , EDDY  S",2,1,1
7870,4021100049,QN,99-31 63 ROAD,01,B3,"ILYABAYEV, BORIS",2,1,1
7871,4023200012,QN,47-25 59 STREET,03,D3,"8 CHUANGS, LLC",2,1,1
7872,4023890032,QN,48-18 66 STREET,02,C0,"LIN, JIAN LONG",2,1,1
7873,4024850052,QN,73-21 52 AVENUE,01,A5,MCCULLAGH LOUIS,2,1,1
7874,4025750280,QN,49-01 MASPETH AVENUE,06,E1,"WAYNE O, LLC",2,1,1
7875,4026420021,QN,61-10 56 STREET,01,B2,FIRST CHURCH OF CHRIST,2,1,1
7876,4026520017,QN,59-59 59 PLACE,01,B2,JOSEPH P ZAKRZEWSKI,2,1,1
7877,4026800056,QN,58-91 GRAND AVENUE,01,B2,"FELLE, JOSEPH F",2,1,1
7878,4027110020,QN,61-31 MASPETH AVENUE,01,B2,BETH JACOBSON LISA,2,1,1
7879,4027110029,QN,61-11 MASPETH AVENUE,01,B2,"CUNNEELY, STEVEN",4,3,1
7880,4027510057,QN,57-52 65 STREET,01,A5,"PALLOTO,  VINCENTE B JR.",2,1,1
7881,4027530304,QN,64-35 59 AVENUE,01,A2,JOHN T GILKES,2,1,1
7882,4027620031,QN,62-50 60 DRIVE,01,B3,"GIBBONS, GEORGE THOMAS",2,1,1
7883,4033250044,QN,82-21 ABINGDON ROAD,01,A3,"DAVIDOFF, SAMUEL",2,1,1
7884,4033310040,QN,258 BREVOORT STREET,01,A3,"OSTAYEV, SHEMTOV",2,1,1
7885,4033880026,QN,1926 HARMAN STREET,01,B2,"LAMIA, NEE DI GANGI, MARIA",2,1,1
7886,4035790027,QN,1812 DECATUR STREET,01,A2,A KRANZ,2,1,1
7887,4035980040,QN,74-08 64 LANE,10,G0,ANDREW H BOGATS,2,1,1
7888,4036760021,QN,65-19 MYRTLE AVENUE,04,S9,"ROMO,",2,1,1
7889,4038150022,QN,77-22 79 STREET,01,B3,TRACY PATRICIA,2,1,1
7890,4038600011,QN,88-22 79 AVENUE,01,B2,"LAMALFA, ROSEMARIA",3,2,1
7891,4038820047,QN,90-30 82 ROAD,01,B1,"LULO, EUGENE",2,1,1
7892,4040460005,QN,111-16 14 AVENUE,01,B2,"BIAO DONG, YONG",2,1,1
7893,4042340044,QN,23-18 130 STREET,02,C0,"CHEN, XIU YU",2,1,1
7894,4044140099,QN,140-03 32 AVENUE,11,V0,Z AND H II REAL ESTATE LLC,2,1,1
7895,4044580025,QN,145-56 9 AVENUE,01,A1,LUCIO LOMBARDOZZI,2,1,1
7896,4044860055,QN,12-39 148 STREET,02,C0,"TORRES, COLLEEN",3,2,1
7897,4045070003,QN,3-19 150 STREET,01,B3,"STAKIAS, JOHN",2,1,1
7898,4045450005,QN,154-59 10 AVENUE,01,A0,SMILOVE RICHARD,2,1,1
7899,4045970069,QN,14-84 164 STREET,01,A1,SIMON DANIEL P,2,1,1
7900,4046110029,QN,167-17 CRYDERS LANE,01,A1,"CAVALIERE, LUCIO",2,1,1
7901,4046260054,QN,15-17 146 PLACE,01,A1,TASOS YEROLEMOU,2,1,1
7902,4046350008,QN,22-21 PARSONS BOULEVARD,01,A1,PEZZINO VINCENZO -,2,1,1
7903,4046500034,QN,147-26 17 AVENUE,01,A1,"NG, LILY SAU SIM",2,1,1
7904,4047030020,QN,151-25 17 ROAD,01,B2,NICHOLAS A ROMANO,2,1,1
7905,4049900015,QN,33-11 149 PLACE,01,A2,"LIN, RONG",2,1,1
7906,4050590009,QN,41-53 150 STREET,02,C0,"YANG, YAN FEN",2,1,1
7907,4051480024,QN,137-48 HOLLY AVENUE,01,A5,"LIU, DAI JIN",2,1,1
7908,4051490026,QN,137-58 JUNIPER AVENUE,01,B3,"WANG, YONG",2,1,1
7909,4052960020,QN,36-34 170 STREET,02,C0,JIE ZHENG AS TRUSTEE,2,1,1
7910,4053280026,QN,154-22 BARCLAY AVENUE,01,A1,"YE, GESI",2,1,1
7911,4054100038,QN,43-56 MURRAY STREET,01,A1,HONG TEH TEMPLE CORPORATION,2,1,1
7912,4054600042,QN,46-18 162 STREET,02,C0,"WONG, JAYNE SHERNA",2,1,1
7913,4060760015,QN,33-20 201 STREET,01,A5,D'ANGELO MARIANO,2,1,1
7914,4060830025,QN,203-19 34 AVENUE,01,A5,"DISIMONE, ROBERT",2,1,1
7915,4060920025,QN,207-19 34 AVENUE,01,A1,"YANG, WENLI",2,1,1
7916,4061120061,QN,34-27 213 STREET,01,B3,"MESKOURIS, MARIA A",2,1,1
7917,4061770028,QN,214-19 38 AVENUE,01,B1,"CARRILLO, EUNICE",2,1,1
7918,4062250054,QN,39-17 210 STREET,01,B2,KONG HAO WANG,2,1,1
7919,4067420002,QN,154-26 65 AVENUE,01,B3,"DIAZ, LISANIAZ",2,1,1
7920,4067460057,QN,61-40 156 STREET,01,A1,"LIN, AI MIN",2,1,1
7921,4067590015,QN,61-33 162 STREET,01,B1,HUNG YUEN WONG,2,1,1
7922,4068010053,QN,71-20 163 STREET,02,C0,"CHAN, TONY",2,1,1
7923,4068220020,QN,73-15 PARSONS BOULEVARD,07,G4,HERON REAL ESTATE CORP,2,1,1
7924,4072490066,QN,182-15 80 DRIVE,01,A2,"LOPEZ, VINCENT",2,1,1
7925,4072640037,QN,84-16 188 STREET,01,A2,"GOLD, JEFFREY",2,1,1
7926,4076330001,QN,213-09 73 AVENUE,02,C6,HOLLISCO OWNERS CORP,104,103,1
7927,4080680041,QN,301 38 ROAD,01,A2,"HAINLINE , BRIAN",2,1,1
7928,4081190060,QN,42-23 247 STREET,01,A5,"YSJIN HOLDING, LLC",2,1,1
7929,4082430315,QN,251-35 52 AVENUE,01,A3,"LIN, PENG",2,1,1
7930,4082480011,QN,49-23 BROWVALE LANE,01,A1,"CHIEN, KATY YU-I",2,1,1
7931,4082500075,QN,252-49 BRATTLE AVENUE,01,A1,"LEE, REGINA YUNG",2,1,1
7932,4083510025,QN,58-21 255 STREET,01,B2,"LEUNG, YUI C",3,2,1
7933,4089850032,QN,93-06 92 STREET,01,B2,"HUANG, EDDIE LIN",2,1,1
7934,4090150029,QN,94-17 84 STREET,08,N2,ST. ELIZABETH ROMAN CATHOLIC CHURCHOF WO ODHAVEN,2,1,1
7935,4090220014,QN,95-16 87 STREET,02,C0,95-16 87TH ST FAMILY LIMITED PARTNERSHIP,2,1,1
7936,4090640043,QN,97-39 90 STREET,01,B1,"LI, XIN JU",2,1,1
7937,4090790004,QN,101-08 80 STREET,01,B2,"AHMAD, ZEMIL",2,1,1
7938,4090870034,QN,86-19 102 AVENUE,02,C0,RAJHODAI PUNSAMMY,2,1,1
7939,4092920020,QN,90-20 102 STREET,02,C0,NEZAM BANGARI,2,1,1
7940,4093750168,QN,135-14A 91 AVENUE,10,G0,"GONZALEZ, TELMA M",2,1,1
7941,4094870032,QN,101-58 120 STREET,01,A1,"KAUR, SINDER",2,1,1
7942,4095080010,QN,104-20 103 AVENUE,01,A1,ANN SHIVNATH,2,1,1
7943,4095450050,QN,107-55 107 STREET,01,A1,"SEWS   R, SHANTA",3,2,1
7944,4095580045,QN,103-41 120 STREET,11,V1,120 RICHMOND HILL LLC,2,1,1
7945,4095810045,QN,104-88 128 STREET,01,B3,"MULTANI, LAKHWINDER",2,1,1
7946,4095950060,QN,105-37 135 STREET,01,B3,"ELIE, JR, JEAN C",2,1,1
7947,4096150022,QN,107-32 VAN WYCK EXPRESSWAY,01,B2,"SINGH, LAKHWINDER",2,1,1
7948,4096830036,QN,139-01 89 AVENUE,04,S9,"BATISTA, RAFAEL",2,1,1
7949,4096860033,QN,88-26 145 STREET,01,B2,JUGDAT AYRAWATEE,2,1,1
7950,4097240142,QN,86-07 144 STREET,01,B3,"RAHMAN, MOFIZUR",2,1,1
7951,4097760014,QN,159-22 NORMAL ROAD,02,C0,BACHEU  MAHARANEE,2,1,1
7952,4098630135,QN,84-37 170 STREET,01,A1,"SCARLATO, THERESA",2,1,1
7953,4099010036,QN,90-16 182 PLACE,01,A9,ROBLES EVANGELINE,2,1,1
7954,4100570027,QN,106-17 WALTHAM STREET,04,S5,TOV 106 LLC,3,2,1
7955,4100730010,QN,107-36 PINEGROVE STREET,01,B3,"KNIGHT, MIRIAM",2,1,1
7956,4101390051,QN,107-43 160 STREET,01,B3,"CHARRAN, DONNA",2,1,1
7957,4101720023,QN,164-02 108 AVENUE,01,B2,"NEWPORT, CLIFFORD",2,1,1
7958,4103110040,QN,179-07 114 ROAD,01,A1,"DANIELS, CARL",3,2,1
7959,4104080031,QN,185-11 MURDOCK AVENUE,01,A1,"TAYLOR, JAMES B",2,1,1
7960,4105010015,QN,87-14 SANTIAGO STREET,01,A1,"HURWITZ, SUZANNE",2,1,1
7961,4105290009,QN,86-14 FRANCIS LEWIS BLVD,01,A2,LOUIS SMITH,2,1,1
7962,4105660022,QN,91-46 HOLLIS COURT BLVD,01,A1,"DIHAL, VIDOUR",2,1,1
7963,4106430001,QN,91-07 217 STREET,01,A1,"ALGU, DEOCHAN",2,1,1
7964,4106550070,QN,89-52 214 STREET,01,A1,"MURRAY, LEVAUGHN",2,1,1
7965,4107450016,QN,222-20 FAIRBURY AVENUE,01,B1,"SINGH, RAJINDER",2,1,1
7966,4108340001,QN,94-31 204 STREET,06,E7,"SAFEGUARD HOLLIS, LLC",2,1,1
7967,4109140025,QN,104-38 208 STREET,01,A1,"SEEPERSAUD, GURNAUTH",2,1,1
7968,4110290141,QN,114-02 211 STREET,04,K4,114-02 211TH STREET INC,3,2,1
7969,4110730111,QN,116-39 201 STREET,01,B3,"CROOKS, SHEENA N",2,1,1
7970,4111010001,QN,106-31 215 STREET,01,A0,"EDWARDS, TERESA",2,1,1
7971,4111270044,QN,111-50 WITTHOFF STREET,01,A1,NYC HOUSING AUTHORITY,2,1,1
7972,4111630047,QN,104-02 219 STREET,01,A5,"PHILLIPS, JERMAINE",2,1,1
7973,4114570007,QN,77-06 155 AVENUE,01,A1,"RUZZAQ, SHARDA",2,1,1
7974,4116770022,QN,115-38 135 STREET,01,A1,"NOWRANG, NARESH",3,2,1
7975,4116990003,QN,135-06 FOCH BOULEVARD,01,B3,"SINGH, LAKHWINDER",2,1,1
7976,4117540052,QN,130-06 ROCKAWAY BOULEVARD,08,W2,"CENTRAL ISALMIC ORGANIZATION OF NY, INC",2,1,1
7977,4119270022,QN,109-23 141 STREET,01,B2,LUZ M PALENCIA,3,2,1
7978,4119450140,QN,147-15 108 AVENUE,01,B1,MCRAE DAVE S,2,1,1
7979,4119630041,QN,111-66 LIVERPOOL STREET,01,B3,K PENN,2,1,1
7980,4119730016,QN,143-01 115 AVENUE,01,B3,"BRADSHER,   CELESTE  F.",2,1,1
7981,4119780026,QN,114-42 148 STREET,01,A1,EMILY R BANKS,2,1,1
7982,4120260104,QN,119-15 INWOOD STREET,01,A1,"JONES, GUS JR",2,1,1
7983,4120570032,QN,127-15 140 STREET,01,B2,BRIAN SAMUEL,2,1,1
7984,4121120042,QN,130-08 150 STREET,01,B3,"MANIRAM, KUBEER N",2,1,1
7985,4121120044,QN,130-12 150 STREET,01,A1,"SINGH, HARDAT R",2,1,1
7986,4121690089,QN,150-49 LINDEN BOULEVARD,01,B3,ALTHEA HERON,4,3,1
7987,4121750009,QN,111-75 157 STREET,04,S3,SIMKA DEVELOPMENT CORP,3,2,1
7988,4121780139,QN,112-36 DILLON STREET,01,B2,"KISSOON, BISHRUNAUTH",2,1,1
7989,4122030198,QN,150-32 116 DRIVE,01,B3,EUNICE L BOYD,2,1,1
7990,4122430025,QN,119-10 LONG STREET,01,B3,GEORGE I WASHINGTON JR,2,1,1
7991,4123720242,QN,172-05 119 AVENUE,01,A2,"FARMER, FELICIA",2,1,1
7992,4123880164,QN,120-55 171 STREET,01,B3,"DAVY, COLLIN E",2,1,1
7993,4125370093,QN,130-25 176 PLACE,01,A1,"WATERS, QUINTON",2,1,1
7994,4125880001,QN,170-19 143 ROAD,01,B2,"SAMAROO, FAROUK",2,1,1
7995,4126080018,QN,118-24 193 STREET,01,A1,"SINGLETON, DENNIS",2,1,1
7996,4126160031,QN,195-09 119 AVENUE,01,A1,"PEREZ, DAMARIS",2,1,1
7997,4128250510,QN,221-03 130 AVENUE,01,A2,"FORBES, MELVERN",2,1,1
7998,4128650011,QN,121-24 LAURELTON PARKWAY,01,A2,"COOK, BONNIE  M",2,1,1
7999,4129490022,QN,131 AVENUE,10,G0,EKIM CRIBS LLC,2,1,1
8000,4130410013,QN,183-26 140 AVENUE,01,B1,"BLAKE, SHEA D",2,1,1
8001,4130940055,QN,185-10 144 AVENUE,01,B2,"FARRELL, SHIRLEY",2,1,1
8002,4133420038,QN,145-93 178 PLACE,01,A1,"GAVIN, JONATHAN",2,1,1
8003,4134830031,QN,145-12 227 STREET,01,B2,"DUNCAN, ANNA",2,1,1
8004,4135410052,QN,146-02 HUXLEY STREET,01,B3,"BARNES, CARL T",2,1,1
8005,4135440024,QN,241-08 NEWHALL AVENUE,02,C0,"VAUGHN, ELAINE",3,2,1
8006,4141420033,QN,155-50 100 STREET,01,A1,"STROBLE, STEVEN C",2,1,1
8007,4141980043,QN,162-33 96 STREET,01,B3,"GARCIA, RICARDO",2,1,1
8008,4150130038,QN,144-18 159 STREET,01,A1,"YAP, CHARMAINE",2,1,1
8009,4153170071,QN,47 WEST 13 ROAD,01,A1,"PORCELLA, THOMAS A JR.",2,1,1
8010,4156510019,QN,14-24 PINSON STREET,01,B3,FIRST CHURCH OF GODINC,2,1,1
8011,4157210025,QN,12-31 BAY 27 STREET,01,B3,"PAHLADSINGH, GAITRIE",4,3,1
8012,4157310022,QN,10-87 DICKENS STREET,08,M1,BAYSWATER JEWISH CENT,5,4,1
8013,4157740098,QN,24-18 DEERFIELD ROAD,02,C3,NERUKA TITUS,2,1,1
8014,4161690122,QN,160 BEACH 97 STREET,02,C0,UNAVAILABLE OWNER,2,1,1
8015,4162430006,QN,131-09 BEACH CHANNEL DRIVE,01,B2,"13109 BCD, LLC",2,1,1
8016,4163030044,QN,314 BEACH 147 STREET,01,A2,"MCLEOD, BRIAN",2,1,1
8017,5001020092,SI,394 HENDERSON AVENUE,11,V0,"RAVISANKAR, R.",2,1,1
8018,5001120003,SI,148 BRIGHTON AVENUE,01,A1,"RIVERS, BERNARD",2,1,1
8019,5001250054,SI,441 CASTLETON AVENUE,05,K2,RJSAV  REALTY  LLC,2,1,1
8020,5001300028,SI,786 BRIGHTON AVENUE,02,C3,BRIGHTON PROPERTIES I,2,1,1
8021,5001500089,SI,184 HARRISON PLACE,01,A1,ALEATHA MONE,2,1,1
8022,5001510052,SI,332 DAVIS AVENUE,01,B2,"SHI, LI JUN",2,1,1
8023,5001650015,SI,359 NORTH BURGHER AVENUE,01,A1,"NOTARO, RALPH",2,1,1
8024,5001850516,SI,1939 RICHMOND TERRACE,,Z9,AVLM REALTY LLC,3,2,1
8025,5001870052,SI,1610 RICHMOND TERRACE,06,E2,RCCD HOLDINGS LLC,2,1,1
8026,5002010021,SI,157 CLOVE ROAD,01,A1,"COOPER-JONES, DEE",2,1,1
8027,5002100037,SI,1168 CASTLETON AVENUE,05,O1,30 ROCK REALTY LLC,2,1,1
8028,5002380064,SI,315 JEWETT AVENUE,01,A1,"VARGAS, SERGIO",2,1,1
8029,5002760059,SI,14 LAWRENCE AVENUE,02,C3,ALBERT R LEISENGANG,4,3,1
8030,5003180094,SI,45 ALPINE COURT,01,A1,"SPENCER, CATHERINE",2,1,1
8031,5003290007,SI,51 SANFORD PLACE,01,A1,"HERMAN, KENT C",2,1,1
8032,5003380024,SI,237 POTTER AVENUE,01,A1,"GUERRA, STEPHEN",2,1,1
8033,5003460053,SI,270 POTTER AVENUE,01,A1,"CAMP, GREGORY",2,1,1
8034,5003480036,SI,8 HODGES PLACE,01,B1,PAUL F HANSALIK,2,1,1
8035,5003680054,SI,27 SAWYER AVENUE,01,A1,TERRENCE CRAVEN,2,1,1
8036,5005070035,SI,16 CLINTON STREET,01,A9,EVA SANDSTROM,2,1,1
8037,5005150098,SI,58 WILLIAM STREET,01,B2,"LI, KAI",2,1,1
8038,5005770031,SI,16 ROSEWOOD PLACE,01,B2,"GEORGE LINDSEY, TRUSTEE",2,1,1
8039,5005870024,SI,37 HOWARD AVENUE,01,A3,ARTHUR SHIKHMAN,3,2,1
8040,5006060074,SI,155 VAN CORTLANDT AVENUE,01,B3,"HERNANDEZ, BERNARD",2,1,1
8041,5007760122,SI,1165 WILLOWBROOK ROAD,01,A1,"KUSAYEV, ILIYAVUSAVY",2,1,1
8042,5008490251,SI,97 HOLLY STREET,01,A1,SASHIKALA KRISHNAN,2,1,1
8043,5008540034,SI,11 DUTCHESS AVENUE,01,B2,ANN PALAZZOLA,3,2,1
8044,5008980043,SI,411 FLAGG PLACE,01,A3,GABRIEL H GARCIA,2,1,1
8045,5010440009,SI,495 HEBERTON AVENUE,01,A1,"PEREZ, ANNALYNN",2,1,1
8046,5010570017,SI,47 TABB PLACE,01,A1,"WILMINGTON SAVINGS FUND SOCIETY, FSB, D/ B/A CHRIST",2,1,1
8047,5010940029,SI,100 CLINTON PLACE,01,B2,"KORKIDAS, ANDREAS",2,1,1
8048,5011050001,SI,2319 RICHMOND TERRACE,07,G9,2319 RICHMOND TERRACE CORP,2,1,1
8049,5011200037,SI,220 NICHOLAS AVENUE,01,A1,"MILLER, ERICK",2,1,1
8050,5012210013,SI,22 CONFEDERATION PLACE,01,A5,EDUARDO DE LA CRUZ,2,1,1
8051,5015010086,SI,17 HAWTHORNE AVENUE,01,A1,KRISTEN MCNALLY,2,1,1
8052,5016910041,SI,2108 FOREST AVENUE,04,S2,BARTLAY FORTE,2,1,1
8053,5022300052,SI,112 SOMMER AVENUE,01,A5,CLARA MINEO 2019 FAMILY TRUST,2,1,1
8054,5027050100,SI,480 WILD AVENUE,04,S0,G & S ASSOCIATES OF STATEN  ISLAND LLC,2,1,1
8055,5027710035,SI,11 WILD AVENUE,01,A1,"ZAKRZEWSKI, JOSEPH P",2,1,1
8056,5028450035,SI,1080 BAY STREET,01,A1,OMAR O REYES,2,1,1
8057,5028560058,SI,261A MARYLAND AVENUE,01,B2,OLYMPIA ENTERPRISE GRUOP LLC,2,1,1
8058,5028880036,SI,311 BRITTON AVENUE,01,A5,"WU, RISHENG",3,2,1
8059,5029670031,SI,223 ST MARYS AVENUE,02,C0,DONC PROPERTY MANAGEMENT LLC,3,2,1
8060,5029720017,SI,193 VIRGINIA AVENUE,01,A1,VILLA  JOHN A,2,1,1
8061,5031660065,SI,72 GRASMERE AVENUE,01,A5,JOSEPH MIRANDA,2,1,1
8062,5031760022,SI,101 NORTH RAILROAD AVE,01,A1,"BROITMAN, DMITRI",2,1,1
8063,5033440019,SI,290 GARRETSON AVENUE,01,B2,DENNIS SEMENZA,2,1,1
8064,5036120045,SI,210 BANCROFT AVENUE,01,B3,"MUSLEH, EKRAM",2,1,1
8065,5038070028,SI,733 PATTERSON AVENUE,02,C0,DIDEA CHARLES,3,2,1
8066,5038160006,SI,619 LINCOLN AVENUE,01,A5,"OBERSON, JAMES",2,1,1
8067,5042170007,SI,105 9 STREET,01,A1,MARY R. MAHONEY,2,1,1
8068,5044370041,SI,3660 RICHMOND ROAD,01,A3,ANTHONY E MARTINCICH,2,1,1
8069,5044680066,SI,332 CLARKE AVENUE,01,A2,JOHN MERCIECA,2,1,1
8070,5049640024,SI,22 BUFFALO STREET,02,C0,RUSSO LUIGI,2,1,1
8071,5051560039,SI,23 NASH COURT,01,A5,LISA CARRANO,2,1,1
8072,5052230098,SI,6 SHERWOOD PLACE,01,A1,MICHAEL & CYNTHIA KAMBOS,2,1,1
8073,5053650032,SI,24 HALES AVENUE,01,A2,"VARVARA, JOSEPH",2,1,1
8074,5054940026,SI,453 RIDGEWOOD AVENUE,01,A5,"JOSEPH D. PISCOPIA, TRUSTEE",2,1,1
8075,5055130158,SI,94 RIDGEWOOD AVENUE,01,A1,WALLACE CATHRYN,2,1,1
8076,5055900038,SI,64 SYLVIA STREET,01,B2,"BOVO, JUDY",2,1,1
8077,5067510281,SI,73 MANEE AVENUE,01,B2,"SCHRAIDT, MARIA",2,1,1
8078,5067930063,SI,19 STEVENSON PLACE,01,A2,"SQUATRITO, PHILIP J",2,1,1
8079,5069930142,SI,6193 AMBOY ROAD,01,B2,"LIU-MEI, YU HUA",2,1,1
8080,5070400240,SI,14 NORTH EDO COURT,01,B2,"OCONNOR-LYONS, LISA  A",2,1,1
8081,5070710006,SI,2542 ARTHUR KILL ROAD,08,P9,GEORGE K WONICA,3,2,1
8082,5072670033,SI,65 SHARROTTS ROAD,01,B2,WILLIAM J HIGGINS,2,1,1
8083,5078120052,SI,131 JOLINE AVENUE,01,B3,MICHAEL DIMINO,2,1,1
8084,5078530074,SI,7194 AMBOY ROAD,01,B2,"LAMARCH, MARIA",2,1,1
8085,5078540071,SI,346 BREHAUT AVENUE,01,A1,DOLORES PARONICH,2,1,1
8086,5078580032,SI,713 ROCKAWAY STREET,01,A3,"BRANDON PROPERTY GROUP, INC.",2,1,1
8087,5078590050,SI,667 YETMAN AVENUE,01,A1,RENELLE MARIA,2,1,1
8088,5078650078,SI,503 YETMAN AVENUE,01,A1,LOUIS M TREDIA,2,1,1
8089,5078670024,SI,92 SPRAGUE AVENUE,01,A1,"RHOM, FLORENCE",2,1,1
8090,5078670198,SI,25 PARADISE PLACE,01,A3,"DAVIS, KIM",2,1,1
8091,5080210089,SI,152 BARNARD AVENUE,01,B3,"GREENFIELD, FRANCES",2,1,1
8092,1002820058,MN,2 PIKE STREET,05,O6,TWO PIKE LLC,2,1,1
8093,1003060001,MN,119 HESTER STREET,04,C7,"DK HESTER STREET, LLC",2,1,1
8094,1004170070,MN,82 STANTON STREET,04,K4,DC REALTY CORP,3,2,1
8095,1005430066,MN,131 WEST 3 STREET,04,K4,131 WEST 3RD STREET INC.,2,1,1
8096,1005920005,MN,128 WEST WASHINGTON PLCE,01,B9,GINSBERG REVOCABLE TRUST,2,1,1
8097,1006170045,MN,220 WEST 13 STREET,04,D7,220 W 13 STREET LLC,2,1,1
8098,1006200082,MN,211 WEST 10 STREET,02,C6,W 10 ST HLDG,2,1,1
8099,1009420001,MN,2 AVENUE,11,V1,MTA - BRIDGES AND TUNNELS,3,2,1
8100,1011690042,MN,226 WEST 78 STREET,03,D1,226 WEST 78TH STREET,2,1,1
8101,1012070015,MN,37 WEST 93 STREET,03,D4,3793 OWNERS CORP.,2,1,1
8102,1019870024,MN,519 WEST 133 STREET,03,D2,HRP-133/134 HOUSINGDEVELOPMENT FUND CORP .,2,1,1
8103,1020390055,MN,254 WEST 154 STREET,03,D4,MACOMBS MANOR HOUSING DEVELOPMENT UND CO RPORATION,2,1,1
8104,2023570035,BX,610 EXTERIOR STREET,05,K6,BTM DEVELOPMENT PARTNERS LLC,3,2,1
8105,2023700030,BX,3369 3 AVENUE,08,M1,ZION APOSTOLIC CHURCH,2,1,1
8106,2023880054,BX,1119 WASHINGTON AVENUE,02,C3,NYC HOUSING PRESERVATION AND DEVELOPMENT,3,2,1
8107,2025780015,BX,441 CONCORD AVENUE,07,G2,"CONCORD AVENUE REALTY, LLC",2,1,1
8108,2026140004,BX,1176 FRANKLIN AVENUE,08,W2,CHURCH OF ST AUGUSTI,2,1,1
8109,2026930060,BX,1147 REV JAMES POLITE AVE,01,B2,"MORRISON, ROBERT V JR",2,1,1
8110,2027660523,BX,1333 RANDALL AVENUE,10,G7,SILVER STAR MANAGEMENT CORP.,2,1,1
8111,2028620003,BX,43 WEST 177 STREET,02,C0,NATIONS HOLDING CORP,2,1,1
8112,2029580036,BX,1818 MOHEGAN AVENUE,01,B2,"DE JESUS , DANIEL",2,1,1
8113,2030600002,BX,4216 3 AVENUE,04,C7,JHR PROPERTY LLC,2,1,1
8114,2030650031,BX,2376 HOFFMAN STREET,02,C1,BX HOFFMAN LLC,2,1,1
8115,2032020038,BX,2647 JEROME AVENUE,05,K1,KAMBIA REAL ESTATE CORP,3,2,1
8116,2032040009,BX,2516 GRAND AVENUE,03,D1,GEEL GRAND AVENUE HDFC,2,1,1
8117,2032900002,BX,309 EAST 197 STREET,01,A1,309 E197TH ST LLC,2,1,1
8118,2034990010,BX,412 SOUNDVIEW AVENUE,04,S9,DC 408 SOUNDVIEW LLC,6,5,1
8119,2037520051,BX,1159A ST LAWRENCE AVENUE,01,B2,"MOUMOUNI, NURU",2,1,1
8120,2037610019,BX,1230 ROSEDALE AVENUE,02,C2,1230 ROSEDALE ASSOCIATES LLC,2,1,1
8121,2037750025,BX,1250 WARD AVENUE,08,W1,NYC DEPARTMENT OF EDUCATION,4,3,1
8122,2038070013,BX,2110 BLACKROCK AVENUE,01,B2,"BROWN, DANIEL O",2,1,1
8123,2038950087,BX,1719 CROSS BRONX EXPWY,07,G4,ALLIANCE ENERGY LLC,2,1,1
8124,2039760028,BX,1479 ST PETERS AVENUE,01,B2,BAITUL MAAMUR JAME MASHJID INC,2,1,1
8125,2039780039,BX,2473 FRISBY AVENUE,01,B3,"CORPAS, DENNIS",2,1,1
8126,2040190046,BX,1732 VAN BUREN STREET,02,C0,V.B. CARPI LLC,2,1,1
8127,2040670025,BX,1535 HONE AVENUE,01,B3,SYLVIA ALEXANDER,2,1,1
8128,2040700111,BX,2553 POPLAR STREET,01,A1,"KIANI, WAHEED",2,1,1
8129,2040810021,BX,1634 EASTCHESTER ROAD,04,C7,EASTCHESTER PINE PROP,2,1,1
8130,2041580044,BX,1635 EDISON AVENUE,01,A1,"MARTINO, DIANE",2,1,1
8131,2042310045,BX,1947 MAYFLOWER AVENUE,01,A5,MANCINI CHARLES,2,1,1
8132,2043480035,BX,2353 WALLACE AVENUE,01,A5,GARNER  GWENDOLYN,2,1,1
8133,2044520031,BX,2564 LURTING AVENUE,01,A1,"HUSSAIN, NADEEM",2,1,1
8134,2044760079,BX,2511 FENTON AVENUE,01,A2,"LUKE, NEIL G",2,1,1
8135,2044920058,BX,2523 LODOVICK AVENUE,01,B2,"OHENEWAA, BERNICE",2,1,1
8136,2045230038,BX,2751 TENBROECK AVENUE,02,C0,"BROWNE, CALICE",2,1,1
8137,2047250031,BX,1468 NEEDHAM AVENUE,01,B2,"BEASON, PAULINE",2,1,1
8138,2047290047,BX,3431 GUNTHER AVENUE,01,B2,REYNOLDS CHRISTIAN,2,1,1
8139,2047890015,BX,2937 WICKHAM AVENUE,01,B1,"GRANT-REID, GENE",2,1,1
8140,2048270029,BX,641 EAST 225 STREET,03,D1,FILOMENA GARDENS HDFC,2,1,1
8141,2048430061,BX,732 EAST 230 STREET,01,B2,JAGOPAT RAGNATH,3,2,1
8142,2048660061,BX,924 EAST 231 STREET,01,B1,"LOWE, ALIEU",2,1,1
8143,2048720060,BX,1036 EAST 226 STREET,01,A2,BRITZ CONTRACTING INC,2,1,1
8144,2049530059,BX,1684 EAST 233 STREET,06,E1,"AIKLER 1684 1,LLC",4,3,1
8145,2050030002,BX,1726 BUSSING AVENUE,01,B1,"WHITE-AMHERST, WINSOME",2,1,1
8146,2050150043,BX,4121 EDSON AVENUE,01,A1,DANIEL AYALA,2,1,1
8147,2050520068,BX,4355 BRUNER AVENUE,01,A1,"ALI, TAKIYAH",2,1,1
8148,2050920006,BX,1905 NEREID AVENUE,01,B3,"GONZALEZ, PETER J.",3,2,1
8149,2052740020,BX,3517 DE LAVALL AVENUE,01,B2,NORTH BRONX REALTY CORP.,2,1,1
8150,2053480060,BX,1309 ELLISON AVENUE,02,C0,"LUCIANO, PUBLIO",2,1,1
8151,2053570143,BX,2878 CODDINGTON AVENUE,01,B1,FRANJO MANAGEMENT CORP.,2,1,1
8152,2054090529,BX,3264 SPENCER DRIVE,01,B1,GRIXTI FRANCIS P,2,1,1
8153,2054090544,BX,3302 SPENCER DRIVE,01,A2,"FALLON, JEFFREY",2,1,1
8154,2054110207,BX,1526 MACDONOUGH PLACE,02,C0,"SIMOLACAJ, GEORGE",2,1,1
8155,2054170130,BX,1526 BAY VIEW AVENUE,01,B1,"POZZUTO, GRAZIO",2,1,1
8156,2055190213,BX,246 LONGSTREET AVENUE,01,B1,CHARLES N. SWEENEY,2,1,1
8157,2055360079,BX,927 BRINSMADE AVENUE,01,A2,"COSME, ANGLE L.",2,1,1
8158,2056460063,BX,478 MINNIEFORD AVENUE,01,A2,"MANCUSO, CANDY",2,1,1
8159,2056480036,BX,171 KILROE STREET,01,B3,MANZ ANNE L,2,1,1
8160,2056510064,BX,1437 ROOSEVELT AVENUE,01,A2,"MOSCHETTA, ROBERT",2,1,1
8161,2056510215,BX,45 ELM TREE LANE,01,A9,"MESTOUSIS, GINA",2,1,1
8162,2058461718,BX,5445 FIELDSTON ROAD,01,A9,"HAAS, BRIAN",2,1,1
8163,3001980011,BK,314 DEAN STREET,05,O2,EPDI ASSOCIATES LLC,2,1,1
8164,3002780023,BK,216 ATLANTIC AVENUE,04,S2,"ATLANTIC DTB, LLC",2,1,1
8165,3006730053,BK,191 31 STREET,01,B9,CATHERINE TORIGIAN,2,1,1
8166,3006760060,BK,127 32 STREET,01,B9,"MATEO, JENNY",2,1,1
8167,3008800001,BK,544 7 AVENUE,08,W1,NYC DEPARTMENT OF EDUCATION,4,3,1
8168,3009700050,BK,296 6 AVENUE,01,B1,"CHANG, VIVIAN WEI-HUA",2,1,1
8169,3010280020,BK,244 12 STREET,01,A5,"JELLINGHAUS , CHARLES  C",2,1,1
8170,3012930008,BK,1394 CARROLL STREET,04,K4,KINGSTON Y M REALTY I,2,1,1
8171,3013100039,BK,572 MONTGOMERY STREET,01,A5,"SIMPSON, YOSEF",2,1,1
8172,3013480005,BK,105 SCHENECTADY AVENUE,01,B1,105 SCHENECTADY LLC,3,2,1
8173,3014120068,BK,591 CROWN STREET,01,B1,BARUCH M MEIJERS,2,1,1
8174,3014420028,BK,2256 PACIFIC STREET,02,C0,POINT HOMES LLC,2,1,1
8175,3014650032,BK,1938 PROSPECT PLACE,07,G2,1515 EAST NEW YORK A,2,1,1
8176,3014850039,BK,42 HOWARD AVENUE,02,C2,42 HOWARD REALTY LLC,2,1,1
8177,3015650004,BK,225 THOMAS S BOYLAND ST,02,C0,"RIDDICK, RODNEY",2,1,1
8178,3016460027,BK,678 MADISON STREET,01,B3,"LEONARD, JESSICA",2,1,1
8179,3017930049,BK,316 CLIFTON PLACE,01,B3,"MCBEAN CLARKE, TYRONE",2,1,1
8180,3018600021,BK,1212 FULTON STREET,05,K1,BAWABEH BROTHERS NO. 2 LLC,3,2,1
8181,3018900090,BK,471 MYRTLE AVENUE,04,S2,470-471 MYRTLE AVENUE REALTY CORP,2,1,1
8182,3018940049,BK,104 EMERSON PLACE,02,C0,106 EMERSON LLC,2,1,1
8183,3019530006,BK,301 GREENE AVENUE,01,B1,ROBINSON BETTY P,2,1,1
8184,3019890039,BK,432 FRANKLIN AVENUE,04,S2,"ALSTON TRUSTEE, IRENE",2,1,1
8185,3019940032,BK,22 CLAVER PLACE,01,A9,"EDINBORO, DALE C",3,2,1
8186,3020440029,BK,79 CARLTON AVENUE,02,C0,"BOBB, MARCIA",2,1,1
8187,3020460035,BK,69 CLERMONT AVENUE,01,B9,"KING, JOSEPHINE",2,1,1
8188,3020890001,BK,209 WASHINGTON PARK,02,C2,WUTHERING HEIGHTS LLC,3,2,1
8189,3020960016,BK,201 ASHLAND PLACE,02,C0,PETERKIN FLORICE,2,1,1
8190,3023210009,BK,210 NORTH 8 STREET,02,C3,210 N 8 LLC,2,1,1
8191,3023787503,BK,57 GRAND STREET,04,RM,UNAVAILABLE OWNER,2,1,1
8192,3024250014,BK,390 SOUTH 2 STREET,03,D1,VIOLA CLEF LLC,3,2,1
8193,3026170036,BK,119 GUERNSEY STREET,02,C1,GUERNSEY PARK LLC,2,1,1
8194,3026520042,BK,88 DIAMOND STREET,01,B9,"ROBESPIERRE, GILLIAN",2,1,1
8195,3026940025,BK,817 MEEKER AVENUE,06,E1,MEEKER AVENUE CORP,3,2,1
8196,3027720016,BK,36 BUSHWICK AVENUE,02,C3,"CTGC REALTY, LLC",2,1,1
8197,3027780023,BK,70 BUSHWICK AVENUE,03,D1,BUSHWICK POWERS LLC,3,2,1
8198,3029160069,BK,219 DEVOE STREET,01,A5,CAROLINE R ANDREWS,2,1,1
8199,3030427501,BK,151 MANHATTAN AVENUE,04,RM,UNAVAILABLE OWNER,2,1,1
8200,3030440035,BK,155 MESEROLE STREET,02,C1,"155 MESEROLE LLC.,",2,1,1
8201,3031970049,BK,1119 WILLOUGHBY AVENUE,02,C2,JAY WILL LLC,2,1,1
8202,3032430023,BK,1270 DEKALB AVENUE,04,S2,"GLAZER, VICTOR LEWIS",2,1,1
8203,3033330033,BK,1349 GATES AVENUE,03,D1,"GATES GARDENS HOUSING DEVELOPMENT FUND C OMPANY, IN",2,1,1
8204,3033680005,BK,495 EVERGREEN AVENUE,11,V0,495 EVERGREEN CORP.,2,1,1
8205,3033920050,BK,1369 HANCOCK STREET,01,B1,"URBAN , GREGORY  L",2,1,1
8206,3036120019,BK,901 THOMAS S BOYLAND ST,01,B1,COBB STEPHEN,2,1,1
8207,3038470007,BK,741 SACKMAN STREET,01,A5,ROBERTO J MITCHELL,2,1,1
8208,3038740043,BK,730 HINSDALE STREET,01,B1,"GREENAWAY, DELIS Q",2,1,1
8209,3039600003,BK,209 HALE AVENUE,01,B1,"DUKHARAN, LESLYN",2,1,1
8210,3039740001,BK,3100 ATLANTIC AVENUE,02,C1,3100 ATLANTIC LLC,54,53,1
8211,3040180032,BK,729 BELMONT AVENUE,01,A1,HERNANDEZ JOSE,2,1,1
8212,3040310127,BK,668 BELMONT AVENUE,01,A5,"BAILEY-FLORES, GLORIA A",2,1,1
8213,3041190061,BK,316 ETNA STREET,01,B1,RVM8 DEVELOPMENT INC,2,1,1
8214,3041350032,BK,564 RIDGEWOOD AVENUE,04,S3,"AGUILAR, NOEMI",2,1,1
8215,3042690010,BK,671 HEMLOCK STREET,02,C0,EBANKS GEORGE,2,1,1
8216,3043020038,BK,631 HEGEMAN AVENUE,01,B1,"WILLIAMSON, CAROL E",2,1,1
8217,3043190015,BK,728 ALABAMA AVENUE,01,B2,"CAESAR, JAHANGELO E",2,1,1
8218,3043220024,BK,1929 LINDEN BOULEVARD,07,G4,"BOLLA EM REALTY, LLC",2,1,1
8219,3044810049,BK,785 LOGAN STREET,02,C3,"MACK, SEAN A",2,1,1
8220,3047120018,BK,591 EAST 91 STREET,02,C0,LINDA PIERRE,2,1,1
8221,3047600030,BK,1144 UTICA AVENUE,06,E2,ADAR 1188 LLC,2,1,1
8222,3047680153,BK,1235 SCHENECTADY AVENUE,01,A9,"RAJKUMAR, JUNIOR",2,1,1
8223,3048010004,BK,1143 NOSTRAND AVENUE,04,S1,RUFAI REAL ESTATE HOLDING CORP,2,1,1
8224,3048500013,BK,248 EAST 46 STREET,02,C0,HINES THELMA,2,1,1
8225,3050300065,BK,259 MAPLE STREET,01,A1,"ALCALY, MARA",2,1,1
8226,3050710022,BK,38 STRATFORD ROAD,02,C5,JANET PRYCE,2,1,1
8227,3051410065,BK,272 STRATFORD ROAD,01,B3,"BURKE, JOSEPH",2,1,1
8228,3051430016,BK,244 ARGYLE ROAD,01,A1,"COHN , NAOMI",2,1,1
8229,3051530027,BK,416 STRATFORD ROAD,01,A1,ADAM A. MAZOR,2,1,1
8230,3052140069,BK,1275 ROGERS AVENUE,02,C2,"MORAIS, IRMA",2,1,1
8231,3052230105,BK,1270 FLATBUSH AVENUE,04,S2,CYRUS REALTY SERVICES LLC,2,1,1
8232,3052350027,BK,634 MARLBOROUGH ROAD,02,C0,"GARCIA, OSCAR",2,1,1
8233,3053020048,BK,3437 FT HAMILTON PARKWAY,07,G4,CROPSEY 20TH AVE CORP,2,1,1
8234,3053310033,BK,817 FRIEL PLACE,01,A9,"GALLAGHER, RYAN",2,1,1
8235,3053790080,BK,1621 44 STREET,01,A9,"GLASSMAN, EFRAIM",2,1,1
8236,3053980075,BK,695 EAST 4 STREET,01,B2,ELVIRA LEFKOVITS,2,1,1
8237,3054550010,BK,4903 17 AVENUE,01,A1,NAFTALI BRACHFELD,2,1,1
8238,3054660036,BK,1660 51 STREET,01,B2,HERBERT SPITZ,2,1,1
8239,3054780063,BK,1665 54 STREET,01,B2,"ZELIG PRAG, PINCHAS",2,1,1
8240,3055080029,BK,2152 58 STREET,01,B3,"WORCH, MYER",2,1,1
8241,3055110067,BK,1729 60 STREET,01,A1,SOLOMON SABEL,2,1,1
8242,3055910059,BK,1017 42 STREET,02,C2,"ABER, JOSEPH",2,1,1
8243,3056200007,BK,4611 10 AVENUE,02,C3,"UNGER, ISRAEL",2,1,1
8244,3056290060,BK,1339 48 STREET,11,V0,1339 48 ST LLC,2,1,1
8245,3056650048,BK,873 54 STREET,02,C0,"CHEN, YONG LE",2,1,1
8246,3056680026,BK,1152 53 STREET,01,B1,1152 53 MANAGEMENT LLC,2,1,1
8247,3056720011,BK,812 54 STREET,05,O5,FORUM DEVELOPMENT LLC,2,1,1
8248,3056770046,BK,1359 55 STREET,02,C0,"GLATZER, ALBERT",2,1,1
8249,3056970024,BK,1246 57 STREET,04,D7,1250 57TH STREET LLC,2,1,1
8250,3059750229,BK,26 COLONIAL COURT,01,A3,BRUNETTI CAROLYN P,2,1,1
8251,3059800071,BK,439 80 STREET,01,A1,"MASTORAKIS, KONSTANTINO",2,1,1
8252,3059990041,BK,580 81 STREET,01,B1,"PARASKEVADIS, MILTON",2,1,1
8253,3060050014,BK,146 82 STREET,01,A1,GUTWIRTH DAVID,2,1,1
8254,3060050024,BK,162 82 STREET,01,A1,"GHORRA, THEODORE J",2,1,1
8255,3060460047,BK,75 88 STREET,01,A1,"MENEZES, NELSON",2,1,1
8256,3061550062,BK,1239 70 STREET,02,C0,"GIRONE, MARIO",2,1,1
8257,3061750068,BK,2125 71 STREET,01,B2,"MOK, SHEUNG YING",2,1,1
8258,3061970029,BK,2166 72 STREET,01,B2,Anthony Nastasi,2,1,1
8259,3062640060,BK,2137 79 STREET,01,B1,CHAYA TABAK,2,1,1
8260,3062670008,BK,7901 12 AVENUE,01,A9,"IACOBUZIO, BRUNA ROMEO",2,1,1
8261,3064167501,BK,119 BAY 31 STREET,02,R3,UNAVAILABLE OWNER,3,2,1
8262,3064167503,BK,2230 BENSON AVENUE,02,R3,UNAVAILABLE OWNER,3,2,1
8263,3065190035,BK,1064 EAST 7 STREET,01,A1,ALBERT KASSAB,2,1,1
8264,3065220004,BK,910 AVENUE I,01,A3,"DWECK, ADELE",2,1,1
8265,3065360057,BK,1171 EAST 10 STREET,01,A9,"FRIEDMAN, MICHAEL",2,1,1
8266,3065450004,BK,908 AVENUE L,01,A1,MATTHEW J. OKON,2,1,1
8267,3065710061,BK,1375 EAST 8 STREET,01,B2,NAGELBLATT ESTHER,2,1,1
8268,3065750024,BK,1440 WEST 9 STREET,02,C3,"SAVASTANO, FRANCESCO",2,1,1
8269,3065800050,BK,1439 WEST 5 STREET,01,B2,"IACOBUZIO, ELIZABETH M",2,1,1
8270,3065890016,BK,1426 EAST 8 STREET,01,B2,"SHAMAH, IRWIN",2,1,1
8271,3066110025,BK,1640 EAST 5 STREET,01,A9,"AZAR, ABE",2,1,1
8272,3066130062,BK,1593 OCEAN PARKWAY,01,A7,"YADID, JACOB",2,1,1
8273,3066380056,BK,1653 OCEAN PARKWAY,01,B1,THE SAM N. SASSON 2011 IRREVOCABLE RESID ENCE TRUST,2,1,1
8274,3066420059,BK,1647 EAST 10 STREET,01,B1,"BAREKET, DAVID",2,1,1
8275,3066420067,BK,1627 EAST 10 STREET,01,B2,"WEISMAN, MOSHE",2,1,1
8276,3066580035,BK,1820 EAST 2 STREET,02,C3,CAROLLO MARIA,2,1,1
8277,3066960049,BK,1209 AVENUE I,01,B1,1209 AVENUE I RESIDENCE TRUST,2,1,1
8278,3067110046,BK,934 EAST 19 STREET,04,S1,HERTZ ALAN,2,1,1
8279,3067200074,BK,1100 EAST 19 STREET,01,A1,"CHURBA, SHIFRA",2,1,1
8280,3067560029,BK,1460 EAST 19 STREET,01,B1,"REISMAN, STEVEN",2,1,1
8281,3067760006,BK,1314 AVENUE P,02,C0,"LEIMAN, DVORAH",2,1,1
8282,3070220063,BK,2859 WEST 16 STREET,02,C2,MARIE SCORDARAS IRREVOCABLE TRUST DATED  4/30/2019,4,3,1
8283,3070370100,BK,4606 SURF AVENUE,01,B2,JUDITH GLUCKSMAN REALTY LLC,2,1,1
8284,3070780075,BK,1913 WEST 11 STREET,02,C0,"HOUY, SEING",2,1,1
8285,3070890040,BK,1980 EAST 8 STREET,02,C3,1980 EAST 8TH STREET LLC,2,1,1
8286,3071040401,BK,2078 EAST 1 STREET,01,A1,"HARARI, ALAN",2,1,1
8287,3071080166,BK,1970 OCEAN PARKWAY,01,A1,HABERT GISELLE,2,1,1
8288,3071090040,BK,2136 EAST 7 STREET,01,B3,"ASSIS, TOUVI",2,1,1
8289,3071120058,BK,2059 EAST 9 STREET,01,B2,"ABADI, LETICIA LYNN",2,1,1
8290,3071190049,BK,2167 WEST 8 STREET,01,B2,FICANO SALVATORE,2,1,1
8291,3071340012,BK,730 AVENUE U,04,S9,BLUE SPOT CORP,2,1,1
8292,3071580083,BK,2225 OCEAN PARKWAY,01,A1,BAWABEH GOOD WILL LLC,2,1,1
8293,3071770005,BK,372 AVENUE W,01,A1,MOUSA SAAD,2,1,1
8294,3072910131,BK,1221 AVENUE T,08,M1,BETH EL TALMUT TORAH,2,1,1
8295,3073000001,BK,2102 AVENUE S,01,B3,TAL MIZRAHI,2,1,1
8296,3073050081,BK,1917 EAST 26 STREET,01,A1,"MIZRAHI, NINA",2,1,1
8297,3073160071,BK,2025 EAST 12 STREET,01,A9,"CHOUEKA, ILYAHO",2,1,1
8298,3073270012,BK,2014 EAST 23 STREET,01,B3,"WU, MEI NA",3,2,1
8299,3073440042,BK,1217 AVENUE V,01,A1,KBABIA YUSSEF,2,1,1
8300,3073790014,BK,2222 EAST 19 STREET,01,B3,"KHIDIDEH, AZIZ",2,1,1
8301,3074050323,BK,2352 EAST 24 STREET,01,B1,"NIP, WAH CHING",2,1,1
8302,3074310041,BK,1123 AVENUE Z,04,S1,KUPERMAN MANAGEMENT CORP.,2,1,1
8303,3074430030,BK,2563 EAST 27 STREET,01,B3,"ZHENG, KEN",2,1,1
8304,3074790106,BK,2644 COYLE STREET,11,V0,NICHOLAS GOZO,2,1,1
8305,3075720076,BK,872 EAST 27 STREET,01,A9,GRAY MARK,2,1,1
8306,3076210023,BK,1279 EAST 21 STREET,01,A1,SHLOMO GERTZULIN,2,1,1
8307,3076380079,BK,1406 EAST 21 STREET,01,A1,"LESHKOWITZ, ESTHER S",2,1,1
8308,3076430046,BK,2516 AVENUE L,01,A1,"HAIM, STEVEN",2,1,1
8309,3076580074,BK,1352 EAST 23 STREET,01,A1,FRAYDEL SOLOFF MIRIAM,2,1,1
8310,3076990049,BK,1514 EAST 38 STREET,01,A1,JACOB NEISS,2,1,1
8311,3077560031,BK,1133 EAST 52 STREET,01,B1,"GUY, ULRIC",2,1,1
8312,3077720022,BK,1309 EAST 46 STREET,01,A5,"ARMSTRONG, DAVID",2,1,1
8313,3077910038,BK,4318 AVENUE J,01,B1,"MCDONALD C. WHITE, TRUSTEE",2,1,1
8314,3078230060,BK,1948 TROY AVENUE,01,B2,"SAINROSE, CHARLY",2,1,1
8315,3079930038,BK,602 EAST 89 STREET,01,B1,CHRISTIAN CHURCH OCCANARSIE,2,1,1
8316,3083340050,BK,2200 ROCKAWAY PARKWAY,09,Q1,NATIONAL PARK SERVICE,2,1,1
8317,3084420063,BK,2258 EAST 74 STREET,01,A1,"MASHKOV, PAVEL",2,1,1
8318,3085370036,BK,2113 EAST 37 STREET,01,A1,"SZCZAPA, BRIAN",2,1,1
8319,3086740028,BK,3066 BRIGHTON 5 STREET,02,C3,HYF REALTY LLC,2,1,1
8320,3087230267,BK,262 CORBIN PLACE,01,A3,SEMYON RUVINSKY,2,1,1
8321,3088157501,BK,3144 EMMONS AVENUE,04,RM,UNAVAILABLE OWNER,19,18,1
8322,4003590018,QN,9-04 37 AVENUE,08,M1,PENTECOSTAL CHRISTIAN,2,1,1
8323,4003970035,QN,27-09 40 AVENUE,06,F5,40TH AVE DUTCH KILLS REALTY LLC,2,1,1
8324,4004300018,QN,42-42 27 STREET,04,S2,"ROYAL CP HOTEL HOLDINGS, L.P.",2,1,1
8325,4004730564,QN,38-42 12 STREET,06,E9,LIC NORTH LLC,3,2,1
8326,4005210119,QN,33-20 14 STREET,01,B1,TABI ROBERT,2,1,1
8327,4007230039,QN,47-14 BROADWAY,02,C0,"GIRDHARI, CHET",2,1,1
8328,4008750044,QN,23-14 23 AVENUE,01,A5,"YOON, MICHAEL",2,1,1
8329,4010800001,QN,85-01 24 AVENUE,10,G1,"85-01 24TH AVENUE, LLC",4,3,1
8330,4010840017,QN,23-28 91 STREET,01,A2,MARTHA MONTEVERDE,2,1,1
8331,4013460035,QN,68-05 43 AVENUE,02,C0,HELEN MEI HO,2,1,1
8332,4014040015,QN,31-22 93 STREET,01,A5,"PUCHA, VICTOR",2,1,1
8333,4014720011,QN,37-12 85 STREET,02,C6,UNAVAILABLE OWNER,2,1,1
8334,4015520028,QN,40-58 CASE STREET,01,B3,"WU, YIMEI",2,1,1
8335,4016450044,QN,24-25 GILLMORE STREET,01,A1,"ORDONEZ, HAYDEE J",2,1,1
8336,4017030066,QN,32-41 108 STREET,01,B1,"GAMARRA, INES",2,1,1
8337,4017030108,QN,32-32 110 STREET,01,B1,"HUANG, AIDI",2,1,1
8338,4017200015,QN,33-18 106 STREET,01,A1,ESTRADA MARTHA,2,1,1
8339,4017320022,QN,98-17 35 AVENUE,01,B3,"ZHONG, LIANXIA",3,2,1
8340,4017420032,QN,101-03 37 AVENUE,04,S2,"DE LA CRUZ, ANA I",2,1,1
8341,4018570026,QN,90-54 55 AVENUE,02,C0,"LOH, EDDIE",2,1,1
8342,4018790027,QN,97-68 CORONA AVENUE,04,S2,GONZALEZ DANIEL GOME,2,1,1
8343,4019540037,QN,107-01 OTIS AVENUE,08,W1,NYC DEPARTMENT OF EDUCATION,2,1,1
8344,4020010020,QN,108-42 45 AVENUE,02,C0,JOSE L PANORA,2,1,1
8345,4026750152,QN,58-77 58 AVENUE,01,B2,"LENARD, ABIGNIEW",2,1,1
8346,4027040063,QN,60-22 56 ROAD,01,B3,"COSTIN, ANN",2,1,1
8347,4027510002,QN,57-49 64 STREET,01,B2,"CHEN, QIN GENG",2,1,1
8348,4027530271,QN,64-82 58 ROAD,01,A5,"CAPUTO, MICHAEL",2,1,1
8349,4027530305,QN,64-31 59 AVENUE,01,A2,JOSEPH W DOWNES JR,2,1,1
8350,4028300009,QN,69-32 59 DRIVE,01,A2,69-32 59TH DRIVE LLC,2,1,1
8351,4029440036,QN,84-31 61 ROAD,01,A5,"TAM, KIM CHING",2,1,1
8352,4030020005,QN,64-01 77 STREET,01,B3,"HANRAHAN, MARTIN",2,1,1
8353,4030690034,QN,66-20 79 PLACE,01,B1,"DEMARTINO, KIMMARIE",2,1,1
8354,4030700064,QN,66-54 80 STREET,01,B3,GRAFFEO MARYLU,4,3,1
8355,4032320012,QN,72 TENNIS PLACE,01,A7,"XIE, JIANLIN",2,1,1
8356,4033420061,QN,111-03 77 AVENUE,04,S1,MAKAMI IV REALTY LLC,2,1,1
8357,4035520036,QN,1652 GEORGE STREET,02,C3,"CHASE, BEVERLY I",2,1,1
8358,4035810041,QN,60-27 78 AVENUE,02,C0,70TH AVENUE GLENDALE LLC,2,1,1
8359,4035960016,QN,75-29 62 STREET,04,S2,"BERMELLO, ALBA",2,1,1
8360,4037080012,QN,73-31 70 STREET,01,B3,"HRYSZKO, DIANE",2,1,1
8361,4037280048,QN,80-44 CYPRESS AVENUE,01,B3,BETA FOUR ENTERPRISE INC.,2,1,1
8362,4037800053,QN,79-27 67 ROAD,01,B3,"GORSKI, JANUSZ",2,1,1
8363,4038050004,QN,77-09 79 PLACE,01,B3,"MUCKIAN, ROBERT",2,1,1
8364,4038110045,QN,71-15 73 PLACE,02,C0,J E WAGNER INC,2,1,1
8365,4038330077,QN,78-66 83 STREET,01,B2,"FITZGERALD, LORETTA",2,1,1
8366,4038700124,QN,88-66 MYRTLE AVENUE,05,O5,S & S OPERATION COMPANY,2,1,1
8367,4039210008,QN,124-01 5 AVENUE,01,B2,"JIANG, JIE WEN",2,1,1
8368,4039420003,QN,7-19 COLLEGE PLACE,01,A5,CAMPUZANO WILLIAM,2,1,1
8369,4039500031,QN,5-15 125 STREET,01,B2,SCANLON GREGORY,2,1,1
8370,4040030073,QN,13-40 127 STREET,01,B2,"WANG, YUANYUAN",2,1,1
8371,4040900040,QN,15-42 126 STREET,01,A1,"MUMINOVIC, SANJIN",2,1,1
8372,4042680033,QN,126-18 25 ROAD,01,B3,"HUANG, YIFU",2,1,1
8373,4042730075,QN,130-07 26 AVENUE,06,F9,A & A PRINCE REALTY COMPANY LLC,2,1,1
8374,4043150052,QN,28-20 119 STREET,06,E1,119 CP PROPERTY LLC,2,1,1
8375,4043460041,QN,29-10 120 STREET,06,E9,SOUTH WIND REALTY LLC,3,2,1
8376,4044830052,QN,13-15 147 STREET,01,A1,"RANALLO, SABATINO",2,1,1
8377,4044870154,QN,151 6 ROAD,06,F5,GRAHEL ASSOCIATES LLC,2,1,1
8378,4045810031,QN,160-22 12 AVENUE,01,A1,"RICCOBONI, NADIA",2,1,1
8379,4045960043,QN,14-44 163 STREET,01,A1,CVECIC NEVENKA,2,1,1
8380,4046300049,QN,145-61 20 AVENUE,01,B1,FRANCO FERRARI,2,1,1
8381,4050040009,QN,35-11 146 STREET,02,C0,SHI YUN HUANG,2,1,1
8382,4050290013,QN,40-15 149 STREET,08,M9,NEW SPROUT PRESBYTERIAN CHURCH OF NEW YO RK,3,2,1
8383,4051020050,QN,132-27 POPLE AVENUE,01,A2,"HO, LUAN HSIANG",2,1,1
8384,4052230018,QN,140-54 OAK AVENUE,01,B3,"HUANG, DAVID WEI",2,1,1
8385,4052420080,QN,33-76 158 STREET,01,A3,"LI, YAN",2,1,1
8386,4052630008,QN,35-11 MURRAY STREET,04,S2,"TYPHILLIP, LLC",2,1,1
8387,4053140003,QN,192-07 37 AVENUE,02,C6,BAYDALE TENANTS CORP,4,3,1
8388,4056850028,QN,56-48 HOLLIS COURT BLVD,01,A1,"LOH, JOHNNY YIU YUNG",2,1,1
8389,4061680030,QN,35-31 212 STREET,01,A1,JOYCE YUAN LLC,2,1,1
8390,4065170200,QN,152-45 MELBOURNE AVENUE,08,W5,DORMITORY AUTHORITYOF THE STATE OF NEW Y ORK,2,1,1
8391,4068020001,QN,163-21 72 AVENUE,02,C0,"NG, DANIEL Y.",2,1,1
8392,4069590014,QN,71-41 171 STREET,01,A3,"KAMINETZKY, BARBARA",2,1,1
8393,4070650008,QN,181-05 HORACE HARDING EXPWY,07,G4,"GTY-CPG(QNS/BX)LEASING,INC",2,1,1
8394,4073790004,QN,202-10 50 AVENUE,01,B3,"JIANG, YAQUN",4,3,1
8395,4073820004,QN,205-08 50 AVENUE,01,A1,"TIBURCIO, VICTOR",2,1,1
8396,4073920046,QN,214-31 51 AVENUE,01,A1,"KANTLIS, KOSTAS",2,1,1
8397,4076530039,QN,230-03 64 AVENUE,01,A0,"YANG, SHU XIAN",2,1,1
8398,4079800020,QN,88-17 241 STREET,01,A1,"RANI, NEENA",2,1,1
8399,4081210037,QN,41-24 248 STREET,01,B3,"CHOW, EUGENE",2,1,1
8400,4083500095,QN,58-30 255 STREET,01,A1,"PO, VIRGINIA W",2,1,1
8401,4083510040,QN,255-20 58 AVENUE,01,B1,"HUANG, CI YI",2,1,1
8402,4089420061,QN,91-11 ELDERT LANE,01,B1,"PIETROVITO, DIANNE",13,12,1
8403,4093750158,QN,134-12 91 AVENUE,01,A9,"CUEVA, CESAR",2,1,1
8404,4094030047,QN,97-17 101 STREET,01,B2,"SAL & SON ENTERPRISES, LLC.",3,2,1
8405,4094070015,QN,97-16 106 STREET,02,C0,"CHEN, HUI YING",2,1,1
8406,4094930016,QN,101-16 127 STREET,02,C0,"GEORGE, SUNNY",2,1,1
8407,4095780010,QN,124-20 LIBERTY AVENUE,05,K2,TULSHI RAJKUMARIE,2,1,1
8408,4095900001,QN,130-02 LIBERTY AVENUE,05,O7,ARTHUR R ELCOCK LIVING TRUST,3,2,1
8409,4097080020,QN,139-30 86 ROAD,01,B1,MING LU ZHANG,2,1,1
8410,4097090068,QN,139-57 86 ROAD,01,B2,ABRAHIM ROMANIE,2,1,1
8411,4097350050,QN,152-03 85 DRIVE,01,A1,ZAMEEN DINDYAL,2,1,1
8412,4098540017,QN,84-17 164 STREET,01,B2,"SALOMON, RADA HART",2,1,1
8413,4098940088,QN,90-66 179 STREET,01,B2,PROBADIAL URPRASAD,2,1,1
8414,4099030024,QN,91-09 183 STREET,01,B2,"TASNEEM, FATEMA",2,1,1
8415,4099430072,QN,83-30 MIDLAND PARKWAY,01,A3,"CHIU, MAN CHOI",2,1,1
8416,4099470128,QN,85-20 AVON STREET,01,A1,"ILIZAROV, ARKADIY",2,1,1
8417,4100330003,QN,148-10 97 AVENUE,07,G2,"SUTPHIN AVENUE DEVELOPMENT, LLC",5,4,1
8418,4101230004,QN,155-10 TUSKEGEE AIRMEN WAY,02,C0,"HARRIS, HAZEL",2,1,1
8419,4102110269,QN,92-49 168 PLACE,01,B3,"MOHAMMED, UDDIN",2,1,1
8420,4103330103,QN,177-27 106 AVENUE,11,V0,"DELGADO, DEREK",2,1,1
8421,4103730012,QN,187-02 104 AVENUE,01,B3,ROBIN D JOHNSON,2,1,1
8422,4103990010,QN,187-19 TIOGA DRIVE,01,A1,"GOODEN, RONALD",2,1,1
8423,4106330012,QN,92-26 217 STREET,01,A1,FLORACITA DUNN,2,1,1
8424,4108460007,QN,99-02 200 STREET,01,A1,L HAMPTON,2,1,1
8425,4109620440,QN,111-25 204 STREET,01,A1,"PRUITT, ALFONSO",2,1,1
8426,4109860001,QN,112-43 209 STREET,01,B3,"BELCHER, NEIL V.",2,1,1
8427,4109880039,QN,191-29 MURDOCK AVENUE,01,A1,SHOUN M. KENNEDY AS TRUSTEE,2,1,1
8428,4109920036,QN,113-37 197 STREET,01,A1,"FOCHT, FRANCES",3,2,1
8429,4110100047,QN,194-37 114 ROAD,01,A1,"SNUGGS, DAVID  W",2,1,1
8430,4110920011,QN,102-21 216 STREET,01,A1,"CHRISTIANSEN, WILLIA",2,1,1
8431,4111360006,QN,214-10 113 AVENUE,01,B3,"MORIAN, MCDONALD",2,1,1
8432,4111830035,QN,107-20 219 STREET,01,A1,LEON GAINES,3,2,1
8433,4113060028,QN,115-69 224 STREET,01,A2,"MOLINA, JUAN D",2,1,1
8434,4113470001,QN,84-04 SUTTER AVENUE,01,B1,"RAMJATTAN, SUDESH",2,1,1
8435,4114820026,QN,110-21 107 STREET,01,B2,"YANG, FLORA YEWEI",2,1,1
8436,4116100024,QN,109-38 131 STREET,01,A1,"ZAYAS, LUCIA",2,1,1
8437,4116600049,QN,114-39 134 STREET,01,B3,"CARRANZA, KEVIN A",2,1,1
8438,4117450013,QN,117-51 123 STREET,01,B3,"SANKAR , HEMWATTEE",2,1,1
8439,4117690026,QN,130-25 133 AVENUE,01,A2,RATHOUR VILATI,2,1,1
8440,4119320045,QN,144-09 109 AVENUE,01,B2,GRACIE M IRBY,2,1,1
8441,4119730116,QN,114-04 144 STREET,01,A2,"SMITH, DEREK J",2,1,1
8442,4119790052,QN,114-27 148 STREET,01,A1,"PERSAUD, MOONILALL",2,1,1
8443,4119930058,QN,148-08 115 AVENUE,01,A1,GEDEON LORAINE,2,1,1
8444,4120210009,QN,146-18 FOCH BOULEVARD,01,B3,"DILLAWAR, ZAHIR",2,1,1
8445,4120240113,QN,144-08 119 AVENUE,01,A1,"DWARKA, RAVINDRALALL",2,1,1
8446,4120250080,QN,119-50 INWOOD STREET,01,B1,"PETERSON, MARCUS",2,1,1
8447,4120370020,QN,142-44 120 AVENUE,01,A5,"ALI, NAYEEMI",2,1,1
8448,4120550065,QN,137-01 130 AVENUE,01,A1,"SUGRIM, KRISHNA",2,1,1
8449,4120610019,QN,126-26 144 STREET,01,B1,NALINIE SUDHU,3,2,1
8450,4121020061,QN,126-46 148 STREET,10,G0,VICTOIRE TINGUE,2,1,1
8451,4122010018,QN,150-24 116 AVENUE,01,A1,"SKEOKUMAR, GEETANJALIE",2,1,1
8452,4122020074,QN,150-59 116 DRIVE,01,A1,JEROME L BATTLE,2,1,1
8453,4122390020,QN,160-15 118 ROAD,01,A2,"CRAWFORD , CYNTHIA",2,1,1
8454,4122510031,QN,160-46 121 AVENUE,01,B1,"MOULTRIE, WANDA",2,1,1
8455,4122660040,QN,157-16 128 AVENUE,01,B2,"LOUISON, CECIL",2,1,1
8456,4123850225,QN,168-07 BAISLEY BOULEVARD,07,G3,BAISLEY REALTY HOLDINGS LLC,3,2,1
8457,4124660016,QN,119-46 179 STREET,01,A1,B JONES,2,1,1
8458,4124740036,QN,179-89 SELOVER ROAD,01,A5,"ROBINSON, ZULEMA B",2,1,1
8459,4125160103,QN,174-35 125 AVENUE,01,B3,"HOLLOMAN-MERCHANT,ELAINE",2,1,1
8460,4126190018,QN,117-24 199 STREET,01,A1,2 OF A KIND LLC,2,1,1
8461,4126320062,QN,118-08 203 STREET,01,A1,"WELCOME , LATONYA",2,1,1
8462,4128740052,QN,128-20 234 STREET,01,A2,"LOUIS, MARIE L",2,1,1
8463,4128750004,QN,234-11 129 AVENUE,01,A3,CARRIE B SHELTON,2,1,1
8464,4129220141,QN,216-26 131 AVENUE,01,A1,"MCDONALD, BENJAMIN",3,2,1
8465,4129570161,QN,133-18 220 STREET,01,A1,SHEILA TUFFARELLI,2,1,1
8466,4129920011,QN,178-02 CRANDALL AVENUE,01,B3,"HENRY, ROBERTO",2,1,1
8467,4130180029,QN,136-35 SPRINGFIELD BLVD,04,S9,JOSEPH HANANIA,3,2,1
8468,4130630066,QN,219-24 EDGEWOOD AVENUE,01,B3,"ESPINAL, ESPEDITO A",2,1,1
8469,4131060028,QN,134-33 225 STREET,01,B3,LAMB DAWN,2,1,1
8470,4131730003,QN,137-56 232 STREET,01,A1,THE WINSTON V. PERRY REVOCABLE TRUST,2,1,1
8471,4135120046,QN,231-05 EDGEWOOD AVENUE,01,A2,JACQUELINE M JEROME FAMILY TRUST,2,1,1
8472,4135590011,QN,241-29 142 AVENUE,01,A2,LUVIE OLUFADE,3,2,1
8473,4136110016,QN,139-21 248 STREET,01,A1,"MOHSIN, MOHAMMAD",2,1,1
8474,4141940013,QN,161-16 99 STREET,01,A1,ROBERT MCGUIRE,2,1,1
8475,4154650007,QN,212 EAST 9 ROAD,01,A1,"CHAVANNE, LEO",2,1,1
8476,4155030079,QN,11-32 BRUNSWICK AVENUE,01,B2,AGATEP NOREEN,2,1,1
8477,4155830016,QN,802 HICKSVILLE ROAD,08,W2,YESHIVA OF FAR ROCKAWAY,2,1,1
8478,4156650058,QN,13-94 DICKENS STREET,01,B3,NATIONSTAR MORGAGE LLC,2,1,1
8479,4157210062,QN,12-24 BAY PARK PLACE,01,B3,"HUSAIN , ALAN",2,1,1
8480,4157990036,QN,314 BEACH 28 STREET,01,B3,GLORIA SOOM,2,1,1
8481,4162610037,QN,409 BEACH 138 STREET,01,A1,"MOLLOY, STEPHEN M",2,1,1
8482,5000410001,SI,54 LAYTON AVENUE,01,B2,"LASHLEY, JOAN",2,1,1
8483,5001320109,SI,56 WALBROOKE AVENUE,01,A3,MICHAEL ZARRILLI,2,1,1
8484,5001830031,SI,82 MYRTLE AVENUE,01,B2,JAMES LAURIA,2,1,1
8485,5002080020,SI,47 CAROLINE STREET,02,C3,HTT HOME GROUP LLC,3,2,1
8486,5002140018,SI,28 WHITE PLACE,01,A1,HELENE GUMBS,2,1,1
8487,5002290014,SI,22 DISOSWAY PLACE,01,A1,"PERERA, JERALD",2,1,1
8488,5002520044,SI,250 OAKWOOD AVENUE,01,A1,"BAVER, JOSHUA AARON",2,1,1
8489,5002540257,SI,16 ROSE COURT,01,A1,"RIKIC, MILAN",2,1,1
8490,5003480016,SI,109 BEECHWOOD PLACE,01,B1,JANE DAVIES,2,1,1
8491,5003580026,SI,284 KINGSLEY AVENUE,01,B3,"BARRETT, PAUL",2,1,1
8492,5003900095,SI,55 ELDRIDGE AVENUE,01,B3,"CARLSON, SCOTT",2,1,1
8493,5003980052,SI,164 WARDWELL AVENUE,01,A1,JAMES V. TREACY,2,1,1
8494,5004650043,SI,342 NEAL DOW AVENUE,01,A1,"BROWN, JOANN",2,1,1
8495,5004780067,SI,328 STEWART AVENUE,01,A1,"VACATELLO, DANIELLE",2,1,1
8496,5005980035,SI,19 RUGBY AVENUE,01,A1,"SHALL, LINDA",2,1,1
8497,5006330001,SI,305 VANDERBILT AVENUE,01,B2,"ALSAEDE, ALI",2,1,1
8498,5006490060,SI,495 VANDERBILT AVENUE,01,A1,"MENDEZ, RENE",2,1,1
8499,5006620032,SI,47 LITTLE CLOVE ROAD,04,O8,"PREMAST MANAGEMENT, LLC",2,1,1
8500,5007000019,SI,26 TILLMAN STREET,01,B1,TUNG THE PHUONG,2,1,1
8501,5008130006,SI,143 WELLBROOK AVENUE,01,A5,"ADRESS, IRA",2,1,1
8502,5008820095,SI,262 OCEAN TERRACE,01,A2,"PEFANIS, PANTELIS",2,1,1
8503,5010170040,SI,91 BOND STREET,01,A1,DENNIS MARDENBOROUGH,2,1,1
8504,5010590007,SI,599 PORT RICHMOND AVENUE,01,B1,STATE OF NEW YORK,2,1,1
8505,5010790043,SI,96 GROVE AVENUE,01,B2,GRINBERG M & DEVELOPMENT LLC,2,1,1
8506,5010840110,SI,72 SHARPE AVENUE,01,B2,"MIMIDINOVSKI, SPATIM",2,1,1
8507,5010890010,SI,166 CHARLES AVENUE,01,B2,ZAWISNY RICHARD,2,1,1
8508,5011210043,SI,165 JOHN STREET,01,B2,"RAMIREZ, ROBERT R",2,1,1
8509,5011320073,SI,42 WALKER STREET,01,A9,SAMPANG JOSELENE D,3,2,1
8510,5011330098,SI,90 WALKER STREET,01,A1,"CALVELLO, JOHN A",2,1,1
8511,5011500017,SI,23 GRANITE AVENUE,01,A1,"LOPEZ, DEISY",2,1,1
8512,5011650056,SI,128 LAKE AVENUE,01,B3,135 LAKE AVENUE REALTY LLC,2,1,1
8513,5012110102,SI,2848 RICHMOND TERRACE,01,B2,LI LIN,3,2,1
8514,5012160032,SI,97 MAPLE PARKWAY,01,A9,MARTA R. PALKO,2,1,1
8515,5012230060,SI,252 NETHERLAND AVENUE,01,A5,UNAVAILABLE OWNER,2,1,1
8516,5014400079,SI,64 BRYSON AVENUE,01,A1,"CAIAZZO, RAFFAELE",2,1,1
8517,5015080095,SI,22 TREMONT AVENUE,01,A2,"CALANDRA, PAUL JOHN",2,1,1
8518,5015080140,SI,19 CANTERBURY AVENUE,01,B2,"APEDO, ASHREFE W",2,1,1
8519,5015080172,SI,27 TREMONT AVENUE,01,A1,MICHAEL C NICHOLAS,2,1,1
8520,5016517502,SI,24 FARRAGUT AVENUE,02,R3,REGALWALK HOMEOWNERS ASSN INC,14,13,1
8521,5027800075,SI,41 CANNON AVENUE,01,A1,FRED CAPPETTA,2,1,1
8522,5027830008,SI,48 CANNON AVENUE,01,A2,K BRAHN,2,1,1
8523,5028580014,SI,150 MARYLAND AVENUE,01,A1,"FALLETTA, CHARLES M",2,1,1
8524,5028670167,SI,60 FAIRWAY AVENUE,01,A1,ALFONSO M ORDDE,2,1,1
8525,5030980051,SI,84 MACFARLAND AVENUE,01,B2,"EADICICCO, CATHERINE",3,2,1
8526,5031030093,SI,14 PEBBLE LANE,01,B9,LOUIS LIN,2,1,1
8527,5032220025,SI,32 MC CORMICK PLACE,01,A5,ELIZABETH CORDERO,2,1,1
8528,5032980017,SI,20 DELAWARE AVENUE,01,A1,"SHEEN, GRAHAM D",2,1,1
8529,5033970033,SI,301 OLYMPIA BOULEVARD,01,A5,ROBERT J ZAMBIASI ET,2,1,1
8530,5035570043,SI,122 JEFFERSON AVENUE,01,A1,CAPUTO JEFF C,2,1,1
8531,5035610015,SI,209 ADAMS AVENUE,01,A1,"TRAN, ANTHONY QUOC",2,1,1
8532,5035810017,SI,80 COLFAX AVENUE,01,B2,DEVITO MARIO,3,2,1
8533,5037280026,SI,406 HAMDEN AVENUE,01,A5,"SIMANOVA, OLGA",2,1,1
8534,5037340003,SI,459 MIDLAND AVENUE,01,B2,SINAI 123 LLC,2,1,1
8535,5037910056,SI,953 OLYMPIA BOULEVARD,01,A1,MARIA L AROCHO,3,2,1
8536,5038710023,SI,660 HUNTER AVENUE,01,A6,"HARRELL, DAVID",2,1,1
8537,5040660039,SI,69 HETT AVENUE,01,A2,"MONAHAN, PHYLLIS",2,1,1
8538,5040670031,SI,50 BEACON PLACE,01,B2,"YUSUF, MOHAMMED",2,1,1
8539,5042160033,SI,38 7 STREET,01,A1,"RYAN, TATIANA",2,1,1
8540,5043940043,SI,303 RIEDEL AVENUE,01,B2,"CASCARDO, RUSSELL",2,1,1
8541,5044210053,SI,80 WEST CEDARVIEW AVE,01,A1,"BRUNO, CHRISTOPHER",2,1,1
8542,5052710007,SI,65 WIMAN AVENUE,01,B3,"LAM, CHI  W",2,1,1
8543,5053100040,SI,60 GLOVER STREET,01,A5,ARKADIY BOLDINA,2,1,1
8544,5054380077,SI,200 KATAN AVENUE,01,B2,MARTIN DENNIS,2,1,1
8545,5054440111,SI,16 MICHAEL COURT,01,A5,JIE TANG,2,1,1
8546,5054470065,SI,386 GIFFORDS LANE,01,A1,DANIEL PRAVATA,2,1,1
8547,5057270094,SI,198 KENILWORTH AVENUE,01,A5,"GUBERMAN, IRINA",2,1,1
8548,5067010067,SI,14 DIRENZO COURT,01,A9,MOTEL FAYER,2,1,1
8549,5067960039,SI,115 LATOURETTE STREET,01,B2,"FYFE, VINCENT",2,1,1
8550,5073110015,SI,97 STORER AVENUE,06,E2,"97 STORER AVENUE, LLC",2,1,1
8551,5078210012,SI,7 JOLINE AVENUE,01,A1,"AMATUZZO, JARED C",2,1,1
8552,5078640013,SI,268 LORETTO STREET,01,A1,RINDA REGA,2,1,1
8553,5078670065,SI,166 SPRAGUE AVENUE,01,A1,HUGH LYNCH,2,1,1
8554,5078830028,SI,602 YETMAN AVENUE,01,A1,"LOMBARDI, JOSEPH",2,1,1
8555,5079000005,SI,7484 AMBOY ROAD,01,A1,"KOCIAN, THOMAS A",2,1,1
8556,5080260025,SI,133 MAIN STREET,01,B2,"BOEMI, NICOLE",2,1,1
8557,5080340020,SI,7095 AMBOY ROAD,05,K1,KARAMETI ARDJENT,2,1,1
8558,1001780029,MN,98 FRANKLIN STREET,04,D7,DDG 100 FRANKLIN LLC,2,1,1
8559,1002770014,MN,101 MADISON STREET,02,C1,KAM LAN REALTY CORP,2,1,1
8560,1004730001,MN,462 BROADWAY,05,O5,"462 BDWY LAND, L.P.",2,1,1
8561,1004750018,MN,51 WOOSTER STREET,05,O5,"WOOSTER 51, LLC",2,1,1
8562,1006090164,MN,139 WEST 13 STREET,02,C6,WINKLER RICHARD S,3,2,1
8563,1006310027,MN,273 WEST 10 STREET,02,C4,MAJOR 10TH ST REALTYCRP,2,1,1
8564,1007180001,MN,440 WEST 21 STREET,08,W7,GEN THEO SEMINARY P E,2,1,1
8565,1008900001,MN,7 PARK AVENUE,03,D4,PARK AVENUE & 35 STCORP,4,3,1
8566,1008950060,MN,148 EAST 40 STREET,05,O2,"148 EAST 40TH STREET OWNER, L.P.",2,1,1
8567,1009910060,MN,25-00 FDR DRIVE,04,D6,WATERSIDE PLAZA GROUND LESSEE LLC.,8,7,1
8568,1010930021,MN,604 WEST 46 STREET,07,G9,610 WEST 46TH STREET LLC,6,5,1
8569,1011980044,MN,30 WEST 85 STREET,01,A4,"FIRST, LAWRENCE A",2,1,1
8570,1013047501,MN,301 PARK AVENUE,05,RC,UNAVAILABLE OWNER,2,1,1
8571,1014080056,MN,1032 LEXINGTON AVENUE,04,K4,ADB MANAGEMENT LLC,2,1,1
8572,1014090149,MN,172 EAST 75 STREET,04,S2,SAGGESE FRANCESCO,2,1,1
8573,2023400028,BX,2590 PARK AVENUE,06,F4,"2590 PARK AVENUE, LLC",2,1,1
8574,2024560075,BX,1127 SHERIDAN AVENUE,04,C7,1125 SHERIDAN LLC,2,1,1
8575,2027630139,BX,758 MANIDA STREET,10,G0,DIAZ OBDULIA,2,1,1
8576,2027820085,BX,1348 TELLER AVENUE,01,B2,"CORREA, JUAN",2,1,1
8577,2028920009,BX,1808 ANTHONY AVENUE,01,B2,1808 ANTHONY REALTY LLC,2,1,1
8578,2029580074,BX,1820 WATERLOO PLACE,01,A1,"DOWDY, DAMEKA",2,1,1
8579,2029670002,BX,1560 BOSTON ROAD,01,A2,RUBEN RIVERA,2,1,1
8580,2029740001,BX,1216 INTERVALE AVENUE,08,M1,NY CONF AFR ZION CHUR,2,1,1
8581,2032750057,BX,2537 DECATUR AVENUE,04,C7,"MED REALTY, INC.",2,1,1
8582,2033370049,BX,3319 ROCHAMBEAU AVENUE,02,C0,MMC CORPORATION,2,1,1
8583,2034470028,BX,156 PUGSLEY AVENUE,01,B1,"SOUND POWER STUDIOS, LLC",2,1,1
8584,2036130048,BX,2236 HOMER AVENUE,01,B3,CAROLINE DEGIOVANNI,2,1,1
8585,2036480025,BX,960 CLOSE AVENUE,06,E9,CPA CLOSE AVENUE LLC,3,2,1
8586,2038760019,BX,1330 ST LAWRENCE AVENUE,02,C0,"RODRIGUEZ, CARLOS",2,1,1
8587,2039910030,BX,1664 PARKER STREET,08,M9,"CAPILLA EVANGELICA,INC.",2,1,1
8588,2040550046,BX,1862 MATTHEWS AVENUE,01,B2,"ALMONTE, GABRIEL",2,1,1
8589,2044550019,BX,2432 HERING AVENUE,01,B3,LORENZA DEBELLIS,3,2,1
8590,2044810118,BX,2563 WOODHULL AVENUE,01,A5,"PERTAB, GAITRI",2,1,1
8591,2044920040,BX,2574 TIEMANN AVENUE,01,B3,"CARABALLO, ANA D",2,1,1
8592,2045320011,BX,2712 MORGAN AVENUE,01,B2,"COLEMAN THOMPSON, ANDREA A",2,1,1
8593,2046140003,BX,1111 BURKE AVENUE,08,M1,TRINITY FAITH PENTECOSTAL CHURCH OF GOD,2,1,1
8594,2046670059,BX,710 EAST 220 STREET,02,C2,220 HOLDING LLC,2,1,1
8595,2046760068,BX,848 EAST 218 STREET,01,A1,"CRUZ, JANICE R",2,1,1
8596,2047940043,BX,2816 WICKHAM AVENUE,01,A2,"GOMEZ, ROCIO",2,1,1
8597,2048310045,BX,4053 LOWERRE PLACE,01,B1,"ACOSTA, DELVIS F",2,1,1
8598,2048440013,BX,753 EAST 230 STREET,01,A1,"SUKHDEO, YAGEETE",2,1,1
8599,2048490025,BX,821 EAST 224 STREET,02,C0,MAIN PROPERTIES 101 CORP.,2,1,1
8600,2049730025,BX,3938 MULVEY AVENUE,07,G2,"EKN REALTY, LLC",2,1,1
8601,2050290005,BX,2084 PITMAN AVENUE,01,A5,"SARGEANT, MAREENE",2,1,1
8602,2050490029,BX,4310 DIGNEY AVENUE,01,A1,JOSEPH ANTHONY P,3,2,1
8603,2051040005,BX,4809 ROBERTSON STREET,01,A1,SUKHRA  SEERAM,2,1,1
8604,2051190016,BX,4816 MURDOCK AVENUE,02,C0,MITCHELL KINGSLEY,2,1,1
8605,2051410120,BX,2049 BARTOW AVENUE,03,D4,RIVERBAY CORPORATION,251,250,1
8606,2053270019,BX,1114 CLARENCE AVENUE,01,B9,"TARTARONE, VINCENT",2,1,1
8607,2053660028,BX,3060 CODDINGTON AVENUE,01,A1,LEE THOMAS,2,1,1
8608,2054110270,BX,1528 DWIGHT PLACE,01,B2,HASIME BERISHAJ,2,1,1
8609,2054400025,BX,552 EDISON AVENUE,01,A1,"CARMODY, NICHOLAS",2,1,1
8610,2054650025,BX,1015 DEAN AVENUE,01,A1,ANTHONY CATTANO,2,1,1
8611,2054760030,BX,711 WILCOX AVENUE,01,A1,KENNETH KNAPP,2,1,1
8612,2055460057,BX,846 SWINTON AVENUE,01,A1,"ACEVEDO, MICHELLE",2,1,1
8613,2056310056,BX,19 FORDHAM STREET,01,A2,"GARCIA, FAUSTINO",2,1,1
8614,2059120013,BX,4759 HENRY HUDSON PKWY W,08,M1,RIVERDALE PRESBYTERIA,5,4,1
8615,3001950054,BK,161 BERGEN STREET,01,B3,SIM MC LAUGHLIN JR,2,1,1
8616,3003190023,BK,147 COLUMBIA STREET,04,S5,"147 COLUMBIA STREET, LLC",2,1,1
8617,3004090014,BK,78 BUTLER STREET,02,C0,BUTLER STREET DEVELOP,2,1,1
8618,3004560012,BK,11 DENTON PLACE,01,A9,NJK DENTON LLC,2,1,1
8619,3006070001,BK,558 COLUMBIA STREET,09,Q2,NYC DEPARTMENT OF PARKS AND RECREATION,3,2,1
8620,3006810038,BK,216 32 STREET,01,B9,"BARNA, JOHN M/TRUSTEE",2,1,1
8621,3007140052,BK,465 41 STREET,01,B9,"VIVAR, LUZ E",2,1,1
8622,3009580022,BK,616 PRESIDENT STREET,02,C3,"BARAKAT, EBRAHIM",2,1,1
8623,3009690001,BK,283 4 AVENUE,06,E9,GARDEN ESTATES LLC,4,3,1
8624,3010030001,BK,453 3 AVENUE,05,GU,3RD AND 9TH LLC,2,1,1
8625,3011390010,BK,762 DEAN STREET,02,C3,"KANELLOS REALTY, INC.",2,1,1
8626,3011740051,BK,489 ST JOHNS PLACE,08,Y1,FIRE DEPARTMENT OF NEW YORK,3,2,1
8627,3012760032,BK,1270 UNION STREET,01,B9,"LONDON, GEORGE",2,1,1
8628,3012950025,BK,164 CROWN STREET,01,A4,ST PAUL COMMUNITY BAPTIST CHURCH INC,2,1,1
8629,3013300034,BK,404 LEFFERTS AVENUE,04,S4,JEAN LUC GUERRIER,3,2,1
8630,3014390069,BK,2087 DEAN STREET,01,B1,"FORD, PAMELLA R",2,1,1
8631,3014390071,BK,2081 DEAN STREET,02,C3,"CULPEPPER, RANDALL",2,1,1
8632,3014500001,BK,2171 BERGEN STREET,04,D7,CB MOTHER GASTON LLC,2,1,1
8633,3015200044,BK,112 THOMAS S BOYLAND ST,02,C0,EVERALD COLLINS,2,1,1
8634,3015790008,BK,17 MARCUS GARVEY BLVD,04,S4,PHARMACIA POPULAR INC,3,2,1
8635,3016160097,BK,859 GREENE AVENUE,04,C7,THELMA JOHNSON REVOCABLE TRUST,2,1,1
8636,3016230044,BK,1272 BROADWAY,05,K2,"ACTIE , SAMUEL",2,1,1
8637,3017680078,BK,145 HART STREET,02,C0,BEC CONTINUUM HOUSING DEVELOPMENT FUND C OMPANY INC,2,1,1
8638,3018180039,BK,282 MONROE STREET,02,C0,"CALDWELL, FERRIS",2,1,1
8639,3019590050,BK,394 VANDERBILT AVENUE,02,C2,394-396 VANDERBILT AVE NY CORP.,2,1,1
8640,3020100053,BK,532 CLINTON AVENUE,11,V0,532 CLINTON LLC,2,1,1
8641,3022130054,BK,235 PENN STREET,04,S2,CONG KAHAL BETH DAVID,2,1,1
8642,3023210032,BK,217 NORTH 7 STREET,01,A1,"JACK P. COOK, JR., TRUSTEE",2,1,1
8643,3023420027,BK,97 NORTH 4 STREET,02,C3,"FRIEDEN, RON",2,1,1
8644,3025320011,BK,102 HURON STREET,02,C1,102-104 HURON STREET LLC,2,1,1
8645,3025320031,BK,142 HURON STREET,01,B9,142 HURON LLC,2,1,1
8646,3026250040,BK,130 DIAMOND STREET,03,D1,HEB DIAMOND LLC,2,1,1
8647,3027210047,BK,19 RICHARDSON STREET,11,V0,19 RICHARDSON STREET LLC,2,1,1
8648,3027310022,BK,42 RICHARDSON STREET,01,B9,SORIANO JOSEPHINE T,2,1,1
8649,3027620001,BK,560 LORIMER STREET,02,C0,560 LORIMER REALTY LLC,2,1,1
8650,3027620017,BK,632 METROPOLITAN AVENUE,01,B9,"632 METROPOLITAN AVENUE, LLC",2,1,1
8651,3027730025,BK,132 AINSLIE STREET,01,B9,132 AINSLIE LLC,2,1,1
8652,3027770030,BK,191 POWERS STREET,01,B9,IRENE GONZALEZ,2,1,1
8653,3030420010,BK,102 SCHOLES STREET,02,C1,102 SCHOLES STREET LLC,2,1,1
8654,3030880024,BK,95 SEIGEL STREET,02,C1,"95 SEIGEL, LLC",2,1,1
8655,3032630010,BK,4 KOSSUTH PLACE,02,C0,B&R MANAGEMENT LIMITED PARTNERSHIP,2,1,1
8656,3032750028,BK,80 HIMROD STREET,01,B3,"MORALES , PETER",2,1,1
8657,3032800037,BK,158 WYCKOFF AVENUE,04,S4,"BOLOGNA, MARIO",2,1,1
8658,3033500041,BK,139 WOODBINE STREET,01,B2,139 BUYERS GROUP LLC,2,1,1
8659,3035100042,BK,28 TAPSCOTT STREET,02,C0,"QUILLI, EZEQUIEL S",2,1,1
8660,3035190054,BK,128 BRISTOL STREET,01,B9,"HAMPTON, SHARON",2,1,1
8661,3035510021,BK,735 HOWARD AVENUE,01,B1,"CLARKE, LEONIS F",2,1,1
8662,3035680019,BK,261 LEGION STREET,01,B1,ERICA NORRIS,2,1,1
8663,3036280014,BK,603 OSBORN STREET,01,B1,PARTNERS3 CORP.,2,1,1
8664,3039580009,BK,199 SHEPHERD AVENUE,01,B1,"CABRAL-PENA, JUAN O",2,1,1
8665,3040130019,BK,362 JEROME STREET,01,B9,HUBERT ELLIS,2,1,1
8666,3040420007,BK,419 VAN SICLEN AVENUE,04,S2,WAYNE WILSON,2,1,1
8667,3040810016,BK,687 CLEVELAND STREET,02,C0,WINNIFRED STANISLAUS,2,1,1
8668,3041030043,BK,40 CHESTNUT STREET,01,B2,"HAYES, LESLIAN",2,1,1
8669,3042910021,BK,721 DREW STREET,01,A2,"OGANDO, CARLOS J",2,1,1
8670,3043160062,BK,703 ESSEX STREET,01,B1,"GYATSO, DELEK",2,1,1
8671,3045190007,BK,1462 LORING AVENUE,01,A9,"MANGIARACINA, ANTONINO",2,1,1
8672,3046050019,BK,54 EAST 52 STREET,02,C2,"RUTLAND CORNERS, LLC",2,1,1
8673,3046400016,BK,120 EAST 54 STREET,02,C0,THE JANIS COPPIN-BYNOE LIVING TRUST,3,2,1
8674,3047760028,BK,534 EAST 56 STREET,01,B1,IACONETTI MARY C,2,1,1
8675,3048710020,BK,138 EAST 35 STREET,01,A1,JOSEPH PIERRE,2,1,1
8676,3048760012,BK,122 EAST 40 STREET,01,B2,JOCELYN NAZAIRE,2,1,1
8677,3049340064,BK,487 EAST 34 STREET,01,B1,"CHARLES, AUDREY",2,1,1
8678,3049500029,BK,590 EAST 34 STREET,01,A1,"GILL, RAQUEL",2,1,1
8679,3049570012,BK,1228 ALBANY AVENUE,01,B2,MCEWEN VERONICA M,2,1,1
8680,3050870040,BK,144 LINDEN BOULEVARD,01,B1,"CLARKE, BARRY",2,1,1
8681,3051030093,BK,29 SNYDER AVENUE,08,W9,NYC DEPARTMENT OF EDUCATION,2,1,1
8682,3051790043,BK,494 EAST 16 STREET,01,A1,"BICKFORD, LOUIS",2,1,1
8683,3051990037,BK,1305 NEWKIRK AVENUE,04,S9,"NEWKIRK EQUITIES, LLC",4,3,1
8684,3052300018,BK,563 EAST 28 STREET,01,A1,ANDRE AUGUSTIN,2,1,1
8685,3052410048,BK,762 EAST 21 STREET,01,B3,JANICE AND JOHN RICARD LIVING TRUST,2,1,1
8686,3052910025,BK,3719 FT HAMILTON PARKWAY,07,G2,"GOLDBERG, GERTRUDE",2,1,1
8687,3053650058,BK,1547 40 STREET,01,B1,CONGREGATION & YESHIVA NITEI GAVRIEL,2,1,1
8688,3053940027,BK,792 MCDONALD AVENUE,07,G2,792 MCDONALD AVENUE LLC,2,1,1
8689,3054000053,BK,609 OCEAN PARKWAY,01,B2,RABBI MARGULIES FAMILY TRUST,2,1,1
8690,3054020006,BK,814 DITMAS AVENUE,01,B1,"SHIMUNOV, DOVID",2,1,1
8691,3055040062,BK,1739 59 STREET,01,A9,"BERGMAN, JOSEPH",2,1,1
8692,3055150011,BK,2112 59 STREET,01,A1,"WEBER, MAYER",2,1,1
8693,3055540037,BK,1874 65 STREET,01,B3,"DIOGUARDI, JOHN",2,1,1
8694,3055760060,BK,1771 BAY RIDGE AVENUE,02,C0,"HUANG, XIAO TING",2,1,1
8695,3055917501,BK,1053 42 STREET,02,R3,UNAVAILABLE OWNER,3,2,1
8696,3056880067,BK,1025 57 STREET,02,C0,"FRIEDMAN, CHAIM",2,1,1
8697,3057020040,BK,5808 11 AVENUE,04,S1,CONGREGATION SHAAR EPHRAIM,2,1,1
8698,3058850003,BK,7039 COLONIAL ROAD,01,B1,MHK REALTY DEVELOPMENT LLC,2,1,1
8699,3058890057,BK,169 72 STREET,01,B1,HUI QUEN OU,2,1,1
8700,3058990069,BK,639 72 STREET,01,B2,"CHEN, YIZHU",2,1,1
8701,3059300009,BK,416 74 STREET,04,S1,"JOSSELME-NOCHIMSON, ANNE",2,1,1
8702,3059780074,BK,217 80 STREET,01,A1,"GRASSO, CAROLINE A",2,1,1
8703,3059870023,BK,242 80 STREET,01,A3,"STATHOUDAKIS, GEORGE",2,1,1
8704,3059960015,BK,220 81 STREET,01,A4,"HARRAJO, LLC",2,1,1
8705,3062290061,BK,2041 76 STREET,02,C0,"CONTE, GRACE",2,1,1
8706,3062410024,BK,2142 76 STREET,01,B2,"LIU, HOI PING",2,1,1
8707,3062570061,BK,1439 79 STREET,01,B3,"CHUNG, WAI LUN",3,2,1
8708,3062900034,BK,1164 81 STREET,01,A5,"MITILIS, STEPHANIE",2,1,1
8709,3063710037,BK,31 BAY 20 STREET,01,B3,GIUSEPPE D'ONOFRIO,2,1,1
8710,3064020016,BK,137 BAY 17 STREET,02,C0,"ZHANG, TINA",2,1,1
8711,3064410033,BK,1962 BATH AVENUE,05,K1,BATH AVE. INC.,2,1,1
8712,3064960062,BK,781 EAST 8 STREET,01,B2,"781 E 8, LLC",2,1,1
8713,3065170023,BK,1064 EAST 5 STREET,01,A9,"GINDI, DAVID H",2,1,1
8714,3065690063,BK,1367 OCEAN PARKWAY,01,A3,"LOUZ, YOUSSEF",2,1,1
8715,3065780037,BK,1370 WEST 6 STREET,01,B3,ROCHELLE BEER REVOCABLE TRUST AGREEMENT,2,1,1
8716,3065870050,BK,1496 OCEAN PARKWAY,01,B1,"GADEE, MORRIS",2,1,1
8717,3065890034,BK,1456 EAST 8 STREET,02,C0,"ANGEL, VICKI",2,1,1
8718,3066080040,BK,1644 EAST 2 STREET,02,C3,"CHU, ROSEANN",2,1,1
8719,3066090015,BK,1616 EAST 3 STREET,01,A9,"ALAN HADDAD, TRUSTEEE",2,1,1
8720,3066170062,BK,1573 EAST 10 STREET,08,M1,COCNGREGATION BETH MIDRAS YAM HATORAH,2,1,1
8721,3066180011,BK,1614 WEST 13 STREET,01,B2,"NG, VIRGINIA",2,1,1
8722,3066380019,BK,1716 EAST 7 STREET,01,A9,MOISES A BUSSU,2,1,1
8723,3066390051,BK,1767 EAST 7 STREET,01,A1,"SAVDIE, JOSEPH",2,1,1
8724,3066510016,BK,1724 WEST 5 STREET,01,B1,HARRY TRAN,2,1,1
8725,3066590040,BK,1856 EAST 3 STREET,01,B3,"GAMMAL, PAUL",2,1,1
8726,3066660068,BK,1764 EAST 10 STREET,01,A1,EMILE KRAIEM,2,1,1
8727,3066810211,BK,1897 EAST 2 STREET,01,A3,"EDERY , JOSEPH",2,1,1
8728,3066960045,BK,1217 AVENUE I,01,B1,TIBOR GOLDBERGER,2,1,1
8729,3067230056,BK,1181 EAST 12 STREET,01,A5,NATHAN YEHUDA,2,1,1
8730,3067420048,BK,1309 AVENUE N,01,B2,"BINIK, BARRY",2,1,1
8731,3067970037,BK,1760 EAST 15 STREET,01,B2,"CHAN, SO",2,1,1
8732,3068190054,BK,1887 EAST 13 STREET,01,A1,JACK Y. ATTIE,2,1,1
8733,3069940077,BK,3076 CROPSEY AVENUE,07,G4,CROPSEY CONEY ISLAND CORP,2,1,1
8734,3070830025,BK,1942 WEST 5 STREET,02,C0,"LI, WEIHAO",2,1,1
8735,3071080011,BK,526 AVENUE T,01,B1,ADJMI FAMILY LIMITEDPARTNERSHIP OF NEW Y ORK,2,1,1
8736,3071080059,BK,2131 EAST 5 STREET,01,B2,"KASSIN, MAURICE",2,1,1
8737,3071310034,BK,2240 EAST 5 STREET,01,A5,"HARARI, RITTA",2,1,1
8738,3071310070,BK,2181 EAST 4 STREET,01,A1,ELLIOT ELO,2,1,1
8739,3071320035,BK,2164 OCEAN PARKWAY,02,C0,CHIC HOME DESIGNS LLC,2,1,1
8740,3071580022,BK,2278 EAST 7 STREET,01,B1,"JAJATI, JAMIELA",2,1,1
8741,3072330021,BK,2670 COLBY COURT,03,D1,BEACH HAVEN GROUP LLC,2,1,1
8742,3072910125,BK,1235 AVENUE T,01,A9,"MOSSERI, MAURICE",2,1,1
8743,3072930038,BK,1982 EAST 15 STREET,02,C0,HOPE SMITH,2,1,1
8744,3072970078,BK,1927 EAST 18 STREET,01,A1,"RABIAA, SONY",2,1,1
8745,3073050082,BK,1915 EAST 26 STREET,01,A1,"BANISHAY, YAKOV",2,1,1
8746,3074160012,BK,2416 EAST 15 STREET,01,B1,"ALTHKEFATI, YOUSEF",2,1,1
8747,3074160027,BK,2450 EAST 15 STREET,01,A1,"WELLINGTON, ALVIN",2,1,1
8748,3075660001,BK,2021 AVENUE I,01,B2,NATHAN SCHWARTZ,2,1,1
8749,3076070077,BK,1064 EAST 26 STREET,01,A1,MOISE DWEK,2,1,1
8750,3076510059,BK,1394 EAST 34 STREET,01,A1,"MILLER, ERIC",2,1,1
8751,3076760054,BK,1523 EAST 22 STREET,01,A9,PERL STUART,2,1,1
8752,3076790023,BK,3573 BEDFORD AVENUE,01,A1,"GRAZI, EZRA",2,1,1
8753,3076790026,BK,3567 BEDFORD AVENUE,01,A1,"KAHANA, DANIEL",2,1,1
8754,3078490053,BK,1486A EAST 52 STREET,01,A5,"RODRIGUES, MAUDE",2,1,1
8755,3079030059,BK,1436 EAST 59 STREET,01,A9,"JOHNSON-SALMON, NARDA",2,1,1
8756,3079040062,BK,2440 RALPH AVENUE,01,A9,"LE, BICH HANH",2,1,1
8757,3079900016,BK,651 EAST 85 STREET,01,B2,"CAM RE VENTURES I REO, LLC",2,1,1
8758,3081730013,BK,659 EAST 104 STREET,01,B2,"GRANT, AMANDA",2,1,1
8759,3082110041,BK,10310 FLATLANDS AVENUE,01,A5,ALEX WEREMEICHIK,2,1,1
8760,3082280038,BK,10108 AVENUE J,01,B9,"WHITTAKER, WADE",2,1,1
8761,3082610010,BK,9603 AVENUE M,01,B2,"SIMON, SHONDELL",2,1,1
8762,3082950019,BK,1651 EAST 92 STREET,01,B3,ERCOLANO VINCENT,2,1,1
8763,3087410074,BK,225 COLERIDGE STREET,01,A1,"SEVERINOVSKY, EUGENE",2,1,1
8764,3088150001,BK,2702 EMMONS AVENUE,05,K1,2702-2712 EMMONS LLC,4,3,1
8765,4001550028,QN,39-47 44 STREET,01,A5,"SCIALLA, VINCENT N",2,1,1
8766,4002940360,QN,3027 NEWTOWN CREEK,06,E1,HIGO NEU SCHNITZER EAST,7,6,1
8767,4003240016,QN,34-25 9 STREET,02,C2,34-25 9TH STREET REALTY LLC,3,2,1
8768,4003530036,QN,36-44 11 STREET,01,B9,"FARFAN, FERNANDO",2,1,1
8769,4006100040,QN,34-30 34 STREET,01,A3,AIMEE THRASHER,2,1,1
8770,4006140038,QN,31-11 32 STREET,02,C1,AME BRAJAC RENTAL LLC,2,1,1
8771,4006200057,QN,25-49 32 STREET,02,C0,"VIGLIS, MARIKA",2,1,1
8772,4006530052,QN,37-22 ASTORIA BOULEVARD S,04,S9,"PILARINOS, KONSTANTINOS",2,1,1
8773,4006560004,QN,32-83 38 STREET,02,C2,32-83 38TH STREET LLC,2,1,1
8774,4007180018,QN,24-50 46 STREET,06,F4,"JAPD REALTY,",3,2,1
8775,4007830058,QN,22-25 42 STREET,01,A5,"BRIFFA, TERESA M.",2,1,1
8776,4008040058,QN,23-82 38 STREET,01,B3,"DEBI, JASODA",2,1,1
8777,4008220130,QN,35-06 DITMARS BOULEVARD,04,S2,"STELLA KYRIAKIDES, TRUSTEE",2,1,1
8778,4008560045,QN,22-32 27 STREET,01,A1,HASSAN KHALED,2,1,1
8779,4009750133,QN,21-60 80 STREET,01,B1,"DI GRANDE, ROSA",2,1,1
8780,4011030012,QN,24-12 93 STREET,01,B1,"AREVALO, CLEVER M",2,1,1
8781,4012880063,QN,37-37 77 STREET,04,S1,3737 77 ST OWNERS CORP,2,1,1
8782,4013250001,QN,55-11 QUEENS BOULEVARD,08,W3,MOSTAZAFAN FOUNDATION NY,3,2,1
8783,4013490006,QN,69-12 WOODSIDE AVENUE,04,D6,UTOKILEN LLC,2,1,1
8784,4013710078,QN,25-25 97 STREET,01,A5,"PALJOR, PALJOR",2,1,1
8785,4014000014,QN,31-20 89 STREET,01,B1,"BEGUM, MUNNI",2,1,1
8786,4015990044,QN,42-08 JUNCTION BOULEVARD,06,E9,NU WORLD CAPITAL LLC,2,1,1
8787,4016050002,QN,40-04 97 STREET,02,C0,SANTOS  BANEGAS,2,1,1
8788,4016100046,QN,100-06 40 ROAD,02,C1,A & A CAIRA LLC,2,1,1
8789,4016900013,QN,31-10 104 STREET,01,A1,"NUNEZ, RAFAELA",3,2,1
8790,4016930008,QN,106-18 ASTORIA BOULEVARD,01,A2,106-18 ASTORIA LLC,2,1,1
8791,4016990021,QN,32-32 105 STREET,02,C0,"AKTHER, SHAHMINA A",2,1,1
8792,4017020085,QN,32-27 107 STREET,01,B2,BETTY ALMENGOR,2,1,1
8793,4017100034,QN,33-42 96 STREET,01,B1,"LAZO, DAMACIO",2,1,1
8794,4017450003,QN,103-08 35 AVENUE,02,C3,"DAI, XING LONG",2,1,1
8795,4017530043,QN,34-52 110 STREET,01,B1,TAMASAR PRAMPATTY,2,1,1
8796,4018640043,QN,47-11 49 AVENUE,02,C0,"VARGAS, JESUS",2,1,1
8797,4018940027,QN,94-21 55 AVENUE,01,B1,SUK KUM YIP,2,1,1
8798,4019500081,QN,104-03 OTIS AVENUE,02,C0,"SANCHEZ, FRANKLYN A",2,1,1
8799,4019530017,QN,55-14 VAN DOREN STREET,02,C0,"LIN, CHENG LIANG",2,1,1
8800,4019870024,QN,104-62 43 AVENUE,02,C3,CCSD INC.,2,1,1
8801,4020030181,QN,108-19 48 AVENUE,01,B1,"HARTOFILIS, MICHAEL J",2,1,1
8802,4020040016,QN,108-38 48 AVENUE,02,C3,"CHEN, YIMEI",2,1,1
8803,4020130020,QN,112-04 ROOSEVELT AVENUE,01,B3,"MOJICA, LUIS",2,1,1
8804,4023980085,QN,68-15 CLINTON AVENUE,01,B1,"PALIURAS, SPIROS",2,1,1
8805,4024030004,QN,53-25 66 STREET,01,A1,"JOSEPH HENNESSY, AS TRUSTEE",2,1,1
8806,4024750012,QN,82-10 QUEENS BOULEVARD,08,M9,NEW LIFE FELLOWSHIP (INGLESIA NUEVA VIDA ),2,1,1
8807,4024800003,QN,52-71 69 STREET,01,B2,"BERNARD KANG, TRUSTEE",2,1,1
8808,4024850050,QN,73-25 52 AVENUE,01,B3,IZABELA GLOWALA,2,1,1
8809,4024920040,QN,52-46 79 STREET,01,A5,"CHEN, YAN PING",2,1,1
8810,4026940004,QN,57-63 59 STREET,01,B2,"JOHNSON, GARY M",2,1,1
8811,4027390058,QN,58-50 FRESH POND ROAD,01,B2,KURZAWA ANETA,3,2,1
8812,4027580039,QN,62-80 60 ROAD,01,B2,WIESLAW LENARD,2,1,1
8813,4027580073,QN,62-41 60 DRIVE,01,A5,ROBERT WALSH,2,1,1
8814,4028470024,QN,77-20 CALDWELL AVENUE,02,C0,"MUSACCHIA, CARMELO",2,1,1
8815,4028650039,QN,86-29 54 AVENUE,01,A1,"PAN, XING XING",2,1,1
8816,4029060015,QN,54-24 83 STREET,01,A5,"54-24 83RD STREET, LLC",2,1,1
8817,4029550107,QN,70-10 62 AVENUE,02,C0,"SEROWIK, URSZULA",2,1,1
8818,4030000012,QN,84-28 DANA COURT,01,A1,MATTEO S. MANGANO,2,1,1
8819,4030620039,QN,77-15 66 ROAD,01,A1,HARVEY MICHAEL W,2,1,1
8820,4031950027,QN,68-46 LOUBET STREET,01,B3,ETHEL E EAGAN,2,1,1
8821,4033380063,QN,84-19 CUTHBERT ROAD,02,C3,SALVATORE BADALAMENTI,2,1,1
8822,4034030009,QN,453 ONDERDONK AVE,01,A9,EPOCH PROPERTY LLC,3,2,1
8823,4034990034,QN,59-36 PALMETTO STREET,01,B1,"RICE, PATRICK",2,1,1
8824,4035460001,QN,803 WYCKOFF AVENUE,03,D1,801 WYCKOFF LLC,2,1,1
8825,4035530024,QN,16-30 STEPHEN STREET,06,F9,"STOJIC, GEORGE & LENUCA",2,1,1
8826,4036080190,QN,65-60 ADMIRAL AVENUE,01,B2,"MULLEN, WILLIAM W",2,1,1
8827,4036430009,QN,69-22 66 STREET,01,A1,"HOUSTON, ROBERT J",2,1,1
8828,4037320139,QN,65-08 80 AVENUE,01,B3,"ORTA, KHEMIA",2,1,1
8829,4038100002,QN,81-80 COOPER AVENUE,06,E9,COOPER 8200 REALTY LLC,17,16,1
8830,4038170027,QN,79-64 77 AVENUE,01,A5,"JIANG, YUJIE",2,1,1
8831,4038180017,QN,79-46 77 ROAD,01,B3,"GALBERT, KENNETH O JR.",2,1,1
8832,4038280079,QN,78-60 79 PLACE,02,C0,"GENNA, ANTONINO",2,1,1
8833,4039000058,QN,91-31 71 ROAD,01,B3,STEVEN LASZLO,2,1,1
8834,4039390064,QN,119-09 9 AVENUE,01,A9,"BALTZ, CAROLINE",2,1,1
8835,4040000039,QN,13-30 125 STREET,01,B2,"HUERTA, SEGUNDO O",2,1,1
8836,4040240048,QN,10-23 117 STREET,01,A1,"JIANG, JING SEN",2,1,1
8837,4040820035,QN,18-38 121 STREET,01,A0,ELEANOR SCHENK,2,1,1
8838,4042270027,QN,123-08 23 AVENUE,01,B1,"XU, WEI",2,1,1
8839,4044140027,QN,141-01 32 AVENUE,09,Q3,NORTH FLUSHING POOL CLUB INC,2,1,1
8840,4044660012,QN,147-25 2 AVENUE,01,A3,"SHIELDS, MICHAEL",2,1,1
8841,4045770041,QN,161-02 POWELLS COVE BLVD,01,A1,"CHRONIS, KOSTAS",2,1,1
8842,4046290037,QN,145-55 19 AVENUE,01,B3,STANLEY CHIU LAM AS TRUSTEE,2,1,1
8843,4046520009,QN,147-11 19 AVENUE,01,B1,"SHOW, CHIN MEI",2,1,1
8844,4046780041,QN,150-27 14 ROAD,02,C0,"DI DONNA, VITO",3,2,1
8845,4047040067,QN,151-16 17 ROAD,01,A5,GEORGE KARALIS,2,1,1
8846,4048560018,QN,32-05 155 STREET,01,A1,ROMANO  MARY AGNES,2,1,1
8847,4050070009,QN,35-17 149 PLACE,02,C0,"LEE, KWANG C",2,1,1
8848,4050140076,QN,144-47 37 AVENUE,02,C1,PARKVIEW QUEENS LLC,2,1,1
8849,4050370087,QN,133-03 41 AVENUE,02,C1,"CHANG, LI-JEN",2,1,1
8850,4051320004,QN,137-11 BOOTH MEMORIAL AVE,04,O8,XLANG NING,2,1,1
8851,4052030047,QN,45-33 BOWNE STREET,01,A1,"HUNTSBERRY, THOMAS",2,1,1
8852,4052160012,QN,47-14 UNION STREET,01,A5,"KHAN, TARIQ ALI",2,1,1
8853,4052300011,QN,140-32 QUINCE AVENUE,01,B2,TSAO BETTY,2,1,1
8854,4053950020,QN,164-10 SANFORD AVENUE,01,B2,"TOLOZA, RAUL",2,1,1
8855,4054070064,QN,149-27 CHERRY AVENUE,01,B3,"QIU, YU XIANG",2,1,1
8856,4054180036,QN,160-12 43 AVENUE,01,A1,PRAMOD KHANNA,2,1,1
8857,4054610004,QN,162-07 LABURNUM AVENUE,01,B3,SARANTIS  IOANNIS,2,1,1
8858,4055150003,QN,44-09 189 STREET,01,A1,GRACE BRONGO,2,1,1
8859,4057470066,QN,163-23 20 AVENUE,01,A1,"CHA, WILLIAM",2,1,1
8860,4057610029,QN,166-50 21 ROAD,01,A1,"PING NEN LIN, AS TRUSTEE",2,1,1
8861,4057910049,QN,204-05 23 AVENUE,01,A0,"RUVIO, ANTONIO",2,1,1
8862,4057990066,QN,199-03 26 AVENUE,01,A5,"YUKHTMAN , ALINA",2,1,1
8863,4060850025,QN,203-01 35 AVENUE,02,C6,35TH AVE BAYSIDE INC,10,9,1
8864,4060960011,QN,34-12 208 STREET,01,A1,"HARFORD, KEVIN",2,1,1
8865,4062590016,QN,42-41 201 STREET,08,I6,OZANAM HALL OF QUEENS NURSING HOMES INC,4,3,1
8866,4062650020,QN,42-28 205 STREET,01,A1,"SHIN, RICHARD W",2,1,1
8867,4062850004,QN,211-04 43 AVENUE,01,A5,CHENG ZHI WU,2,1,1
8868,4064010040,QN,139-09 58 AVENUE,05,O7,GARDENA HOLDING CO. LLC,2,1,1
8869,4068280021,QN,158-21 78 AVENUE,01,B2,"LIN, MIN",2,1,1
8870,4068600001,QN,159-21 GRAND CENTRAL PKWY,02,C0,"KIEFER, JOHN R",2,1,1
8871,4070180025,QN,167-11 81 AVENUE,01,A0,"MEHIRDEL, IZZATULLAH",2,1,1
8872,4070300006,QN,169-12 81 AVENUE,01,A0,BOONYAM MANOACH,2,1,1
8873,4072010006,QN,75-04 185 STREET,01,A1,"ABDURAKHMANOV, BORIS",2,1,1
8874,4072400064,QN,181-35 TUDOR ROAD,01,A1,"AKBASHEV, ALBERT",2,1,1
8875,4072410049,QN,81-12 SURREY PLACE,01,A1,"LAVIOV, MICHAEL",2,1,1
8876,4073590046,QN,48-15 FRANCIS LEWIS BLVD,01,B2,KALTSAS THEODORE,2,1,1
8877,4074740050,QN,220-55 46 AVENUE,03,D4,220-55 46 AVE OWNERS INC,2,1,1
8878,4076500006,QN,61-04 228 STREET,01,B2,"FUCHS, BENJAMIN",2,1,1
8879,4076500011,QN,61-12 228 STREET,01,B2,MING DA ZHANG,2,1,1
8880,4086180028,QN,85-06 251 STREET,01,A1,"MALEY, PHILIP J",3,2,1
8881,4089000029,QN,88-58 76 STREET,01,B2,"DONG, ZHOU",2,1,1
8882,4089420049,QN,74-19 93 AVENUE,01,B3,"BAIJNATH, NANDRANIE",2,1,1
8883,4089670010,QN,89-04 86 STREET,04,S9,"LEE, JUNG Y",2,1,1
8884,4089750062,QN,94-08 89 AVENUE,01,B2,LUIS&CECILIA RUBIO,2,1,1
8885,4090290037,QN,95-11 89 STREET,01,B9,"KOCHI, AMINUL",2,1,1
8886,4090360020,QN,95-30 94 STREET,01,B3,"CORZO, JORGE",2,1,1
8887,4091850022,QN,102-46 85 DRIVE,10,G0,FATEMA YASMEEN,2,1,1
8888,4091910033,QN,85-56 106 STREET,01,B1,"GALINDO , MIGUEL LOPEZ",2,1,1
8889,4092230001,QN,85-15 115 STREET,01,A1,"FRIEDMAN, DAVID G",2,1,1
8890,4092290008,QN,115-24 MYRTLE AVENUE,04,S3,PL MYRTLE REALTY LLC,2,1,1
8891,4093250051,QN,91-29 115 STREET,02,C0,"KANHAI, LOKENAUTH",3,2,1
8892,4093950001,QN,109-04 95 AVENUE,01,B2,"SINGH, VIKRAMJIT",2,1,1
8893,4094040041,QN,102-03 101 AVENUE,04,K4,"RUPEE REALTY, LLC",3,2,1
8894,4094340022,QN,94-34 117 STREET,01,B3,"HACKETT, NIGEL A",2,1,1
8895,4094390003,QN,94-05 121 STREET,01,B2,JAGNARINE JAGESSAR,2,1,1
8896,4094660042,QN,95-09 125 STREET,01,B3,"HARDIN, HARDAT",2,1,1
8897,4095050123,QN,103-44 102 STREET,01,B1,VINCENT D ALESSIO,3,2,1
8898,4095290058,QN,104-23 106 STREET,01,B2,"PERSAUD, RAFEEZA",2,1,1
8899,4095580001,QN,120-02 103 AVENUE,02,C0,"SPARROW, DENISE C",2,1,1
8900,4095920036,QN,105-54 133 STREET,01,A1,"DEONARIN, MANRICK",2,1,1
8901,4095940022,QN,105-46 135 STREET,01,B3,"BHOOPSINGH, CHANDRAVALI",2,1,1
8902,4095970056,QN,107-47 117 STREET,02,C0,PARBATIE L RAMNATH,3,2,1
8903,4096210008,QN,87-16 135 STREET,02,C3,"PRASHAD, GUYAH",2,1,1
8904,4097250004,QN,148-08 86 AVENUE,01,B3,"RAMPERSAUD, VISHNU",2,1,1
8905,4097360146,QN,143-55 84 DRIVE,08,M1,QUEENS CHRISTIAN REFORMED CHURCH,3,2,1
8906,4097390140,QN,143-53 HOOVER AVENUE,01,A1,LISA RESIDENCE 92830 LLC,2,1,1
8907,4098540001,QN,84-49 164 STREET,04,K4,IN S KIM,2,1,1
8908,4099590111,QN,184-39 HENLEY ROAD,01,A1,"SINGH, MANJIT",2,1,1
8909,4100030082,QN,95-18 REMINGTON STREET,02,C0,"HOSSAIN, ZAKIR",2,1,1
8910,4100590007,QN,147-22 105 AVENUE,01,A1,"LEGACY 105 REALTY, LLC",2,1,1
8911,4101490002,QN,160-07 109 STREET,01,A1,"CURTIS, ALFREDO PERSIVALDO",2,1,1
8912,4101510019,QN,163-44 JAMAICA AVENUE,05,K1,JAMAICA 163RD STREET REALTY LLC,2,1,1
8913,4101690018,QN,107-21 165 STREET,01,B3,"JAMES , ERWIN",2,1,1
8914,4101950173,QN,110-16 169 STREET,01,A1,"REY, JEAN E",2,1,1
8915,4102540007,QN,171-18 108 AVENUE,01,A1,GIBB LESMORE A,2,1,1
8916,4102750094,QN,110-01 176 STREET,01,A1,GLORIA DUNLAP,2,1,1
8917,4103040104,QN,111-35 180 STREET,01,A5,"ARTIS, ANNETTE",2,1,1
8918,4103350013,QN,177-30 106 ROAD,01,B1,BREDWOOD EDGAR,2,1,1
8919,4103710027,QN,185-19 LIBERTY AVENUE,01,B3,"FITZ-HENLEY, CORANE",2,1,1
8920,4104660081,QN,197-29 JAMAICA AVENUE,05,K1,RAMDEHOLL  SOUDESH,2,1,1
8921,4105580008,QN,90-53 208 STREET,01,A1,"CHOWDHURY, SUMA",2,1,1
8922,4106310055,QN,92-09 215 STREET,01,A1,"BARNETT, GERALDINE",2,1,1
8923,4106960054,QN,218-44 94 ROAD,01,A1,AWOSOGBA AUGUSTINE,2,1,1
8924,4108670052,QN,100-31 200 STREET,01,B2,"MAHMUD, DELWAR",2,1,1
8925,4108690030,QN,100-46 203 STREET,01,A1,PATRICIA BLUNT,2,1,1
8926,4109800014,QN,112-35 204 STREET,01,A5,18320 141 AVENUE CORP.,2,1,1
8927,4110010012,QN,205-17 MURDOCK AVENUE,01,A1,"THORNE, PEARL",2,1,1
8928,4110420098,QN,115-10 202 STREET,01,A0,BONNER INGRID,3,2,1
8929,4111010031,QN,215-32 106 AVENUE,01,A1,"KINGSLEY LEWIS, ALBERT",2,1,1
8930,4111200001,QN,217-09 110 AVENUE,01,A1,NYC HOUSING AUTHORITY,2,1,1
8931,4111240031,QN,209-70 111 ROAD,01,A1,"HUBBARD, MELISSA",2,1,1
8932,4111670047,QN,106-04 221 STREET,01,A1,"ALIE, SABRINA T",2,1,1
8933,4111840005,QN,219-11 109 AVENUE,01,A1,QUIANOO ANNA R,2,1,1
8934,4112690028,QN,114-64 226 STREET,01,A5,HAROLD & NANCY SIEGEL,2,1,1
8935,4113570056,QN,133-15 AMBER STREET,01,A1,"FX PROPERTY, LLC",2,1,1
8936,4114160012,QN,149-18 85 STREET,02,C0,"TURCHIO, JACK (TRUST)",2,1,1
8937,4115310044,QN,137-27 95 STREET,01,A1,PERRETTA FRANK,2,1,1
8938,4116060018,QN,109-24 126 STREET,01,A1,"GHIMIRE, YUBARAJ",2,1,1
8939,4116550039,QN,128-07 115 AVENUE,01,B1,"MILLER, KENY",2,1,1
8940,4116870017,QN,116-24 132 STREET,01,A1,"SINGH, VISHAL",2,1,1
8941,4116910032,QN,135-17 FOCH BOULEVARD,01,B1,"BURKE, RAMONA",2,1,1
8942,4117890040,QN,133-18 130 PLACE,01,A1,"ASLAM, NAHEED",2,1,1
8943,4118050028,QN,135-05 118 STREET,01,A1,MYNOR I. RUANO,2,1,1
8944,4119260095,QN,139-30 GLASSBORO AVENUE,01,B3,"MOSBY, CARL A",2,1,1
8945,4119640288,QN,111-35 147 STREET,01,A1,"DHANRAJ, NANDKISHORE",2,1,1
8946,4119860045,QN,115-43 142 STREET,01,A2,"CAVAL, SANDRA",2,1,1
8947,4121430044,QN,153-23 109 AVENUE,01,A2,"RODGERS, CHARLES",2,1,1
8948,4121850001,QN,114-49 SUTPHIN BOULEVARD,08,I9,"THE JOSEPH P. ADDABBO FAMILY HEALTH CENT ER, INC.",2,1,1
8949,4121870008,QN,114-39 155 STREET,01,A1,"MCCORMICK, NAKIA",2,1,1
8950,4121910025,QN,155-38 115 ROAD,01,A1,RUTH CAMPBELL,2,1,1
8951,4122040170,QN,153-60 FOCH BOULEVARD,01,A9,"ODERINDE, OLAKUNLE",2,1,1
8952,4122040263,QN,154-01 118 AVENUE,01,A9,"WALKER, MICHAEL A",2,1,1
8953,4122090157,QN,118-40 155 STREET,01,A9,"DAWKINS, ERIC",2,1,1
8954,4122140023,QN,119-28 155 STREET,01,B3,"CANDO, WILSON",2,1,1
8955,4122710001,QN,129-01 157 STREET,01,A1,"LOPEZ, JOHANNA",2,1,1
8956,4124050147,QN,115-37 174 STREET,01,B3,GLADYS ROSS,2,1,1
8957,4124710003,QN,120-05 179 STREET,01,A5,"WILLIAMS, ROBERT LEE",2,1,1
8958,4126020007,QN,190-14 117 ROAD,01,A1,"CARRINGTON, JEAN L",2,1,1
8959,4126380010,QN,118-34 204 STREET,01,B2,"WHARTON, MICHAEL",2,1,1
8960,4130410035,QN,183-21 141 AVENUE,01,B1,"PETERS, LENNON V",2,1,1
8961,4130410057,QN,140-15 183 STREET,01,B1,"MYKOO, KENNEDY",2,1,1
8962,4130900089,QN,179-26 144 ROAD,01,B3,"ALEXIS, WISLAINE",2,1,1
8963,4131010036,QN,221-26 134 ROAD,01,B2,"CLARKE, STEPHEN L",2,1,1
8964,4131600024,QN,134-17 232 STREET,01,A1,"BRYAN-GORDON, DWAINETTE",2,1,1
8965,4131930052,QN,228-18 MENTONE AVENUE,01,A1,MONICA H HEMMINGS,2,1,1
8966,4132410001,QN,137-44 244 STREET,08,M1,ST PETERS EPIS CHURCH,2,1,1
8967,4134960027,QN,144-19 226 STREET,01,A2,"THOMPSON, NATHANIEL",2,1,1
8968,4135760004,QN,142-20 250 STREET,01,B3,"KINZONI, STACEANN",2,1,1
8969,4136880127,QN,259-53 148 DRIVE,01,B2,FRANCOIS NORMA,2,1,1
8970,4157200091,QN,25-02 HEALY AVENUE,01,B3,SEVEN EIGHT SIX INC.,2,1,1
8971,4157600033,QN,5-19 BEACH 20 STREET,08,I5,FR LAND COMPANY INC,2,1,1
8972,4160380032,QN,4-50 BEACH 65 STREET,01,B3,"ACIAR RUIZ, FERNANDO EFRAIN",2,1,1
8973,4161737501,QN,168 BEACH 101 STREET,02,R2,UNAVAILABLE OWNER,23,22,1
8974,4162150030,QN,211 BEACH 119 STREET,01,B3,"MOONEY, MARY B",2,1,1
8975,4162220039,QN,202 BEACH 127 STREET,01,B3,JAMES P ROCHE,2,1,1
8976,4162290001,QN,119-15 ROCKAWAY BEACH BLVD,04,S1,TENECYK PROFESSIONAL BUILDING LLC,2,1,1
8977,4162420051,QN,512 BEACH 131 STREET,01,B3,"NACCARATO JR., FRANK",2,1,1
8978,4162780042,QN,1-29 BEACH 133 STREET,01,A9,"JAMES W. BRENNAN, AS TRUSTEE",2,1,1
8979,4162880018,QN,141-10 CRONSTON AVENUE,01,A2,KAMIN A GREEN,2,1,1
8980,4162960062,QN,416 BEACH 146 STREET,01,A1,"BAS, KONSTANTIN",2,1,1
8981,5001010086,SI,15 WESTBURY AVENUE,01,A1,ROBERT W BOHNENBERGER,2,1,1
8982,5001020088,SI,404 HENDERSON AVENUE,01,A1,HAROLD F KUFFNER JR,2,1,1
8983,5001430025,SI,410 BARD AVENUE,01,A3,"DETORE, JANINE",2,1,1
8984,5001570137,SI,146 BEMENT AVENUE,01,A1,"BENNETT, JEAN MARIE",2,1,1
8985,5002010053,SI,84 BODINE STREET,01,A1,VERNELLA BROWNE,2,1,1
8986,5002150284,SI,195 JEWETT AVENUE,06,E2,EMANUEL JAY QUINONES,2,1,1
8987,5002510067,SI,273 OAKWOOD AVENUE,01,A2,BLANCHARD KEVIN,2,1,1
8988,5002930071,SI,43 HARTFORD AVENUE,01,A2,"MURPHY, THOMAS",2,1,1
8989,5003740292,SI,77 ELMIRA AVENUE,01,B2,JOHN HARRINGTON,2,1,1
8990,5003870034,SI,1294 FOREST AVENUE,04,S2,SUTHAAM LLC,2,1,1
8991,5004570001,SI,950 JEWETT AVENUE,05,K5,BURGER KING,2,1,1
8992,5004590034,SI,51 SEWARD PLACE,01,A5,"CABAN , WANDA",2,1,1
8993,5005920095,SI,34 ADA PLACE,01,A2,AMELIA RELLA,2,1,1
8994,5006030074,SI,33 GLENWOOD AVENUE,01,A2,"HUANG, ALICE",2,1,1
8995,5006840055,SI,32 COVERLY AVENUE,01,A3,"PATTI, NICHOLAS",2,1,1
8996,5006960322,SI,109 LINCOLN STREET,01,A1,"GURUGE, THUSHARI N",2,1,1
8997,5007370056,SI,555 INGRAM AVENUE,01,A5,IRENE BARRECA,2,1,1
8998,5007590073,SI,183 MOUNTAINVIEW AVENUE,01,A1,"SAHAKANUSH , YUZBASHYAN",2,1,1
8999,5008720042,SI,112 ST JAMES PLACE,01,A1,"D'ARCO, LORI A",2,1,1
9000,5008820041,SI,178 OCEAN TERRACE,01,A3,"RYNDIN, IGOR",2,1,1
9001,5010260067,SI,182 JEWETT AVENUE,01,B2,WALTER MENDEZ,3,2,1
9002,5010420152,SI,153 CORTLANDT STREET,01,A1,CAROLYN ETTINGER,2,1,1
9003,5011240009,SI,139 EATON PLACE,01,B2,ANTHONY J ARROYA,2,1,1
9004,5011670028,SI,361 PULASKI AVENUE,01,A1,"KOENIG, DON",2,1,1
9005,5012570020,SI,219 SOUTH AVENUE,01,A1,"SHEPARD, KENNETH",3,2,1
9006,5012900063,SI,19 KINSEY PLACE,01,A9,"23 KINSEY ASSOCIATES, LLC",2,1,1
9007,5013180123,SI,70 HOLLAND AVENUE,01,A1,W SHODOSKI,2,1,1
9008,5014640001,SI,245 CRYSTAL AVENUE,01,A1,"PARISI, KRISTIE-LYN",2,1,1
9009,5014780199,SI,131 VEDDER AVENUE,02,C0,HARRY E BRUNKEN,2,1,1
9010,5015257502,SI,435/1 WILLOW ROAD EAST,02,R3,NAME NOT ON FILE,33,32,1
9011,5021560067,SI,8 JONES STREET,01,B9,"MAYORAL, YASMIN",2,1,1
9012,5026200103,SI,27 TOWERS LANE,01,A1,EQUITY TRUST COMPANY CUSTODIAN FBO OF JA MES GILL I,2,1,1
9013,5026310026,SI,70 SHELLEY AVENUE,01,A1,"MOTYLEV, IGOR",2,1,1
9014,5026610201,SI,3 CRABBS LANE,01,A2,OKRASZEWSKI JOHN W,3,2,1
9015,5028310018,SI,96 MARYLAND AVENUE,01,A5,RUSSELL WILNER,2,1,1
9016,5029210006,SI,2071 CLOVE ROAD,05,K2,"2071 CLOVE, LLC",9,8,1
9017,5029250432,SI,361 SKYLINE DRIVE,02,C6,CELEBRATION TOWNHOUSE,12,11,1
9018,5030640039,SI,33 LAKEVIEW TERRACE,01,A3,"ARTEMIEVA, LARISSA",2,1,1
9019,5031000003,SI,143 MC CLEAN AVENUE,04,S3,"CHEN, ZHI HUA",3,2,1
9020,5031040068,SI,75 MC CLEAN AVENUE,01,A2,"TSOI, NGO SUET",2,1,1
9021,5031120038,SI,155 CEDAR AVENUE,02,C2,FSA REALTY HOLDING,3,2,1
9022,5031210001,SI,21 ROBIN ROAD,08,P8,OCEAN ROBIN REALTY CORP,2,1,1
9023,5031880008,SI,37 SCRANTON STREET,01,A2,THE LONG THANH VO AND KIM LOAN T. VO IRREVOCABLE TRUST,2,1,1
9024,5032990001,SI,1510 RICHMOND ROAD,05,O2,NST REALTY LLC,3,2,1
9025,5033330044,SI,293 RARITAN AVENUE,01,B2,"KRAJA, ARBEN",2,1,1
9026,5033960043,SI,17 VULCAN STREET,01,A2,"MARCHESE, SALVATORE",4,3,1
9027,5034000020,SI,23 LANSING STREET,01,B2,"RAFAILOV, RASHID",2,1,1
9028,5034050026,SI,31 LANSING STREET,01,A2,YUNES K DOLEH,2,1,1
9029,5035630012,SI,59 HUNTER AVENUE,01,A0,G MANGER,2,1,1
9030,5035920051,SI,80 LINCOLN AVENUE,04,S2,80  LINCOLN  AVENUE,2,1,1
9031,5036710019,SI,115 HAVEN AVENUE,01,A5,CHEN WEI,2,1,1
9032,5041980010,SI,29 4 STREET,01,B3,DAWN VITOLO,2,1,1
9033,5041990013,SI,59 NEW DORP PLAZA,04,S1,CAROL A. MATZA,2,1,1
9034,5042310046,SI,210 BEACH AVENUE,01,B9,"GAGLIA, ANTHONY",2,1,1
9035,5042690001,SI,45 PENN AVENUE,01,B2,45 PENN AVE LLC,2,1,1
9036,5042940038,SI,419 FLINT STREET,01,A1,"VARRIALE, PATRICK",2,1,1
9037,5043090086,SI,62 DALE AVENUE,01,A2,JAMES ALLOCCO,2,1,1
9038,5051260047,SI,20 DENT ROAD,01,A3,UNAVAILABLE OWNER,2,1,1
9039,5051530133,SI,19 MELROSE PLACE,01,A2,JOSEPH TURCHIANO,2,1,1
9040,5051570056,SI,85 TARLEE PLACE,01,B9,"LAWANDY, HANY",2,1,1
9041,5052350030,SI,321 PACIFIC AVENUE,01,A2,"MALDONADO, ADAM",2,1,1
9042,5053150088,SI,69 ROBINSON AVENUE,01,B9,ANTHONY FIORE,2,1,1
9043,5053160016,SI,82 ROBINSON AVENUE,01,A1,MYLES ROBBINS,2,1,1
9044,5053780080,SI,4485 HYLAN BOULEVARD,01,A1,CHRISTINE KAASMANN,2,1,1
9045,5054420170,SI,228 GIFFORDS LANE,01,A2,"PIANTASI, MICHAEL",2,1,1
9046,5055310006,SI,3415 RICHMOND AVENUE,01,B2,"KHALIL, TAMER",2,1,1
9047,5062490214,SI,1006 ANNADALE ROAD,01,A1,"GATTI, MICHAEL",2,1,1
9048,5062690047,SI,237 STAFFORD AVENUE,01,A1,"DAIDONE, JOSEPH",2,1,1
9049,5066800005,SI,107 SEGUINE AVENUE,01,B2,91 SEGUINE AVENUE LLC,2,1,1
9050,5067930003,SI,239 SHARROTT AVENUE,01,A1,HILMI SUKA,2,1,1
9051,5075900058,SI,4439 ARTHUR KILL ROAD,04,S1,GT STORAGE CORP.,2,1,1
9052,5078540031,SI,7254 AMBOY ROAD,05,K1,7254 AMBOY REALTY CORP,2,1,1
9053,5080030014,SI,5463 ARTHUR KILL ROAD,01,B2,CECIL L THOMAS,2,1,1
9054,5080050166,SI,91 HOPPING AVENUE,01,A1,EDWARD J. ROBISKY IRREVOCABLE TRUST,2,1,1
9055,5080280100,SI,459 CRAIG AVENUE,01,A5,"AMENDOLA, JACQUELINE",2,1,1
9056,5080410037,SI,227 BARNARD AVENUE,01,A1,THERESA D PAGLIUCO,3,2,1
9057,1000180100,MN,56 GREENWICH STREET,10,G1,MTA - BRIDGES AND TUNNELS,3,2,1
9058,5080470005,SI,7497 AMBOY ROAD,01,A1,"KISH, ANNA",2,1,1
9059,1002000006,MN,78 MULBERRY STREET,04,C7,EIGHTY MULBERRY CP,2,1,1
9060,1003720005,MN,22 AVENUE C,02,C1,"18-22 AVENUE C REALTY,",2,1,1
9061,1004070041,MN,539 EAST 13 STREET,02,C4,DORA COLLAZO PLAZA LTD.PARTNERSHIP,2,1,1
9062,1005880037,MN,48 BARROW STREET,01,B2,"MALANOSKI, MARY L",2,1,1
9063,1006060041,MN,138 WEST 11 STREET,01,A4,"138-140 W 11 STREET HOLDINGS, LLC",2,1,1
9064,1006410062,MN,343 WEST 12 STREET,02,C6,343 W 12 ST 0WNERS CORP,2,1,1
9065,1007220031,MN,409 WEST 24 STREET,02,C4,NEW 24 LLC,3,2,1
9066,1008230043,MN,168 5 AVENUE,05,O5,168 5 AVE RLTY CORP,2,1,1
9067,1010600154,MN,448 WEST 51 STREET,01,A5,"CUSUMANO, DINO",2,1,1
9068,1011090030,MN,WEST 52 STREET,07,T2,NYC DEPARTMENT OF SMALL BUSINESS SERVICES,2,1,1
9069,1014130016,MN,1120 LEXINGTON AVENUE,04,K4,"78 COMPANY, LLC.",3,2,1
9070,1021520031,MN,281 AUDUBON AVENUE,08,M1,PENTECOSTAL CHRCH FETAL,3,2,1
9071,1021870007,MN,3859 9 AVENUE,06,E1,FLAIR BEVERAGE CORP,4,3,1
9072,1022440100,MN,5141 BROADWAY,08,I1,THE PRESPYTERIAN HOSP,2,1,1
9073,2023790140,BX,778 ELTON AVENUE,02,C0,"DIALLO, SALIMATOU",2,1,1
9074,2025660055,BX,758 EAST 138 STREET,04,K4,SAJI BUSINESS CORP,2,1,1
9075,2026890011,BX,860 WESTCHESTER AVENUE,08,M1,CHRISTIAN CHURCH JOHN,2,1,1
9076,2027660291,BX,650 WHITTIER STREET,06,E1,L R REALTY INC,2,1,1
9077,2032730225,BX,625 EAST FORDHAM ROAD,05,O7,"625 FORDHAM, LLC",2,1,1
9078,2033010090,BX,2785 BRIGGS AVENUE,01,B2,"RAMDYAL , SABRINA",2,1,1
9079,2033740042,BX,281 EAST 233 STREET,07,G5,HESS REATIL STORES LLC,2,1,1
9080,2034290209,BX,600 HARDING PARK,01,A1,"KEY, NANCY",3,2,1
9081,2037020101,BX,890 ZEREGA AVENUE,06,F5,CUMMINS INC,2,1,1
9082,2037740062,BX,1235 WARD AVENUE,02,C0,SANTOS JOUBERT,2,1,1
9083,2037840030,BX,1279 COMMONWEALTH AVENUE,02,C3,DEOCHAND  KESHWAR,2,1,1
9084,2037900073,BX,1933 WATSON AVENUE,02,C0,"RIYADH, ABDULLAH AL",2,1,1
9085,2038480111,BX,1354 HERSCHELL STREET,01,B3,"SANTIAGO , VENUS",2,1,1
9086,2039310032,BX,1950 MCGRAW AVENUE,04,S1,RS MCGRAW INC.,2,1,1
9087,2040160043,BX,1720 ADAMS STREET,01,B1,"GOLDSCHMIED, STEVEN",2,1,1
9088,2044510046,BX,1050 ALLERTON AVENUE,04,K4,1050 ALLERTON AVE LLC,3,2,1
9089,2044770054,BX,2413 EASTCHESTER ROAD,01,A1,"STEFANELLI, MARIO",2,1,1
9090,2045300041,BX,2757 SEYMOUR AVENUE,02,C0,"NWAOHUOCHA, LOVE",2,1,1
9091,2045640056,BX,2798 SEXTON PLACE,01,A1,"SCARLETT, DIONNE",2,1,1
9092,2046560027,BX,670 EAST 222 STREET,02,C0,"GRULLON, SHEYNE G",2,1,1
9093,2046560060,BX,669 EAST 221 STREET,01,B3,"REYES, ELEUTERIA M",2,1,1
9094,2046670036,BX,727 EAST 219 STREET,02,C0,"REYES, MIGUEL F",2,1,1
9095,2047050011,BX,1119 EAST GUN HILL ROAD,05,H4,"SHRI SIDHDHY VANAYAK,INC",2,1,1
9096,2047170069,BX,3606 EASTCHESTER ROAD,01,B9,"DE LA CRUZ, SOVEIDA MARTE",2,1,1
9097,2048430083,BX,768 EAST 230 STREET,02,C0,"WEISS, JONATHAN",2,1,1
9098,2048880009,BX,1313 EAST 222 STREET,08,M1,SMR 222 LLC,3,2,1
9099,2050260051,BX,4107 HILL AVENUE,02,C0,"O'BRIEN-HAYES, DULCINA",2,1,1
9100,2050380055,BX,4352 MATILDA AVENUE,01,B2,"BHOLA, ROHAN",2,1,1
9101,2050810074,BX,4555 WHITE PLAINS ROAD,04,S4,"BOODRAM, SHYAM S",3,2,1
9102,2053610023,BX,1322 HOBART AVENUE,01,B1,"SENZAMICI, DOMINICK",2,1,1
9103,2053670010,BX,1362 HOLLYWOOD AVENUE,01,B3,"TESHOME, MERDOKIYOS T",2,1,1
9104,2054140107,BX,3276 RADIO DRIVE,01,A2,"LAW, WILLIAM T.",2,1,1
9105,2055180028,BX,4147 THROGS NECK EXPWY,07,G3,THROGS NECK PETRO REALTY LLC,2,1,1
9106,2055180104,BX,3105 WISSMAN AVENUE,01,A2,"RIEGER, JOHN",3,2,1
9107,2055900072,BX,241 REVERE AVENUE,01,A1,"ANDREWS, DEWEY",2,1,1
9108,2056270007,BX,26 SCHOFIELD STREET,01,A1,ARTHUR DIETZ,2,1,1
9109,2056290125,BX,48 HAWKINS STREET,02,C0,"DONAHUE ADLER, NADIA",3,2,1
9110,2056430045,BX,151 CAROLL STREET,01,B2,SEA BREEZE DEVELOPMENT CORP.,2,1,1
9111,2056440015,BX,154 BAY STREET,01,A2,"ALLIE, DIANNE M",2,1,1
9112,2056460023,BX,485 MINNIEFORD AVENUE,01,B9,"BOCKINO, RALPH J JR",3,2,1
9113,2057860237,BX,3221 OXFORD AVENUE,02,C0,ANN DORMIA,3,2,1
9114,2058343001,BX,6255 BROADWAY,03,D1,6255 RIVERDALE LLC,2,1,1
9115,3003660057,BK,45 3 PLACE,01,A9,"45 ST. NICK, LLC",2,1,1
9116,3004320015,BK,525 UNION STREET,06,F5,SACKETT RIVER LLC,2,1,1
9117,3006340018,BK,192 18 STREET,02,C0,"MILL, DANIEL",2,1,1
9118,3006370017,BK,194 19 STREET,02,C2,VERGARA-PONCE REALTY LLC,2,1,1
9119,3007220038,BK,4210 3 AVENUE,04,S2,ROBERT GARDYN,2,1,1
9120,3008660049,BK,5924 8 AVENUE,04,K4,HING WONG INC,3,2,1
9121,3010490072,BK,297 16 STREET,01,B3,ANN NEWLAND,2,1,1
9122,3012710015,BK,726 EASTERN PARKWAY,01,B9,GOROVITZ CHANA D,2,1,1
9123,3012760067,BK,1217 PRESIDENT STREET,01,B9,"JOSEPH, SOFER",2,1,1
9124,3013240042,BK,17 BALFOUR PLACE,01,A4,BARRY DOV STEINMETZ,2,1,1
9125,3013660079,BK,1351 PARK PLACE,01,B9,"MCGHEE, MARIA  L",2,1,1
9126,3013880040,BK,280 TROY AVENUE,02,C0,"BEULAH CHURCH OF THE NAZARENE, INC.",2,1,1
9127,3014090058,BK,1703 CARROLL STREET,02,C3,132-37 217 STREET CORP.,2,1,1
9128,3015520036,BK,2200 FULTON STREET,01,B1,FULTON ESTATE 26 LLC,2,1,1
9129,3015660040,BK,34 GUNTHER PLACE,01,B9,"SHABAZZ, ROBERT",3,2,1
9130,3015720026,BK,84 SACKMAN STREET,01,B9,"VASQUEZ, CARMEN",2,1,1
9131,3016140065,BK,751 GREENE AVENUE,02,C1,SELDON GROUP LLC,2,1,1
9132,3016400007,BK,544 MONROE STREET,02,C0,ASQUITH GRIFFITH,3,2,1
9133,3017090006,BK,41 ROCHESTER AVENUE,01,B3,"NELSON, KENYATTA",2,1,1
9134,3017160048,BK,42 WALWORTH STREET,06,E1,GBW BUILDING CORPORATION,2,1,1
9135,3018130018,BK,416 GATES AVENUE,08,M9,GATES AVE. HOLDINGS LLC,4,3,1
9136,3018710039,BK,434 HERKIMER STREET,01,B1,HAZELTEEN O. LEWIS,2,1,1
9137,3019700060,BK,71 QUINCY STREET,02,C0,"71 QUINCY ST., NYC, LLC",3,2,1
9138,3020140022,BK,956 FULTON STREET,,Z9,USPS,2,1,1
9139,3020440076,BK,124 ADELPHI STREET,01,B2,"AZULAI, ALLON",2,1,1
9140,3020730001,BK,199 CARLTON AVENUE,02,C3,"CHAMPAGNE, MICHAEL",3,2,1
9141,3020880001,BK,100 WASHINGTON PARK,09,Q1,NYC DEPARTMENT OF PARKS AND RECREATION,5,4,1
9142,3021690015,BK,461 BEDFORD AVENUE,02,C3,"461-B, LLC",3,2,1
9143,3024870048,BK,111 DUPONT STREET,02,C2,EIN OID LLC,2,1,1
9144,3025520014,BK,232 JAVA STREET,06,F5,"FA HOLDING, LLC",2,1,1
9145,3029510045,BK,213 MEADOW STREET,06,E9,MEADOW ST RLTY CORP,2,1,1
9146,3031990007,BK,71 IRVING AVENUE,02,C2,H RANCH LLC,2,1,1
9147,3035520014,BK,183 GRAFTON STREET,01,B1,"LIN , FANG PING",2,1,1
9148,3038050031,BK,464 PENNSYLVANIA AVENUE,01,B1,484 ROCKAWAY LLC,2,1,1
9149,3038660122,BK,649 SNEDIKER AVENUE,01,A5,"CUMMINGS-VIALVA, ALLISON W",2,1,1
9150,3039800006,BK,247 SCHENCK AVENUE,01,B3,3XA PRODUCTIONS INC.,2,1,1
9151,3040420006,BK,421 VAN SICLEN AVENUE,01,B1,421 VAN SICLEN HOLDINGS LLC,2,1,1
9152,3041190059,BK,314 ETNA STREET,01,B1,WAZID HAMESHWA B,2,1,1
9153,3041400024,BK,234 RICHMOND STREET,01,B2,"PERDOMO, JOHN",2,1,1
9154,3044540019,BK,434 ATKINS AVENUE,01,A1,"EVANS, ANCEL",2,1,1
9155,3046940074,BK,476 EAST 98 STREET,04,S3,"CAMPBELL, ELAINE",2,1,1
9156,3047040024,BK,184 EAST 57 STREET,01,B1,"HOLLINGS, LAWRENCE JR.",2,1,1
9157,3047250028,BK,398 EAST 54 STREET,01,B1,"MARSHALL, DONNA I",2,1,1
9158,3047690008,BK,4818 CLARENDON ROAD,01,A5,NY 308 LINDEN CORP,2,1,1
9159,3048740051,BK,211 EAST 37 STREET,01,B1,SMALLWOOD CAROLYN,2,1,1
9160,3048950031,BK,236 EAST 42 STREET,01,B3,"CARROLL, EVELYN",2,1,1
9161,3049330035,BK,3323 CLARENDON ROAD,01,A9,"AIME, MARC J",2,1,1
9162,3049710005,BK,3714 AVENUE D,08,M1,ST PAULS M E CH VAND,3,2,1
9163,3050000015,BK,1473 BROOKLYN AVENUE,02,C0,"BICKEL, JACOB",2,1,1
9164,3051100017,BK,2402 SNYDER AVENUE,01,A9,2402 SNYDER AVENUE LLC,2,1,1
9165,3051890065,BK,343 EAST 23 STREET,01,A1,COPE PROBYN W,2,1,1
9166,3052450022,BK,665 EAST 24 STREET,01,B3,SITORUS FAMILY RESIDENCE TRUST,2,1,1
9167,3052600005,BK,71 MCDONALD AVENUE,02,C0,"ANGEELIS, L.P.",2,1,1
9168,3053630053,BK,1563 42 STREET,08,M1,CONGREGATION AFSEI ORETZ,2,1,1
9169,3053890092,BK,577 EAST 5 STREET,01,B1,CONGREGATION TZEMACHDUVID DINVER BETHMED RSH,2,1,1
9170,3054200043,BK,208 WEBSTER AVENUE,02,C0,"BRACH, HADASSAH  R",2,1,1
9171,3054310052,BK,1561 45 STREET,01,B1,HANNAH L. TRAUBE,2,1,1
9172,3054600061,BK,1733 51 STREET,01,B1,1733 51ST DEVELOPMENT LLC,2,1,1
9173,3054660066,BK,1659 52 STREET,01,A1,"BRODT, HALINA",2,1,1
9174,3054710062,BK,1535 53 STREET,01,A1,"KAUFMAN, HAROLD",3,2,1
9175,3054720012,BK,1606 52 STREET,02,C0,"FREIER, TZVI DAVID",2,1,1
9176,3054780074,BK,1635 54 STREET,01,B2,"PILLER, PINCHUS",2,1,1
9177,3054940040,BK,1830 55 STREET,01,B2,"DIAMANT, LEAH",2,1,1
9178,3055080062,BK,2139 59 STREET,01,A9,"OSTREICHER, ELIEZER",2,1,1
9179,3055460033,BK,1752 64 STREET,02,C0,UNAVAILABLE OWNER,2,1,1
9180,3055890044,BK,4012 13 AVENUE,05,K1,"SHOUELA, ISAAC",2,1,1
9181,3056380071,BK,911 50 STREET,01,B1,105 ENTERPRISES LLC,2,1,1
9182,3056540056,BK,1143 52 STREET,01,B1,"BRODT, MOSHE",2,1,1
9183,3056700055,BK,1365 54 STREET,02,C0,"SCHLOSSER, BERTHA",2,1,1
9184,3056860068,BK,825 57 STREET,04,O8,"LONG XING REALTY, LLC",2,1,1
9185,3057090019,BK,1030 59 STREET,01,B2,"PETRELLA, JOSEPH",3,2,1
9186,3058770053,BK,6914 FT HAMILTON PARKWAY,04,S2,"LI, TZE FUNG",2,1,1
9187,3059470001,BK,33 77 STREET,01,B2,"TZITZIKALAKIS, GEORGE",2,1,1
9188,3061240053,BK,121 97 STREET,01,B3,"KAMBESELES, ELENI",2,1,1
9189,3062000005,BK,7311 13 AVENUE,04,S2,"LEUNG, KING TAI",2,1,1
9190,3062900064,BK,1133 82 STREET,01,B2,"SABATINO, JACQUELINE",2,1,1
9191,3063710084,BK,8678 19 AVENUE,02,C3,"KHUU, VINH",2,1,1
9192,3064960009,BK,718 EAST 9 STREET,01,A9,"BESSON, PATRICIA",2,1,1
9193,3065100025,BK,866 EAST 8 STREET,11,V0,"HADDAD, EDWARD",2,1,1
9194,3065100064,BK,965 EAST 7 STREET,01,A1,SAMUEL MARCOS,2,1,1
9195,3065320036,BK,1256 EAST 7 STREET,01,A9,DAVID WAHBA,2,1,1
9196,3065350064,BK,1153 EAST 9 STREET,01,B2,HOROWITZ  NAFTALI,2,1,1
9197,3065500055,BK,2257 62 STREET,01,A5,"GRUNFELD, EFRIYM",2,1,1
9198,3065640039,BK,1436 EAST 2 STREET,01,B3,"CIUFO, BRIAN R",2,1,1
9199,3065670081,BK,1415 EAST 4 STREET,01,B2,"LI, JAIME",2,1,1
9200,3065890068,BK,1561 EAST 7 STREET,01,A9,"BRODT, STEVEN S",2,1,1
9201,3065900035,BK,1468 EAST 9 STREET,01,B1,1468 EAST 9TH STREET TRUST,2,1,1
9202,3066160007,BK,922 AVENUE O,01,B1,"IMANI, DAN MR.",2,1,1
9203,3066370044,BK,1686 OCEAN PARKWAY,01,B2,"AZIZO, EZRA",2,1,1
9204,3066590059,BK,1839 EAST 2 STREET,01,A3,"SETTON, ALBERT",2,1,1
9205,3066600059,BK,1851 EAST 3 STREET,01,B3,"GOLDSTEIN, ABRAHAM",2,1,1
9206,3066600071,BK,1815 EAST 3 STREET,01,A9,KASSIN SAUL J,2,1,1
9207,3066630010,BK,1782 EAST 7 STREET,01,A1,"LANIADO, MOSHE",2,1,1
9208,3066830078,BK,1895 EAST 7 STREET,01,B1,"BERGMAN, DANIEL",2,1,1
9209,3066830084,BK,1889 EAST 7 STREET,01,B1,JOSE ZONANA,2,1,1
9210,3066890073,BK,19 WALDORF COURT,01,A1,"FRANCA, COLLEEN",2,1,1
9211,3067120081,BK,1450 OCEAN AVENUE,02,C3,TORAH ACADEMY HIGH SCHOOL OF BROOKLYN,2,1,1
9212,3067120083,BK,1456 OCEAN AVENUE,02,C3,"NEZAMOODEEN, TTEE, PHILBERT",2,1,1
9213,3067180064,BK,1057 EAST 16 STREET,01,B2,"ADLER, RAPHAEL",2,1,1
9214,3067330080,BK,1241 EAST 13 STREET,01,A5,ICKOWICS STEVEN,2,1,1
9215,3067827502,BK,2158 OCEAN AVENUE,04,RM,UNAVAILABLE OWNER,2,1,1
9216,3068080031,BK,1766 EAST 26 STREET,01,A1,"ASHUROV, ANATOLY",2,1,1
9217,3068270034,BK,1904 EAST 22 STREET,01,B1,"ILYABAYEV, BENYAMIN",2,1,1
9218,3068950007,BK,2531 HARWAY AVENUE,01,A5,MAN KUI NG,2,1,1
9219,3069960073,BK,2744 WEST 15 STREET,02,C2,HERNANDEZ ARTEMIO,3,2,1
9220,3071310014,BK,2184 EAST 5 STREET,01,B2,"FATIHA, KHEDER",2,1,1
9221,3071310026,BK,2220 EAST 5 STREET,01,B2,"SAVDIE, MARGO",2,1,1
9222,3071320048,BK,2237 EAST 5 STREET,01,A9,ZAKI HABER,2,1,1
9223,3071530070,BK,2245 EAST 1 STREET,01,B1,"CHALOUH, CHARL",2,1,1
9224,3071600070,BK,2337 STILLWELL AVENUE,01,A9,"ZENG, JOYCE MA",3,2,1
9225,3071700024,BK,2482 MCDONALD AVENUE,06,E1,IRON HOLDINGS LLC,2,1,1
9226,3071810044,BK,2359 EAST 5 STREET,01,A2,"HANONO, ELIE",2,1,1
9227,3071840055,BK,53 LANCASTER AVENUE,01,B1,"ZAYTSEV, SERGEY",2,1,1
9228,3072470067,BK,2707 STILLWELL AVENUE,04,S2,SHORE PARKWAY LLC,2,1,1
9229,3072930030,BK,1958 EAST 15 STREET,01,B3,"JMSSDM, CORP.",2,1,1
9230,3073410030,BK,3081 AVENUE U,04,O8,DESTEFANO WILLIAM,2,1,1
9231,3074000078,BK,2299 EAST 15 STREET,01,A1,"PEAY, GREGORY JAMES",2,1,1
9232,3074220236,BK,2123 AVENUE Y,02,C0,HENAO JOSEPH,3,2,1
9233,3074707502,BK,2654 EAST 26 STREET,02,R3,UNAVAILABLE OWNER,3,2,1
9234,3075850037,BK,1053 EAST 21 STREET,01,A1,"FUCHS, LUDVIK",2,1,1
9235,3075880080,BK,3114 BEDFORD AVENUE,01,A1,"ROSENSHEIN, AVRAHAM",2,1,1
9236,3075910035,BK,923 EAST 27 STREET,01,B1,GERALD E SCHWARTZ,2,1,1
9237,3076230049,BK,2320 AVENUE K,01,A1,SANFORD BRAUN,2,1,1
9238,3076280039,BK,1115 EAST 28 STREET,01,A1,MARK KLEIN,2,1,1
9239,3076400047,BK,2212 AVENUE L,01,B2,"AMES, REBECA",2,1,1
9240,3076650018,BK,1369 EAST 29 STREET,01,A1,"GOTTESMAN, DAVID",2,1,1
9241,3076660020,BK,2721 NOSTRAND AVENUE,05,G8,CRYSTAL BAY IMPORTSLTD,2,1,1
9242,3076740082,BK,1584 EAST 21 STREET,01,A9,ELIE CASTRO,2,1,1
9243,3076920051,BK,1524 EAST 31 STREET,01,A5,ODES FAMILY TRUST,2,1,1
9244,3077050013,BK,1669 EAST 32 STREET,01,B1,SIMON ABECASSIS,2,1,1
9245,3077180079,BK,1766 EAST 36 STREET,01,A9,"EREZ, ZVI  YEHUDA",2,1,1
9246,3077470011,BK,1005 EAST 43 STREET,01,A1,"BISHOP, ROSETTA ROBERTS",2,1,1
9247,3077870017,BK,1245 EAST 39 STREET,01,B3,CEPTUS SUZE,3,2,1
9248,3077890020,BK,1901 ALBANY AVENUE,01,A9,"JOSEPH, NIGEL",2,1,1
9249,3078800051,BK,1402 EAST 56 STREET,01,A1,KENNETH JORDAN,2,1,1
9250,3079000072,BK,1560 EAST 56 STREET,01,B1,DECRESCENZO GARY,2,1,1
9251,3079010006,BK,1577 EAST 56 STREET,01,A2,"PALMA, JULIA MARIE",2,1,1
9252,3079010075,BK,1472 EAST 57 STREET,01,A9,"SENTOME, HELEN MARIE",3,2,1
9253,3081870033,BK,9900 GLENWOOD ROAD,01,B2,"MICHEL, ANDRE J",2,1,1
9254,3084500063,BK,2348 EAST 73 STREET,01,B3,"MATOS, LUIS",2,1,1
9255,3084990068,BK,1966 EAST 33 STREET,01,A9,"QIU, LINGE",2,1,1
9256,3085030057,BK,1924 EAST 37 STREET,01,A9,"JASON RICHARDSON TRUST, DATED OCTOBER 21 , 2011",2,1,1
9257,3086720088,BK,3058 BRIGHTON 3 STREET,02,C3,ATRIUS 3058 BRIGHTON L.P.,2,1,1
9258,3087230256,BK,230 CORBIN PLACE,01,B2,"BRODSKY, VADEM",2,1,1
9259,3087340047,BK,145 BEAUMONT STREET,01,A1,"GOFMAN , NELLY",2,1,1
9260,3087530093,BK,161 JAFFRAY STREET,01,A1,"GERSHFELD, VLADIMIR",2,1,1
9261,3087837502,BK,2806 EAST 23 STREET,03,R4,UNAVAILABLE OWNER,2,1,1
9262,3088007501,BK,2827 BROWN STREET,02,R3,UNAVAILABLE OWNER,2,1,1
9263,3088160018,BK,2030 STUART STREET,01,B9,ANOSHKINA ALLA,2,1,1
9264,4003230044,QN,34-40 9 STREET,01,B9,"BOTHOS, DEMETRIOS",4,3,1
9265,4003300016,QN,35-25 10 STREET,01,A2,DESOLA MELODY,2,1,1
9266,4003700035,QN,28-07 38 AVENUE,04,S1,28-07 38TH AVENUE LLC,2,1,1
9267,4005320032,QN,14-32 31 ROAD,01,B3,"SUN, YUEYUAN",2,1,1
9268,4005690027,QN,31-13 23 STREET,02,C1,P & R ASTORIA LLC,3,2,1
9269,4006030025,QN,30-12 35 AVENUE,02,C0,CONSTANTOURIS DINOS,2,1,1
9270,4007150019,QN,25-61 44 STREET,01,B1,25-61 44TH STREET REALTY LLC,2,1,1
9271,4007990063,QN,40-17 21 AVENUE,02,C3,ANLEMACO REALTY LLC,2,1,1
9272,4008080044,QN,21-28 38 STREET,01,B3,"MACKELBURG, KARL",2,1,1
9273,4008230013,QN,21-51 36 STREET,01,B1,"HADJICHARALAMBOUS, COSTAS",2,1,1
9274,4008630012,QN,24-57 24 STREET,01,B1,"SHERMAN, STUART",2,1,1
9275,4008660014,QN,25 STREET,07,U6,UNAVAILABLE OWNER,2,1,1
9276,4013430061,QN,42-26 66 STREET,01,B2,"CHO, EUNG YUN",2,1,1
9277,4013490028,QN,42-02 72 STREET,08,W1,NYC DEPARTMENT OF EDUCATION,3,2,1
9278,4013500027,QN,69-54 43 AVENUE,01,B2,"DOMINGUEZ, BLANCA",2,1,1
9279,4013540032,QN,43-10 74 STREET,02,C0,"CHEN, RU",2,1,1
9280,4013830048,QN,30-47 85 STREET,01,B1,"MARTINEZ, GLADIS",2,1,1
9281,4014240004,QN,32-03 JUNCTION BOULEVARD,04,S1,"SILVA, ONOFRE",2,1,1
9282,4014640048,QN,35-47 90 STREET,02,C0,"LI, JEANNE",2,1,1
9283,4015030067,QN,40-39 GLEANE STREET,01,A1,"ANDREW GOAS, MANUEL",2,1,1
9284,4015240079,QN,42-33 78 STREET,02,C0,42-33 78TH STREET LLC,2,1,1
9285,4016010067,QN,94-23 44 AVENUE,01,B3,"CUZO, MIREYA",2,1,1
9286,4017550084,QN,34-39 111 STREET,01,B1,BIENVENIDA NUNEZ TRUST,2,1,1
9287,4017690091,QN,37-29 103 STREET,04,S4,"YQL REAL PROPERTIES, LLC",2,1,1
9288,4018380017,QN,87-40 52 AVENUE,01,B2,BENSON GIN LUI,2,1,1
9289,4018700006,QN,92-20 54 AVENUE,01,B2,KAUR MANPREET,2,1,1
9290,4019350038,QN,104-53 ALSTYNE AVENUE,02,C0,"WU, ZIWEI",2,1,1
9291,4019890001,QN,104-12 45 AVENUE,01,B2,JAIME ARIAS,2,1,1
9292,4020080032,QN,108-64 52 AVENUE,01,B2,GIOVINAZZO JOSEPH,2,1,1
9293,4020090079,QN,108-33 CORONA AVENUE,04,K4,VERRELLI ALDO,4,3,1
9294,4021090024,QN,99-32 62 DRIVE,01,A3,"ILYAYEVA, STELLA",2,1,1
9295,4021780041,QN,108-49 68 AVENUE,01,A3,"PINKHASOV, DAVID",2,1,1
9296,4022970058,QN,50-44 48 STREET,01,B1,JOSE CAJAMARCA,2,1,1
9297,4023820074,QN,52-62 66 STREET,01,B2,"SUGRUE, DANIEL",2,1,1
9298,4023960058,QN,66-42 HULL AVENUE,01,A9,"MCGARVEY, RAYMOND",2,1,1
9299,4024270001,QN,50-06 69 STREET,05,K1,DELORES GURI,2,1,1
9300,4024480035,QN,48-01 72 STREET,01,B2,"VOLKER, THOMAS M",2,1,1
9301,4026490142,QN,59-80 59 PLACE,01,B3,"FRANKOWSKI, TOMASZ",2,1,1
9302,4027580026,QN,62-52 60 ROAD,01,B2,"D'ERRICO, CYNTHIA  R",2,1,1
9303,4028080067,QN,72-20 57 AVENUE,01,B1,"WONG, ANNA",2,1,1
9304,4028700109,QN,86-24 57 AVENUE,01,B2,"MYINT, THAN",2,1,1
9305,4028790105,QN,85-10 55 ROAD,01,A1,"DIAZ, LUIS A",2,1,1
9306,4030410030,QN,65-59 79 STREET,01,B1,"DUCEY, KATHLEEN",3,2,1
9307,4031580063,QN,66-26 SAUNDERS STREET,01,A5,"FUZAYLOV, BORIS",2,1,1
9308,4033510053,QN,112 82 ROAD,01,A3,ISAKOV NELSON,3,2,1
9309,4033740009,QN,2110 GROVE STREET,04,S2,21-10 GROVE ST CORP,4,3,1
9310,4034680039,QN,678 WOODWARD AVENUE,04,S2,QUEEN B REALTY LLC,2,1,1
9311,4035540018,QN,1618 NORMAN STREET,01,B1,"CHANDLER, JANETTE RAMOS",2,1,1
9312,4035700040,QN,58-58 78 AVENUE,02,C0,JOHN A. RABSATT,2,1,1
9313,4036670200,QN,67-24 METROPOLITAN AVENUE,09,Z8,LUTHERAN CEMETERY,7,6,1
9314,4037820017,QN,79-20 67 DRIVE,02,C0,"MATISI, STEVE  C",2,1,1
9315,4038180043,QN,79-67 78 AVENUE,01,B1,"TRAN, WINN NGUYEN",2,1,1
9316,4038800062,QN,80-07 MARGARET PLACE,01,A5,BARBARA A. STOCK AS TRUSTEE,2,1,1
9317,4040770049,QN,14-56 COLLEGE POINT BLVD,04,S2,CKS REALTY LLC,2,1,1
9318,4042310037,QN,127-18 23 AVENUE,01,B2,"BISWAS, GOUR",2,1,1
9319,4042620051,QN,123-13 26 AVENUE,01,B3,BLANCA MARTINEZ,2,1,1
9320,4043160004,QN,28-29 119 STREET,06,E1,GJINI LLC,2,1,1
9321,4043870001,QN,31-40 WHITESTONE EXPRESSWAY,06,E7,31-40 WHITESTONE EXPRESSWAY LLC,2,1,1
9322,4045050050,QN,149-25 14 AVENUE,07,G2,"RODRIGUEZ, RONALD",2,1,1
9323,4045070022,QN,3-30 CRESTHAVEN LANE,01,B1,"LICHTENBERG, NATHAN",2,1,1
9324,4046300044,QN,145-69 20 AVENUE,01,A2,GIOVANI CONTI,2,1,1
9325,4046630047,QN,149-38 15 ROAD,01,B1,"LEE, DAI YOU",2,1,1
9326,4047040008,QN,151-07 18 AVENUE,02,C0,RICHARD COFFEY,2,1,1
9327,4047210015,QN,15-55 CLINTONVILLE STREET,01,B1,"YIP, CHIM MING",2,1,1
9328,4047850001,QN,144-03 BAYSIDE AVENUE,01,A1,"CHOI, YOUNG T",2,1,1
9329,4047880034,QN,145-20 BAYSIDE AVENUE,08,M1,HAN MA UM ZEN CENTEROF NEW YORK INC,3,2,1
9330,4049770090,QN,136-45 37 AVENUE,04,D6,CIAMPA REALTY II LLC,2,1,1
9331,4050370100,QN,132-27 41 AVENUE,01,B2,"WANG, UN LIN",2,1,1
9332,4051980002,QN,43-41 BURLING STREET,01,A2,BURLING PLAZA LLC,3,2,1
9333,4052180003,QN,142-10 LABURNUM AVENUE,02,C0,"CHEN, XIONG",2,1,1
9334,4052230026,QN,140-45 POPLAR AVENUE,01,A2,"LIU, JOE CHING CHUO",2,1,1
9335,4052410065,QN,33-46 157 STREET,01,A1,RIBAUDO FRANCESCA,2,1,1
9336,4052590054,QN,33-73 190 STREET,01,A1,"DONNELLAN, MARY ELLEN",2,1,1
9337,4052840007,QN,164-07 CROCHERON AVENUE,02,C0,AOP 7 PROPERTIES LLC,2,1,1
9338,4053610046,QN,40-37 196 STREET,01,A2,"RANDALL, CHRISTINE",2,1,1
9339,4053850037,QN,42-16 156 STREET,01,A1,ROBINSON MARGIE D,2,1,1
9340,4054130005,QN,43-59 MURRAY STREET,01,A1,MARIA A P MENDOZA,2,1,1
9341,4056180038,QN,198-14 47 AVENUE,04,S3,"47TH AVENUE/198TH STREET ASSOCIATES, INC .",2,1,1
9342,4059000002,QN,212-15 26 AVENUE,05,K6,CORD MEYER DEVELOPMENT,11,10,1
9343,4060110021,QN,211-12 28 AVENUE,01,A1,"FENDT, JAMES",2,1,1
9344,4060160001,QN,28-55 214 PLACE,01,A1,ROBERT G BASSOLINO,2,1,1
9345,4060430010,QN,32-08 208 STREET,01,A5,"YUI, YUEH HWA",2,1,1
9346,4060540043,QN,29-20 214 STREET,01,A1,CORCORAN  DEBRA,2,1,1
9347,4061020009,QN,34-08 210 STREET,01,A1,"GRIFFITH, FRANKLYN",2,1,1
9348,4061590029,QN,36-46 208 STREET,01,A1,"PANTELATOS, NEOFYTOS N",2,1,1
9349,4061850054,QN,217-01 CORBETT ROAD,01,A1,CHRISTINE VALENTE,2,1,1
9350,4062370035,QN,40-18 BELL BOULEVARD,04,K4,40-18 BELL BLVD REALTY CORP,2,1,1
9351,4062490029,QN,216-19 40 AVENUE,01,B1,"WONG, DANNY",3,2,1
9352,4062880041,QN,214-11 41 AVENUE,04,S9,BAYSIDE RE GROUP LLC,3,2,1
9353,4063910005,QN,135-12 63 AVENUE,01,B3,THEODORE J DVORAK,2,1,1
9354,4063990013,QN,138-14 63 AVENUE,01,B3,PENZOH MENACHEM,2,1,1
9355,4065010045,QN,136-04 64 ROAD,01,A5,"SANTOS, MARIA LIZA JAVIER",2,1,1
9356,4066670045,QN,144-11 77 AVENUE,08,M1,OHEL SARA BUKHURIAN JEWISH CENTER INC,2,1,1
9357,4068050045,QN,72-69 KISSENA BOULEVARD,05,K5,FRED KARMIN,2,1,1
9358,4072520080,QN,184-13 MIDLAND PARKWAY,01,A1,"TSADYK, EGAL",2,1,1
9359,4079180049,QN,232-03 SEWARD AVENUE,01,A3,"BANGIEW, ARON",2,1,1
9360,4080410038,QN,139 ARLEIGH ROAD,01,A3,"NEWTON, PETER",2,1,1
9361,4081400112,QN,41-63 GLENWOOD STREET,01,A1,"DOYLE , BRIAN",2,1,1
9362,4082300294,QN,249-41 BEECHKNOLL AVENUE,01,A1,"GUIDICE-PIZZO, LORRAINE",3,2,1
9363,4083060058,QN,245-57 63 AVENUE,01,A0,LOREN & AUDREY LEVY,2,1,1
9364,4085910006,QN,83-04 249 STREET,01,A1,HARINDER SINGH,2,1,1
9365,4087220208,QN,80-59 266 STREET,01,A2,"BRUZZESE, JOSEPH",2,1,1
9366,4088270008,QN,87-39 259 STREET,01,A1,"RIVAS, RONALD I",2,1,1
9367,4089490052,QN,90-27 75 STREET,01,B2,"SOMAD, TOJAMMIL 0",2,1,1
9368,4090720013,QN,97-13 99 AVENUE,01,B2,"LUIS T. JIMENEZ SAMANIEGO, F/K/A LUIS T. V. JIMNENEZ",2,1,1
9369,4090810056,QN,81-49 102 AVENUE,01,B9,RODOLFO DE LEON A/K/A,3,2,1
9370,4090820042,QN,102-06 84 STREET,06,E1,OLYMPIC REALTY HOLDINGS INC.,2,1,1
9371,4091000053,QN,101-43 93 STREET,01,B2,"SUERO, ANA J",2,1,1
9372,4091490022,QN,105-34 87 STREET,01,A1,"HERNANDEZ, JUAN P",2,1,1
9373,4091500067,QN,105-27 87 STREET,01,A1,"PARKER, KALIN TAKEU",2,1,1
9374,4093010019,QN,87-42 112 STREET,01,B3,VENKAT SAMBAMURTY,2,1,1
9375,4093280082,QN,87-33 118 STREET,01,B2,"THOMPSON, KAMRAJ",2,1,1
9376,4093300055,QN,120-11 89 AVENUE,06,E2,12011 89TH AVE LLC,2,1,1
9377,4094500054,QN,94-34 VAN WYCK EXPRESSWAY,04,S9,JIMMY R. DIAZ,2,1,1
9378,4094580019,QN,95-26 121 STREET,01,A1,YOURAJ PATTY SINGH,2,1,1
9379,4094660026,QN,125-11 97 AVENUE,01,B3,"BROTHERS 2010 REALTY, LLC",3,2,1
9380,4094710036,QN,95-27 129 STREET,01,B3,"ANGELA KIRKLAND-SAUNDERS, TRUSTEE",2,1,1
9381,4095260036,QN,107-08 104 STREET,01,B1,"PARMESHWAR, SUNNY M",2,1,1
9382,4095400002,QN,101-01 ROCKAWAY BOULEVARD,08,W1,NYC DEPARTMENT OF EDUCATION,4,3,1
9383,4095460042,QN,107-68 109 STREET,01,A1,WILLIAM ROMERO,2,1,1
9384,4095480062,QN,107-39 110 STREET,01,A9,"ALAM, IMTEAZ",2,1,1
9385,4095550024,QN,103-34 118 STREET,01,B2,"RODRIGUES, JUANA",2,1,1
9386,4095580010,QN,120-20 103 AVENUE,01,B3,120 20 103 INC,2,1,1
9387,4095710051,QN,104-43 117 STREET,01,B3,"SINGH, JARNAIL",2,1,1
9388,4095790085,QN,104-19 125 STREET,01,B2,DABA EQUITIES LLC,2,1,1
9389,4095830023,QN,105-22 130 STREET,01,A1,"RAMOO, GOPAUL",2,1,1
9390,4095970005,QN,117-10 107 AVENUE,01,B3,EDWARD DOMENECK,2,1,1
9391,4096100048,QN,107-55 130 STREET,01,B3,"FORLADER, CRAIG",2,1,1
9392,4096830011,QN,139-40 88 ROAD,01,B3,"RAHMAN, MD MAHBUBUR",2,1,1
9393,4097090059,QN,86-24 143 STREET,01,B2,FLORO TRIFONIA,2,1,1
9394,4098260037,QN,170-15 88 AVENUE,01,B3,AMADOR TANIA,2,1,1
9395,4098850068,QN,175-60 DALNY ROAD,01,A1,SILVANA M. FALCO,2,1,1
9396,4100740027,QN,143-18 LUX ROAD,01,A1,PRINCESELLA SMITH,2,1,1
9397,4100930001,QN,151-02 JAMAICA AVENUE,08,Z1,NYS DORMITORY AUTH,2,1,1
9398,4102030015,QN,163-40 PHROANE AVENUE,01,B2,FISH AVENUE CORP,2,1,1
9399,4102350326,QN,173-44 105 AVENUE,01,A1,"MCKAY, TERRY",2,1,1
9400,4102990034,QN,111-42 177 STREET,01,A2,ENGLISH PATTERSON,2,1,1
9401,4103340016,QN,177-22 106 AVENUE,01,B1,"ARCHIBONG, DELIA",2,1,1
9402,4104750365,QN,93-32 202 STREET,01,B2,THE FRANCIS FAMILY IRREVOCABLE TRUST,2,1,1
9403,4105460035,QN,94-02 212 STREET,01,A1,"FARHAD, MOHAMMAD EMRAN",2,1,1
9404,4106430004,QN,217-02 91 AVENUE,01,B3,"SIKDER, ASHIK",2,1,1
9405,4108050019,QN,222-32 99 AVENUE,01,A1,EDWIN GOULD SERVICES FOR CHILDREN & FAMI LIES,2,1,1
9406,4108930001,QN,197-02 104 AVENUE,01,B3,NYC HOUSING PRESERVATION AND DEVELOPMENT,2,1,1
9407,4109210053,QN,109-01 210 STREET,01,A1,"DOUGLAS, ALICE M.",2,1,1
9408,4109800057,QN,112-46 205 STREET,01,A5,WILLIE GEORGE JR,2,1,1
9409,4110100053,QN,194-25 114 ROAD,01,A1,WESTON SHANTI,2,1,1
9410,4110150067,QN,114-17 198 STREET,01,A5,ROBERT A BROWN,2,1,1
9411,4110540012,QN,210-48 NASHVILLE BOULEVARD,01,B3,"GIBBS, EUGENE",2,1,1
9412,4110620010,QN,116-28 192 STREET,01,B2,"ZAMRUDEEN, MOHAMED N.",2,1,1
9413,4110760055,QN,116-34 205 STREET,01,B3,FEDERAL HOME LOAN MORTGAGE CORPORATION,2,1,1
9414,4111000037,QN,215-15 106 AVENUE,01,B3,"DE RIGGS, KARL",2,1,1
9415,4111250030,QN,112-07 COLFAX STREET,01,A1,"TROTMAN, LISA M",2,1,1
9416,4111310041,QN,112-32 212 STREET,01,A1,TARA JENKINS,2,1,1
9417,4112330026,QN,216-38 113 DRIVE,01,A1,UNITED STATE AVA,2,1,1
9418,4112340121,QN,216-34 114 AVENUE,01,A1,JAMES BRODY,3,2,1
9419,4113030132,QN,115-67 221 STREET,01,A1,HENDERSON & JANICE CUMMINS,3,2,1
9420,4113220048,QN,116-30 222 STREET,01,B3,PIERRE LUCIEN,2,1,1
9421,4113530082,QN,90-49 SILVER ROAD,01,A1,"MARCELO , MICHELLE  A",2,1,1
9422,4114970145,QN,134-10 97 STREET,01,A1,PASQUALE AMMIRATI,2,1,1
9423,4115520081,QN,97-43 ECKFORD AVENUE,01,A1,"SANTANA, OMAR",2,1,1
9424,4116320024,QN,111-44 128 STREET,01,B3,GARDNER DORNELLA,2,1,1
9425,4116830022,QN,116-34 127 STREET,01,A1,"MCLEAN, MELVIN J",2,1,1
9426,4117470162,QN,117-24 126 STREET,01,A2,FRASER GORDON,2,1,1
9427,4117810260,QN,130-01 135 PLACE,01,A1,"PETER, SATNARINE",2,1,1
9428,4118580029,QN,135-11 124 STREET,01,B2,"JAGDAT, SAVITREE",2,1,1
9429,4119510458,QN,147-18 110 AVENUE,01,B2,"SINGH, CHANDRADAI",2,1,1
9430,4119720157,QN,142-07 115 AVENUE,01,B1,"SAEED, ANWAR",2,1,1
9431,4120080056,QN,116-33 148 STREET,01,A1,KENDRICK JR VERNON,2,1,1
9432,4120500054,QN,123-24 147 STREET,01,A1,"THOMAS, SHARON",2,1,1
9433,4121080055,QN,128-36 150 STREET,01,B3,"RAM, SUCHA",3,2,1
9434,4121640077,QN,160-05 111 AVENUE,01,A1,"JACOBS, LUZ M",2,1,1
9435,4122040261,QN,154-05 118 AVENUE,01,A9,"RUSHMORE JR, WALTER",2,1,1
9436,4122100012,QN,150-31 119 ROAD,01,B2,KENNETH EZEADICHIE,2,1,1
9437,4122110007,QN,119-33 SUTPHIN BOULEVARD,08,M1,BETHEL GOSPEL CHRCH   #A,4,3,1
9438,4122470028,QN,119-54 LONG STREET,01,A1,VERNON M CASH,2,1,1
9439,4123310096,QN,114-46 168 STREET,01,A2,"ROBERTS, SANDRA",2,1,1
9440,4123590017,QN,119-17 164 STREET,01,B3,"GONZALEZ, HILDA",2,1,1
9441,4123640118,QN,11720 168 STREET,01,A1,ROXANNE M HARMON,2,1,1
9442,4126310048,QN,118-01 201 PLACE,01,A1,"WOODRIFFE, CHRISTOPHER",2,1,1
9443,4127030010,QN,122-39 MILBURN STREET,01,A1,"DANIEL, DAVID",2,1,1
9444,4127040038,QN,122-20 BENTON STREET,01,A1,"DRUMMOND, EVERALD",2,1,1
9445,4128600052,QN,121-16 234 STREET,01,A2,"JOSEPH, TRUSTEE, PHERTRINA",2,1,1
9446,4128920033,QN,130-19 SPRINGFIELD BLVD,01,B2,"DANDRIDGE, ELVIRA",2,1,1
9447,4129580112,QN,13328 220 STREET,01,A1,164-04 109 AVENUE LLC,2,1,1
9448,4129890078,QN,177-25 135 AVENUE,01,A1,"ARNOLD , ZENNEBE I",2,1,1
9449,4130410043,QN,183-05 141 AVENUE,01,B1,"YOSIPOV, ISRAEL",2,1,1
9450,4130730151,QN,179-28 143 AVENUE,01,B3,"HAYNES, RYAN",2,1,1
9451,4130860057,QN,222-33 143 ROAD,01,A1,"ALEXANDER, ULRICK",2,1,1
9452,4131980019,QN,134-19 234 STREET,01,A1,HAZEL BLACKWOOD,2,1,1
9453,4133460058,QN,146-05 181 STREET,01,B3,14605 PARTNERS LLC,2,1,1
9454,4134670067,QN,145-80 220 STREET,01,A2,"CAYARD, ROMY",2,1,1
9455,4134830033,QN,145-18 227 STREET,01,B3,"SCOTT, JAMES",2,1,1
9456,4135040016,QN,224-12 SOUTH CONDUIT AVENUE,01,A1,JAMES HUGHES,2,1,1
9457,4135520048,QN,240-27 CANEY ROAD,01,B2,"EADDY, JAMEL J",2,1,1
9458,4136100023,QN,249-04 139 AVENUE,01,B3,"SMITH, RONALD",2,1,1
9459,4139110136,QN,155-25 BROAD STREET,01,A2,INGRID R. DE MARCO,2,1,1
9460,4141630037,QN,158-46 95 STREET,01,B2,ANTONIO N PARENTE,4,3,1
9461,4142420037,QN,163-15 99 STREET,01,A1,"MARCELLO, FRANCESCO",2,1,1
9462,4142471300,QN,102-33 JAMES COURT,01,A2,TIMOTHY EDWARD LUCAS,2,1,1
9463,4142471309,QN,102-15 JAMES COURT,01,A1,"YORK, MICHAEL",2,1,1
9464,4154780001,QN,12-38 CHANNEL ROAD,01,A2,HARNISHER & BARR,2,1,1
9465,4155640025,QN,7-14 BEACH 20 STREET,06,E9,"BEACH 20TH REALTY, L",2,1,1
9466,4156650106,QN,13-65 EGGERT PLACE,01,B3,"PUNNETTE, SHERWIN",2,1,1
9467,4157090154,QN,10-55 BEACH 22 STREET,01,B2,"ALMEIDA, MANUEL",2,1,1
9468,4157970042,QN,322 BEACH 30 STREET,01,B2,"NELSON, GISELE",2,1,1
9469,4161500100,QN,93-01 SHORE FRONT PARKWAY,09,P6,NYC DEPARTMENT OF PARKS AND RECREATION,4,3,1
9470,4161550001,QN,99-20 ROCKAWAY BEACH BLVD,07,G9,2128 FLATBUSH AVE LLC,2,1,1
9471,4162180008,QN,253 BEACH 122 STREET,01,A1,"KERRY A. HENNING, AS TRUSTEE",2,1,1
9472,4162200026,QN,215 BEACH 124 STREET,01,B3,DICIERVO ANTHONY JR,2,1,1
9473,4162280005,QN,118-07 ROCKAWAY BEACH BLVD,02,C3,"WOHL, KEITH",2,1,1
9474,4163210026,QN,159 BEACH 147 STREET,01,A1,INGRID ERBER,2,1,1
9475,5000780069,SI,77 BARD AVENUE,01,A1,GWENDOLYN SIMMONS,2,1,1
9476,5001490263,SI,203 PELTON AVENUE,01,A1,RICHARD TOUSSAINT,2,1,1
9477,5001580099,SI,122 ELM STREET,01,B2,"LAUDER, REBECCA L",2,1,1
9478,5001650014,SI,361 NORTH BURGHER AVENUE,01,A1,"WHITE, SHEILA",3,2,1
9479,5001730034,SI,693 HENDERSON AVENUE,04,S1,THOMAS FORONJY,3,2,1
9480,5002110043,SI,1190 CASTLETON AVENUE,04,K4,THETHREE COPTIC BROTHERS CORP.,2,1,1
9481,5002160036,SI,466 CARY AVENUE,02,C3,NIKOLAOS TOUNTAS,2,1,1
9482,5002290024,SI,438 CLOVE ROAD,01,A1,PETER DE VITO,2,1,1
9483,5003030010,SI,37 COUGHLAN AVENUE,01,A1,"SYKES, JAMES J",2,1,1
9484,5003320145,SI,9 FAIRVIEW AVENUE,01,A1,"CHRISTIE AKA FEDORSCHAK, PATRICIA A",2,1,1
9485,5003770441,SI,134 MARGARETTA COURT,01,A1,"OSTREICHER, HENRY",2,1,1
9486,5003900092,SI,59 ELDRIDGE AVENUE,01,A1,"DE HART, CHRISTINE",2,1,1
9487,5005060053,SI,34 BREWSTER STREET,01,A1,BAILEY HAGAR,2,1,1
9488,5005450100,SI,210 BROAD STREET,03,D3,NYC HOUSING AUTHORITY,9,8,1
9489,5005810006,SI,12 CATLIN AVENUE,01,A1,"FITZGERALD VICARS, MARIAN",2,1,1
9490,5006090024,SI,110 GRAND AVENUE,01,B2,"PRINCE-PREJS, PATRIC",2,1,1
9491,5006670037,SI,155 LABAU AVENUE,01,A5,"WU, ZI FENG",2,1,1
9492,5007530008,SI,315 ELVIN STREET,01,A1,"MYKYTENKO, LYUBOV",2,1,1
9493,5007590075,SI,179 MOUNTAINVIEW AVENUE,01,A1,"GOFFREDO, LAURA",2,1,1
9494,5008190145,SI,259 WELLBROOK AVENUE,01,A9,EARL FRANCIS,2,1,1
9495,5008490188,SI,31 HASBROUCK ROAD,01,A1,MARIO V ACUNZO,2,1,1
9496,5008650350,SI,44 HILLVIEW PLACE,01,A2,MARLA DIFORTE TRUSTEE,2,1,1
9497,5009020095,SI,928 TODT HILL ROAD,01,A2,"ANGELO MARIO DEVITO, TRUSTEE",2,1,1
9498,5009550201,SI,140 FRIENDSHIP LANE,08,I7,SEAVIEW SENIOR LIVING HDFC,4,3,1
9499,5010840008,SI,107 HARRISON AVENUE,01,B2,ROOSEVELT RICE,2,1,1
9500,5011090031,SI,2705 RICHMOND TERRACE,06,F9,GR LK DREDGING CO,3,2,1
9501,5011310090,SI,44 HOOKER PLACE,01,A1,"WELLS FARGO BANK, N.A.",2,1,1
9502,5011550003,SI,231 WALKER STREET,01,B2,DENIS WONG,2,1,1
9503,5011940024,SI,249 VAN NAME AVENUE,01,A1,LUZ N RIVERA,2,1,1
9504,5011940038,SI,221 VAN NAME AVENUE,01,A2,"RAMIREZ, ERIC",2,1,1
9505,5012660059,SI,194 SOUTH AVENUE,01,A1,"BREEN, MICHAEL",2,1,1
9506,5014570019,SI,292 LATHROP AVENUE,01,A2,ROSE MEYER,2,1,1
9507,5016700442,SI,511 LISK AVENUE,01,B2,"BEEPATH, ROSEMARIE",2,1,1
9508,5018350075,SI,100 CHELSEA ROAD,07,U0,CONSOLIDATED EDISON,7,6,1
9509,5019880110,SI,63 WASHINGTON AVENUE,01,A5,SHIRLEY FINKELSTEIN,2,1,1
9510,5026270060,SI,25 SHELLEY AVENUE,01,A1,"25 SHELLEY AVENUE, LLC",2,1,1
9511,5029720053,SI,198 ST MARYS AVENUE,01,B2,198 ST MARYS AVE LLC,2,1,1
9512,5031220314,SI,38 RAGAZZI LANE,01,A5,"ROGINSKAYA, VALENTINA",2,1,1
9513,5032640012,SI,1012 HYLAN BOULEVARD,01,A9,"DIANY, ABDESSAMAD",2,1,1
9514,5033310021,SI,240 ATLANTIC AVENUE,01,A1,JENNIFER EKONOMAKOS,2,1,1
9515,5033950090,SI,10 APPLEBY AVENUE,01,A5,NEENA SOLANKI,2,1,1
9516,5036150023,SI,271 PRESCOTT AVENUE,01,A3,"TKACHUK, ANDZHELA P",2,1,1
9517,5036250036,SI,15 STEELE AVENUE,01,B2,ROBERT FRONER,2,1,1
9518,5036360061,SI,34 BACHE AVENUE,01,A2,"GARDINER, JAMES R",2,1,1
9519,5037410034,SI,251 POULTNEY STREET,01,B2,BARBARA CERRITO,2,1,1
9520,5038710025,SI,664 HUNTER AVENUE,01,A5,LOTZ WALTER F,2,1,1
9521,5042860028,SI,120 OAK AVENUE,01,A1,JOSEPH A FRANZESE,2,1,1
9522,5044280021,SI,305 NATICK STREET,01,A1,"GORDON, JACQUELINE",2,1,1
9523,5046400011,SI,3725 AMBOY ROAD,01,B9,VADIM BASOVSKIY,2,1,1
9524,5051310026,SI,276 GREENCROFT AVENUE,01,B2,"GILBERT, RAYMOND",2,1,1
9525,5052620121,SI,173 HILLCREST STREET,01,B2,"BRAGOUDAKIS , JAMIE",2,1,1
9526,5052770042,SI,157 DAVID STREET,01,B2,YUKI ZHENG,2,1,1
9527,5053910059,SI,30 BLUE HERON DRIVE,01,A3,JOHN P TORONTO,3,2,1
9528,5054970234,SI,268 WILSON AVENUE,01,B3,"XIA, LIANGKAI",2,1,1
9529,5060870125,SI,179 DAHLIA STREET,01,A5,BARBARA ANN MARRONE,2,1,1
9530,5062470037,SI,1033 ANNADALE ROAD,01,A1,"KOGAN, BORIS",2,1,1
9531,5064750001,SI,5150 HYLAN BOULEVARD,08,W2,ST JOSEPH BY-THE-SEA H S,3,2,1
9532,5067750236,SI,20 SHERWOOD AVENUE,08,I9,EDEN II SCHOOL FOR AUTISTIC CHILDREN INC .,2,1,1
9533,5068530079,SI,477 VERNON AVENUE,01,A1,KENNETH KEARNS,2,1,1
9534,5068550072,SI,484 VERNON AVENUE,01,B2,SALVATORE J ACCARDI,2,1,1
9535,5071050500,SI,2812 ARTHUR KILL ROAD,07,G2,"LASKODY, JOHN",2,1,1
9536,5074980022,SI,25 GAYNOR STREET,01,B2,DENNIS T CROWLEY,2,1,1
9537,5075900026,SI,46 ANDROVETTE STREET,06,E1,"46 ANDROVETTE, LLC.",2,1,1
9538,5078640089,SI,531 ROCKAWAY STREET,01,A1,"WILMINGTON SAVINGS FUND SOCIETY, FSB",2,1,1
9539,5078840010,SI,348 MANHATTAN STREET,01,A1,EDNA EARLY,2,1,1
9540,5080210036,SI,125 FISHER AVENUE,01,A1,"MICCIULLA, MAURA T",2,1,1
9541,5080500086,SI,146 BENTLEY STREET,01,A1,"BIRKHEAD, ROBERT",2,1,1
9542,1000020001,MN,4 SOUTH STREET,07,Y7,NYC DEPARTMENT OF SMALL BUSINESS SERVICES,2,1,1
9543,1004380010,MN,404 EAST 11 STREET,04,O8,FOUR GUDS RLTY CORP,2,1,1
9544,1006150091,MN,259 WEST 12 STREET,03,D3,259 WEST 12 ST LLC,2,1,1
9545,1006210060,MN,256 WEST 4 STREET,01,A4,256 W 4 LLC,2,1,1
9546,1008000022,MN,131 WEST 24 STREET,03,D0,BRICK FARMS ETC,2,1,1
9547,1008280017,MN,25 WEST 26 STREET,05,O6,25 WEST 26 ST INC,2,1,1
9548,1008290039,MN,242 5 AVENUE,04,S4,242 GRAMERCY FIFTH LLC,2,1,1
9549,1008450002,MN,69 EAST 17 STREET,09,Q1,NYC DEPARTMENT OF PARKS AND RECREATION,4,3,1
9550,1009070012,MN,217 EAST 26 STREET,04,C7,217 EAST 26TH STREET LLC,2,1,1
9551,1010530039,MN,408 WEST 44 STREET,03,D1,NINTH AVENUE REALTY,2,1,1
9552,1014080008,MN,113 EAST 73 STREET,08,W8,THE BUCKLEY SCHOOL,2,1,1
9553,1014720030,MN,448 EAST 78 STREET,02,C5,R&D 448 LLC,2,1,1
9554,1015040023,MN,47 EAST 92 STREET,01,A4,REPUBLIC OF PAKISTAN,2,1,1
9555,1018700056,MN,250 WEST 99 STREET,03,D3,"D-DAY REALTY, L.P.",2,1,1
9556,1019700016,MN,70 CONVENT AVENUE,03,D1,LOGAN GARDENS HDFC INC,2,1,1
9557,1020390058,MN,262 WEST 154 STREET,03,D1,MACOMBS MANOR HOUSING DEVELOPMENT UND CO RPORATION,2,1,1
9558,1022430384,MN,93 PARK TERRACE WEST,01,B1,"DAVIDSON, DAVID M",2,1,1
9559,2023720047,BX,3461 3 AVENUE,05,GW,3455 THIRD AVE REALTY,2,1,1
9560,2027400083,BX,859 MANIDA STREET,01,B1,"DEJESUS, AUDREY",2,1,1
9561,2028410025,BX,35 MARCY PLACE,03,D3,MARCY BAER ASSOCIATES LP,2,1,1
9562,2028770439,BX,1746 POPHAM AVENUE,08,N2,"LEAKE & WATTS SERVICES, INC.",2,1,1
9563,2030350013,BX,4282 PARK AVENUE,10,G7,"4282 PARK, LLC",2,1,1
9564,2032050005,BX,2600 GRAND AVENUE,02,C0,2600 GRAND LLC,2,1,1
9565,2032660068,BX,3027 BAILEY AVENUE,08,Y1,FIRE DEPARTMENT OF NEW YORK,2,1,1
9566,2035430120,BX,701 METCALF AVENUE,09,Q1,NYC DEPARTMENT OF PARKS AND RECREATION,3,2,1
9567,2035560001,BX,601 ST LAWRENCE AVENUE,01,B2,"LALA GARCIA, LUIS GUILLERMO",2,1,1
9568,2036870043,BX,909 CASTLE HILL AVENUE,02,C0,510 EAST REALTY INC,2,1,1
9569,2037690025,BX,1283 BRONX RIVER AVENUE,02,C3,"BAZEMORE, CHARLES",2,1,1
9570,2039230061,BX,1546 LELAND AVENUE,01,B2,"ZIEGEL, YARON",2,1,1
9571,2039750034,BX,1461 ROWLAND STREET,01,A1,"RAMPRASHAD, AMIT",2,1,1
9572,2040210011,BX,1749 GARFIELD STREET,01,B1,"DEPASQUALE, MICHAEL",2,1,1
9573,2040240044,BX,1606 TAYLOR AVENUE,01,B9,"SANTIAGO, RODNEY",2,1,1
9574,2040430001,BX,800 VAN NEST AVENUE,10,G0,HR VAN NEST LLC,2,1,1
9575,2041400003,BX,1428 BLONDELL AVENUE,06,F9,"IACHETTA ENTERPRISES, LLC",2,1,1
9576,2042370020,BX,3125 ARNOW PLACE,01,B2,"COLLINS, MICHAEL",2,1,1
9577,2042640037,BX,1955 FOWLER AVENUE,01,A1,GARGALLO  GEORGIAN R,2,1,1
9578,2044350038,BX,768 ALLERTON AVENUE,04,K4,"A.A. REALTY,",2,1,1
9579,2044720109,BX,2416 SEYMOUR AVENUE,01,B1,BRITO ENEROLIZA,3,2,1
9580,2044870012,BX,2520 WESTERVELT AVENUE,01,B3,SUJAK ENTERPRISES CORP.,2,1,1
9581,2046070125,BX,3320 BARNES AVENUE,01,A5,"CHAMBERS, SONIA",2,1,1
9582,2046770005,BX,869 EAST 218 STREET,01,A1,GREATER NEW YORK CORPORATION OF SEVENTH- DAY ADVENT,3,2,1
9583,2046860037,BX,902 EAST 216 STREET,01,A1,ELINGER GRAY,2,1,1
9584,2047700001,BX,1750 BURKE AVENUE,09,Q1,NYC DEPARTMENT OF PARKS AND RECREATION,6,5,1
9585,2047810038,BX,3009 EDSON AVENUE,01,A5,"SANTIAGO, ANGEL M",2,1,1
9586,2048320020,BX,4100 LOWERRE PLACE,08,P8,NEW YORK PUBLIC LIBRARY,2,1,1
9587,2048830124,BX,3475 BRUNER AVENUE,01,B1,"HP AMANDA'S COVE HDFC, INC.",2,1,1
9588,2048970018,BX,1241 EAST 222 STREET,01,B2,JOHN & MARIA BEAUCHAMP,2,1,1
9589,2050060033,BX,1738 PITMAN AVENUE,01,B1,"BOLARINWA, TAIWO",2,1,1
9590,2051020009,BX,4707 BRONX BOULEVARD,02,C0,"GREEN BROWN, TONYA",2,1,1
9591,2051060029,BX,4736 MATILDA AVENUE,01,B2,MOLESA BROWN,2,1,1
9592,2051250036,BX,1039 EAST 241 STREET,01,B2,BLUE CORNET STONE CORP.,2,1,1
9593,2053630004,BX,1356 GILLESPIE AVENUE,01,B3,"HERNANDEZ, JULIO A",2,1,1
9594,2054250063,BX,913 HOLLYWOOD AVENUE,01,B2,"MARTINEZ, YISSEL",2,1,1
9595,2054590028,BX,1003 VINCENT AVENUE,01,B3,JOSEPH F ZILLILTO,2,1,1
9596,2054620041,BX,922 THROGMORTON AVENUE,01,B1,"YILDIZ, SULEYMAN",2,1,1
9597,2054830009,BX,620 ELLSWORTH AVENUE,01,B2,"SCHWENK, KAREN",3,2,1
9598,2054850020,BX,650 WILCOX AVENUE,01,A1,"BALBONA, ILIR A",2,1,1
9599,2055260073,BX,3177 GLENNON PLACE,01,B1,"SOLANO, RAFAEL",2,1,1
9600,2055920066,BX,266 SWINTON AVENUE,01,B1,"CLEARY, DIONNE",2,1,1
9601,2056070082,BX,2584 SCHURZ AVENUE,01,B1,DIMEGLIO FRANCO,2,1,1
9602,2056270038,BX,37 CENTRE STREET,01,B3,"FISHEL, HEIDI",2,1,1
9603,2056300074,BX,298 WILLIAM AVENUE,01,A5,"TRUMPY, JOHN",2,1,1
9604,2056440110,BX,345 KING AVENUE,01,A1,"WOJTCZAK, BOGDAN",2,1,1
9605,2056460033,BX,459 MINNIEFORD AVENUE,01,A2,CAMPBELL  JOHN A,2,1,1
9606,2058851262,BX,6115 TYNDALL AVENUE,01,A1,"MAY-ZEITCHIK, DEBRA M",2,1,1
9607,2059330225,BX,5921 PALISADE AVENUE,08,I6,HEBREW HOME HOUSING DEVELOPMENT FUND COM PANY INC,6,5,1
9608,3001210028,BK,194 CONCORD STREET,06,F9,"NEBIOL, FLORRIE B",3,2,1
9609,3003840054,BK,57 WYCKOFF STREET,01,A4,"REILAND, WILLIAM",2,1,1
9610,3004430069,BK,267 CARROLL STREET,02,C0,"ROSSETTI, ELENA",2,1,1
9611,3006720017,BK,134 30 STREET,01,B9,GUILLERMO F. CANADA,2,1,1
9612,3007140006,BK,4001 4 AVENUE,07,G3,4001 4TH LLC,2,1,1
9613,3008000045,BK,5118 6 AVENUE,04,S2,AMANDA Y LLC,2,1,1
9614,3010280015,BK,236 12 STREET,01,A9,236 12TH LLC,2,1,1
9615,3010730001,BK,145 8 AVENUE,08,M1,CONG BETH ELOHIM,2,1,1
9616,3012070038,BK,1265 DEAN STREET,01,B3,"CHIN LIU, JULIE YAN",2,1,1
9617,3012370067,BK,1129 PARK PLACE,01,B9,WILSON THELMA,2,1,1
9618,3013490059,BK,1641 BERGEN STREET,08,M1,BEREAN BAPT CHUR,2,1,1
9619,3014060071,BK,1461 CARROLL STREET,01,B3,"DOBRUSHE DENBURG, TRUSTEE",2,1,1
9620,3015260122,BK,240 SUMPTER STREET,01,B1,"MCALPINE, WILLIE",2,1,1
9621,3016270010,BK,105 MALCOLM X BOULEVARD,02,C1,UNAVAILABLE OWNER,2,1,1
9622,3016870068,BK,201 CHAUNCEY STREET,02,C2,"201 CHANUCEY STREET, LLC",2,1,1
9623,3018340044,BK,408 TOMPKINS AVENUE,04,S9,IRON WOOD CRE LLC,2,1,1
9624,3019500026,BK,484 LAFAYETTE AVENUE,01,B9,VUHEN ADIR LLC,2,1,1
9625,3020270040,BK,32 NORTH PORTLAND AVE,02,C3,2064 5TH AVE 555 LLC,2,1,1
9626,3025810010,BK,304 GREENPOINT AVENUE,06,F5,MARL-GREEN REALTY CORP,2,1,1
9627,3026530039,BK,12 JEWEL STREET,01,A9,THE DANIEL THOMAS COLBERT LIVING TRUST,2,1,1
9628,3027220036,BK,59 RICHARDSON STREET,02,C0,VITTIBURGA MARIE,2,1,1
9629,3028570053,BK,223 FROST STREET,01,B9,"PIECORO, AMY",2,1,1
9630,3029120029,BK,897 METROPOLITAN AVENUE,01,B2,FELTON ELAINE,2,1,1
9631,3030310004,BK,268 UNION AVENUE,02,C1,CHARLES KNOLL FAMILY IRREVOCABLE TRUST,2,1,1
9632,3032350013,BK,762 HART STREET,02,C2,B&R MANAGEMENT LIMITED PARTNERSHIP,2,1,1
9633,3032470010,BK,1480 DEKALB AVENUE,05,K1,CAMILLO ASARO,3,2,1
9634,3034390003,BK,1407 BUSHWICK AVENUE,08,M1,ST THOMAS MISSION,3,2,1
9635,3035680018,BK,265 LEGION STREET,01,B1,"OGUAGHA, IFEANYI",2,1,1
9636,3035810022,BK,297 GRAFTON STREET,01,B1,"TATHAM, BEVERLY",2,1,1
9637,3037160014,BK,272 GLENMORE AVENUE,02,C2,270 GLENMORE AVE LLC,2,1,1
9638,3038270004,BK,599 BRADFORD STREET,02,C0,E PEREZ UX,2,1,1
9639,3038850212,BK,217 HIGHLAND BOULEVARD,01,A1,WILKINS BARBARA A,2,1,1
9640,3039110054,BK,159 RIDGEWOOD AVENUE,01,A1,"SHEWBARAN, KHEMRAJ",2,1,1
9641,3039570041,BK,202 SHEPHERD AVENUE,01,B2,"RUIZ, WILFREDO",2,1,1
9642,3041480016,BK,285 HEMLOCK STREET,01,A9,"MATA, JOSE",2,1,1
9643,3042450036,BK,544 LOGAN STREET,01,B1,TRICOCHE PEDRO J,2,1,1
9644,3044530035,BK,482 BERRIMAN STREET,02,C0,WALKES LEVI A,2,1,1
9645,3044610048,BK,719 EUCLID AVENUE,01,B1,"FRANCOIS, NEVILLE",2,1,1
9646,3046460016,BK,310 EAST 92 STREET,02,C3,"ABORISADE, OMOBOLAJI",3,2,1
9647,3048020003,BK,400 MIDWOOD STREET,01,B9,"ALEXIS, FRANTZ",2,1,1
9648,3048710008,BK,380 LINDEN BOULEVARD,01,A1,DELORES A DAVIS,2,1,1
9649,3048910038,BK,311 EAST 37 STREET,01,A9,"DAVID, RANDY",2,1,1
9650,3049470066,BK,1801 NOSTRAND AVENUE,04,S1,"WANG, QING",2,1,1
9651,3049610068,BK,1215 TROY AVENUE,01,A5,"SUCKOO, ALETHEA",2,1,1
9652,3049620022,BK,742 EAST 46 STREET,01,B3,"JOSEPH, MARIE-CLAUDE",2,1,1
9653,3052210079,BK,673 EAST 21 STREET,01,B2,DEJEAN NANCY,2,1,1
9654,3052390017,BK,705 EAST 18 STREET,01,A1,"TOLCHIN, ROBERT J",2,1,1
9655,3052640019,BK,32 SEELEY STREET,01,B2,GOLDBERG PAMELA R,2,1,1
9656,3053310049,BK,802 FRIEL PLACE,02,C0,"CARINO, HUMBERTO",4,3,1
9657,3053900033,BK,592 EAST 7 STREET,08,I7,"HUMAN CARE SERVICES FOR FAMILIES & CHILD REN, INC.",2,1,1
9658,3054070053,BK,679 DAHILL ROAD,02,C0,EMERALD REALTY DEVELOPMENT CORP    C/O T AUB & FASCIANA P C,2,1,1
9659,3054230085,BK,103 PARKVILLE AVENUE,01,A4,"FRANK, JOSEPH",2,1,1
9660,3054440008,BK,1706 47 STREET,01,A9,YEHUDEI DZENTA,2,1,1
9661,3054730014,BK,1720 52 STREET,01,B2,THOMAS HERSKO,2,1,1
9662,3054740071,BK,1823 53 STREET,01,B1,STEINBERG ISRAEL,2,1,1
9663,3054830085,BK,1029 DAHILL ROAD,01,A5,"ORLANDER, NAFTALI",2,1,1
9664,3054980039,BK,1766 57 STREET,01,A2,SCHEINER YEHUDA,2,1,1
9665,3056240014,BK,1418 46 STREET,02,C0,"BLUM, MORDECHAI",2,1,1
9666,3056410032,BK,1264 49 STREET,02,C0,"STAHL, MOSHE B",2,1,1
9667,3056760056,BK,1247 55 STREET,01,A1,"MARKOWITZ, CHAYA",2,1,1
9668,3057140057,BK,835 61 STREET,05,K2,63RD REALTY INC,2,1,1
9669,3057200077,BK,1411 61 STREET,01,B1,"SHUM, LEP SUN",2,1,1
9670,3057360034,BK,927 64 STREET,02,C2,UNITED POWER REALTY CORP,3,2,1
9671,3057780001,BK,6224 2 AVENUE,07,T2,NYC DEPARTMENT OF SMALL BUSINESS SERVICES,16,15,1
9672,3058180005,BK,6401 4 AVENUE,07,G4,"SPARTAN 5 PROPERTIES, LLC",2,1,1
9673,3059470044,BK,7614 COLONIAL ROAD,01,A5,BRIAN D COAD,2,1,1
9674,3059760021,BK,68 79 STREET,01,B1,CLAUDETTE TEEN,2,1,1
9675,3059810016,BK,522 79 STREET,02,C0,ANNA & SANDY CHANG M,2,1,1
9676,3059990021,BK,540 81 STREET,01,B1,KOUTSODONTIS EVELYN,2,1,1
9677,3060080038,BK,480 82 STREET,01,B9,"LOVERDE, SILVESTRO",2,1,1
9678,3060420067,BK,123 87 STREET,01,A1,"CUNNINGHAM, CHERYL A",2,1,1
9679,3061290098,BK,148 98 STREET,01,A1,"BOURKE, DAVID M",2,1,1
9680,3061730034,BK,1966 70 STREET,02,C0,"LI, YAN YUN",2,1,1
9681,3062180057,BK,2041 BAY RIDGE PARKWAY,01,B2,"PIMPINELLA, DONNA",2,1,1
9682,3062190017,BK,2132 74 STREET,02,C0,"LI, JASON",2,1,1
9683,3062340068,BK,1431 77 STREET,01,B2,JOSEPH BARONE,2,1,1
9684,3062450050,BK,1471 78 STREET,01,B3,ROSEANN TUCCI,2,1,1
9685,3062690035,BK,1472 79 STREET,02,C0,"PAPANTONIOU, EFFIE",2,1,1
9686,3062740041,BK,1980 79 STREET,01,B9,NADER S ABUALAININ,2,1,1
9687,3063087501,BK,1268 83 STREET,02,R3,1268-1270 83 ST CONDO ASSOC,3,2,1
9688,3063160028,BK,1952 82 STREET,01,A1,"LEE, ANTONIO",2,1,1
9689,3063170042,BK,8206 21 AVENUE,01,B1,YERACHMIEL HIRSCHBERG,2,1,1
9690,3065130044,BK,1248 CONEY ISLAND AVENUE,07,G4,"SUNOCO, LLC",2,1,1
9691,3065150058,BK,1071 EAST 2 STREET,02,C0,"FEDER, PESEL",2,1,1
9692,3065670039,BK,1460 EAST 5 STREET,02,C0,"HARARI, MICHAEL B",2,1,1
9693,3065690079,BK,1323 OCEAN PARKWAY,01,B1,"CHETRIT, ISAAC",2,1,1
9694,3065870034,BK,1458 OCEAN PARKWAY,01,B1,"SALAMEH, FARAJ",2,1,1
9695,3065870067,BK,1575 EAST 5 STREET,01,A9,"ZNATY, VICTOR",2,1,1
9696,3065910061,BK,1483 EAST 9 STREET,01,A1,"SCHUR, JONATHAN",2,1,1
9697,3066350019,BK,1724 EAST 4 STREET,01,B3,YEDID MOISE,2,1,1
9698,3066590007,BK,406 QUENTIN ROAD,01,A9,"950 FLATBUSH AVENUE REALTY, LLC",2,1,1
9699,3066590076,BK,1801 EAST 2 STREET,01,A9,"ELBAZ, JACK",2,1,1
9700,3066810237,BK,1896 EAST 4 STREET,01,A7,"YEDID, JACK",2,1,1
9701,3066850065,BK,907 AVENUE S,01,B1,"FAKSE, SHELA",2,1,1
9702,3067210031,BK,1057 EAST 19 STREET,01,A1,SETTON JEFREY,2,1,1
9703,3067250029,BK,1156 EAST 15 STREET,01,B2,EDWARD J ARNIM,2,1,1
9704,3067420027,BK,1352 EAST 14 STREET,01,B2,"ASKARINAM, HERTSEL",2,1,1
9705,3067500075,BK,1455 EAST 12 STREET,01,A9,"COHEN, DAVID",2,1,1
9706,3067570025,BK,1916 OCEAN AVENUE,04,D6,1916 OCEAN AVENUE LLC,2,1,1
9707,3067647501,BK,1535 EAST 17 STREET,04,RM,THE 1535 EAST 17TH ST CONDO,2,1,1
9708,3067910044,BK,1667 EAST 28 STREET,01,A1,MENDLOWITZ BARRY,2,1,1
9709,3068240058,BK,1869 EAST 18 STREET,01,A1,HELENE SHRIQUI,2,1,1
9710,3068510065,BK,2323 83 STREET,04,C7,2327 83RD STREET LLC,2,1,1
9711,3069040006,BK,2835 HARWAY AVENUE,04,S1,"CANDELLI, NICHOLAS",2,1,1
9712,3069120071,BK,2652 MILL ROAD,01,A2,"LEE, PAK WAI",2,1,1
9713,3070280030,BK,4024 BEACH 40 STREET,02,C0,"4024B40 REALTY, LLC",2,1,1
9714,3070790031,BK,1964 WEST 9 STREET,01,B3,"GOLDSTEIN, RYAN",2,1,1
9715,3070880084,BK,1931 OCEAN PARKWAY,02,C0,1931 OCEAN PARKWAY LLC,2,1,1
9716,3070890018,BK,1924 EAST 8 STREET,02,C3,"KHABIEH, VICTOR",2,1,1
9717,3071030049,BK,275 LAKE STREET,01,A9,"SUED, TALIA",2,1,1
9718,3071040173,BK,2002 EAST 2 STREET,01,B1,"COHEN, NATHAN AS TRUSTEE",2,1,1
9719,3071310030,BK,2234 EAST 5 STREET,01,B1,"BEDA, EDWARD",2,1,1
9720,3071350042,BK,2180 EAST 9 STREET,01,B1,DIB NAHMOUD,2,1,1
9721,3071450022,BK,406 VAN SICKLEN STREET,01,B3,"LEFF, MARCELLA",2,1,1
9722,3071540062,BK,2277 EAST 2 STREET,01,A1,CHAKKALO NINETT,2,1,1
9723,3071990022,BK,2444 OCEAN PARKWAY,01,B1,EL-MANN MICHEL,2,1,1
9724,3072630041,BK,2838 BRIGHTON 7 STREET,01,B2,"ULLAH, EHSAN",2,1,1
9725,3072930080,BK,1925 EAST 14 STREET,01,A3,"KAMKHEHJI, AZAR",2,1,1
9726,3072950038,BK,1976 EAST 17 STREET,01,A1,"LANIADO, ABRAHAM",2,1,1
9727,3075600073,BK,1652 NEW YORK AVENUE,01,B2,RUDOLPH RAJABALLEY,3,2,1
9728,3076140005,BK,3213 AVENUE K,01,A5,MALKIE LIPSCHITZ,2,1,1
9729,3076280057,BK,1130 EAST 29 STREET,01,A3,GREATER WORLD ADVISORS LLC,2,1,1
9730,3076450034,BK,1227 EAST 27 STREET,01,A1,YITZCHOK FUCHS,2,1,1
9731,3077040019,BK,1651 EAST 31 STREET,01,A5,"ALPIN, JOSEPH",2,1,1
9732,3077660065,BK,1820 ALBANY AVENUE,01,B3,DANIEL BENNY,2,1,1
9733,3079030056,BK,1428 EAST 59 STREET,01,A9,JENAL L HARDAWAY,2,1,1
9734,3079320093,BK,1332 EAST 59 STREET,05,GW,EMERALD EQUITIES LLC,2,1,1
9735,3080520067,BK,1166 EAST 87 STREET,01,A9,BRUCHA DEVELOPMENT LLC,2,1,1
9736,3080660056,BK,1240 EAST 88 STREET,01,B2,"GASPARD, JEANINON",3,2,1
9737,3081280032,BK,849 EAST 95 STREET,01,B2,"BRANDFORD, HAROLD",2,1,1
9738,3084080028,BK,1556 EAST 66 STREET,01,A9,"GOLOD, LUDMILA",2,1,1
9739,3084330019,BK,2149 EAST 73 STREET,01,A1,"SPIEGAL, CRAIG",2,1,1
9740,3085070020,BK,1957 KIMBALL STREET,01,A1,CARDONA AMELIA C,2,1,1
9741,3085240019,BK,2051 EAST 38 STREET,01,A9,"CAPPUCCIO, JOSEPH",2,1,1
9742,3085280001,BK,2394 FLATBUSH AVENUE,07,G5,HESS RETAIL STORES LLC,2,1,1
9743,3087380012,BK,253 WEST END AVENUE,01,B3,"AMIR, MARK",2,1,1
9744,3087410018,BK,240 DOVER STREET,01,A1,LARISA KURMAN,2,1,1
9745,3087540051,BK,160 LANGHAM STREET,01,B2,SHLEMOVICH GREGORY,2,1,1
9746,3087600060,BK,2001 ORIENTAL BOULEVARD,08,W6,CUNY,22,21,1
9747,3087720078,BK,1733 SHEEPSHEAD BAY ROAD,05,O5,1733 SHEEPSHEAD BAY LLC,2,1,1
9748,3088340175,BK,2428 PLUMB 1 STREET,09,Q8,PETER PAN,3,2,1
9749,4002000046,QN,47-24 39 PLACE,01,B1,"CASTELLO, CARIDAD",2,1,1
9750,4003740048,QN,32-11 38 AVENUE,01,B2,"BEN HORIN, NIR",2,1,1
9751,4003940019,QN,39-13 23 STREET,06,F9,"BOBED  REALTY,  LLC",2,1,1
9752,4005500005,QN,21-23 30 DRIVE,08,M1,ISLAMIC CONGRESS CHURCH,2,1,1
9753,4006030026,QN,30-14 35 AVENUE,02,C0,JASON ZOGRAFAKIS LLC,2,1,1
9754,4006870013,QN,41-06 ASTORIA BOULEVARD S,05,K1,TRIBORO REALTY,2,1,1
9755,4007560009,QN,20-55 49 STREET,01,A1,"KATRAGIS, NICHOLAS",2,1,1
9756,4007710103,QN,45-07 DITMARS BOULEVARD,04,S2,4507 DITMARS LLC,2,1,1
9757,4007990007,QN,20-61 STEINWAY STREET,04,S9,"2061 STEINWAY, LLC",2,1,1
9758,4008220059,QN,22-68 36 STREET,01,B3,"FILIPPIDIS, KONSTANTINOS",2,1,1
9759,4008390041,QN,27-24 HOYT AVENUE SOUTH,04,C7,LATERRA INC,2,1,1
9760,4008650145,QN,23-22 CRESCENT STREET,01,A5,"RAFAELIDIS, GERASIMOS",2,1,1
9761,4010010044,QN,22-13 HAZEN STREET,05,K1,43-04 19TH AVENUE REALTY CORP.,5,4,1
9762,4012150022,QN,37-53 60 STREET,01,A1,KOREAN FIRST PRESBYTERIAN CHURCH OF NEW  YORK,2,1,1
9763,4013230006,QN,41-28 55 STREET,02,C1,VRACHNOS ASSOCIATES,2,1,1
9764,4013310054,QN,59-24 WOODSIDE AVENUE,05,O9,J P MORGAN CHASE,2,1,1
9765,4014060038,QN,94-17 32 AVENUE,01,A1,MYRTLE L. COLLINS IRRV ASSET MANAGEMENT  TRUST,2,1,1
9766,4015030014,QN,40-08 FORLEY STREET,08,I5,SOSA & PEREA PROPERTIES LLC,2,1,1
9767,4016020032,QN,94-60 45 AVENUE,02,C0,"HARIDIN , RAKESH",2,1,1
9768,4017110057,QN,33-23 96 STREET,02,C0,"CIFUENTES, MARIA",3,2,1
9769,4017200148,QN,33-35 105 STREET,02,C0,QI GUANG WENG,2,1,1
9770,4017490028,QN,35-16 108 STREET,01,B2,35 108TH STREET LLC,2,1,1
9771,4017520055,QN,36-01 108 STREET,04,S5,"GAIMS, LLC",2,1,1
9772,4017610026,QN,37-42 99 STREET,02,C0,MANUEL AGUILAR,2,1,1
9773,4017760015,QN,104-44 39 AVENUE,02,C0,"CHEN, GANG",2,1,1
9774,4017790013,QN,108-38 38 AVENUE,02,C3,"LIN, YUQING",2,1,1
9775,4018570029,QN,90-58 55 AVENUE,02,C0,"ZHANG, QIAO LING",2,1,1
9776,4019280041,QN,102-19 ALSTYNE AVENUE,01,B2,"FANG, HENG ZHANG",2,1,1
9777,4019420071,QN,103-59 52 AVENUE,01,B3,"WENG, ZHEN",2,1,1
9778,4019420093,QN,103-21 52 AVENUE,01,B1,"ZHENG , SHI QIN",2,1,1
9779,4019530007,QN,103-18 MARTENSE AVENUE,01,B3,NATIONSTAR MORTGAGE LLC D/B/A MR. COOPER,3,2,1
9780,4019930075,QN,106-29 50 AVENUE,01,B2,"CERVINO, JUDITH",2,1,1
9781,4020010049,QN,109-27 46 AVENUE,02,C0,"46TH AVENUE PROPERTIES, LLC",2,1,1
9782,4020030077,QN,108-27 48 AVENUE,01,B2,"RUSSO, CHRISTINE",2,1,1
9783,4020050027,QN,108-54 49 AVENUE,02,C3,"LEE, PHOEBE",2,1,1
9784,4020160045,QN,111-86 43 AVENUE,01,B2,ARCADIO M. DIAZ AS TRUSTEE,2,1,1
9785,4021080013,QN,99-12 62 ROAD,01,B3,LEVIYEV DZHURA,2,1,1
9786,4022270058,QN,110-11 68 DRIVE,01,A1,"YUNATANOV, ISSAK A",2,1,1
9787,4022960039,QN,50-06 47 STREET,02,C0,LUZ Z. NARVAEZ,2,1,1
9788,4023990024,QN,67-26 54 AVENUE,01,B1,"LI, JIE",2,1,1
9789,4024170033,QN,66-19 50 AVENUE,01,B2,"LIN, JINGCHUN",2,1,1
9790,4024350003,QN,49-15 69 STREET,06,E1,"WANG, ZHE",2,1,1
9791,4024560029,QN,51-07 69 STREET,04,S2,"FIDAN, VALENTINA",2,1,1
9792,4024970047,QN,69-27 53 DRIVE,01,A1,"FOWLES , MARYANN",2,1,1
9793,4027260016,QN,60-38 FLUSHING AVENUE,02,C3,MARIA A. MARKIEWICZ REVOCABLE TRUST,2,1,1
9794,4027530303,QN,64-37 59 AVENUE,01,A2,"REISER, JON A",2,1,1
9795,4029030018,QN,52-32 83 STREET,04,C7,5232 REALTY LLC,2,1,1
9796,4029230032,QN,69-31 61 DRIVE,01,A1,GARRETT T. O'REILLY,2,1,1
9797,4030420040,QN,65-57 79 PLACE,01,B2,CASSANO NOREEN E,2,1,1
9798,4031450039,QN,85-67 67 ROAD,01,A5,"MOREY, MARIA L.",2,1,1
9799,4035790106,QN,75-12 60 PLACE,01,A9,"LIANG, XIANBIAO",2,1,1
9800,4036900017,QN,71-30 73 STREET,01,B3,"WISOTSKY, DANIEL P",2,1,1
9801,4037720050,QN,73-05 68 AVENUE,01,B3,"BOCHENKO, SLAWOMIR",2,1,1
9802,4037750056,QN,75-17 68 AVENUE,02,C0,"CALABRESE, ALFREDO S",2,1,1
9803,4037760040,QN,78-39 67 ROAD,02,C0,"BRZOSKA, WALDEMAR",2,1,1
9804,4040010001,QN,125-19 14 AVENUE,01,B3,EUN I CHANG,2,1,1
9805,4040220006,QN,115-14 10 AVENUE,01,A1,"TINOCO, ROSITA",2,1,1
9806,4041700020,QN,125-08 20 AVENUE,01,B1,"ZHENG, JIAN YAN",2,1,1
9807,4044440160,QN,11-30 WHITESTONE EXPWY,01,A2,PEGGY PERTSINIDES,2,1,1
9808,4044830042,QN,147-21 14 AVENUE,01,A1,"SALEEMI, SABBA K",2,1,1
9809,4045550008,QN,157-53 10 AVENUE,01,A1,"LIAW, UNA",2,1,1
9810,4046100050,QN,12-09 TOTTEN STREET,01,A1,"MARINO, DOMENICO",2,1,1
9811,4046730030,QN,149-53 23 AVENUE,01,B1,"FALLON, MICHAEL J",2,1,1
9812,4046910019,QN,150-27 22 AVENUE,01,B1,"HUANG, XUE YUE",2,1,1
9813,4047370056,QN,154-49 21 AVENUE,01,B2,"RUSSELLO, JOSEPHINE",2,1,1
9814,4049510076,QN,136-33 35 AVENUE,02,C0,"CHEOK , HENRY H.",2,1,1
9815,4051470026,QN,137-54 GERANIUM AVENUE,08,W9,MUSLIM CENTER OF NEW,2,1,1
9816,4054070022,QN,149-40 BEECH AVENUE,01,A1,FAHERTY MARYANN,2,1,1
9817,4054220052,QN,43-20 165 STREET,01,A1,"HARTRICK, ROBERT WARREN",2,1,1
9818,4056840052,QN,56-40 197 STREET,01,A0,MICHAEL O'GRADY,3,2,1
9819,4060140017,QN,28-23 BELL BOULEVARD,01,B3,"HONG, CHONG HAK",3,2,1
9820,4061010028,QN,209-43 34 AVENUE,01,A0,"LAW, RICHARDSON",3,2,1
9821,4061560042,QN,35-23 207 STREET,05,O1,GOODMAN DAVID,2,1,1
9822,4061710031,QN,212-05 38 AVENUE,01,A1,WREN GERALD F,2,1,1
9823,4067380017,QN,59-43 160 STREET,02,C0,59-43 REALTY LLC,2,1,1
9824,4067380044,QN,59-20 161 STREET,01,B3,"CHOO, HOW SAI",2,1,1
9825,4070170040,QN,80-11 166 STREET,01,A1,PHILIP WAH WONG IRREV TRUST,2,1,1
9826,4073320125,QN,214-36 45 ROAD,01,A1,"YOO, ALEXIS",2,1,1
9827,4079880030,QN,89-06 241 STREET,01,B3,"SINGH, SURJEET",2,1,1
9828,4079950021,QN,237-34 DAVENPORT AVENUE,01,A1,MARY KLAP,2,1,1
9829,4080980019,QN,30 CHERRY STREET,01,A1,DAVID S BOCCIO,2,1,1
9830,4082330432,QN,50-07 MORENCI LANE,01,A2,DIANE SANTORO,2,1,1
9831,4089180055,QN,80-29 87 ROAD,01,A5,"FIGUEROA, JACQUELINE",2,1,1
9832,4089470026,QN,92-34 77 STREET,01,A9,"DU, QINGYUN",2,1,1
9833,4089720046,QN,89-15 90 STREET,01,A5,"LIAO, STEVEN",2,1,1
9834,4090550025,QN,97-32 85 STREET,01,B1,"REHMAN, RAO F",2,1,1
9835,4090870041,QN,86-03 102 AVENUE,02,C0,"BALTAZAR, MODESTA",2,1,1
9836,4092040049,QN,108-13 JAMAICA AVENUE,04,S2,108 GOOD FORTUNE LLC,2,1,1
9837,4092340025,QN,84-40 LEFFERTS BOULEVARD,02,C3,NORTH CONDUIT AVENUE CORP.,2,1,1
9838,4092790088,QN,125-11 JAMAICA AVENUE,04,S2,125-11 CORP.,2,1,1
9839,4093000069,QN,87-25 110 STREET,02,C0,FERREIRA DANIEL,2,1,1
9840,4094130007,QN,111-18 95 AVENUE,02,C0,"SINGH, GURCHARANJIT",2,1,1
9841,4094520015,QN,95-22 118 STREET,01,B2,"SINGH, AGYAPAL",2,1,1
9842,4094870049,QN,101-55 LEFFERTS BOULEVARD,02,C0,"SINGH, SANTOKH",2,1,1
9843,4095010022,QN,102-24 134 STREET,01,B3,"LALL, KAMALA DEVI",2,1,1
9844,4095440069,QN,107-27 106 STREET,01,A1,"SHANKAR, RANDY",3,2,1
9845,4095470040,QN,107-68 110 STREET,01,B3,BERNARD RODRIGUES,2,1,1
9846,4095530056,QN,107-47 115 STREET,01,B3,BIBI FAZILA KHAN,2,1,1
9847,4095730043,QN,104-52 120 STREET,01,B3,JOSEPH MERLINO,2,1,1
9848,4095910012,QN,104-20 132 STREET,01,B1,MONICA NAUTH,2,1,1
9849,4098290048,QN,87-70 173 STREET,03,D4,PARK SANFORD OWNERS C,2,1,1
9850,4102070050,QN,111-36 170 STREET,01,A1,"SETTLES, BARBARA ANN",2,1,1
9851,4102320047,QN,173-41 103 ROAD,01,A1,"PRADHANANG, SANTOSH",2,1,1
9852,4102330198,QN,173-48 103 ROAD,01,A1,"GUERRERO, MARIO",2,1,1
9853,4102400057,QN,171-09 107 AVENUE,01,B2,ORTEGA MIGUEL,2,1,1
9854,4102820124,QN,111-12 173 STREET,01,A1,"COLLADO, RENE",2,1,1
9855,4103110006,QN,114-04 180 STREET,01,A1,"OWEN, KISHA A",2,1,1
9856,4104430018,QN,188-13 JAMAICA AVENUE,04,S2,RONG CHAN S,2,1,1
9857,4104740323,QN,93-28 201 STREET,01,A1,"PASHA, BIBI",2,1,1
9858,4105160059,QN,87-02 PALERMO STREET,01,A1,"ABRAHAM, JACK",2,1,1
9859,4105550027,QN,93-03 HOLLIS COURT BLVD,01,A2,SAINCHAND,2,1,1
9860,4106610098,QN,89-46 218 STREET,01,A1,EILEEN ALIOTO,2,1,1
9861,4107240015,QN,94-32 220 STREET,01,B2,"VICCHIULLO, FRANCES",2,1,1
9862,4108460008,QN,99-04 200 STREET,01,A1,"SOPHIA GREENE, TRUSTEE",2,1,1
9863,4108640040,QN,197-05 104 AVENUE,01,A1,"IRGENS,   O. CHRISTIAN",2,1,1
9864,4109030023,QN,104-32 204 STREET,01,A1,BELL NANCY O,2,1,1
9865,4109480087,QN,110-16 208 STREET,01,B3,HECTOR ZAMOR PAULETTE,2,1,1
9866,4109820188,QN,112-40 FRANCIS LEWIS BLVD,05,O1,M.A.M. MANAGEMENT LLC,7,6,1
9867,4110340031,QN,194-54 115 AVENUE,01,A1,CAREW  LAURAINE E,2,1,1
9868,4110580006,QN,116-37 FARMERS BOULEVARD,01,B3,ANITA ELDER,2,1,1
9869,4110630050,QN,192-19 LINDEN BOULEVARD,04,S9,"MCKENZIE, LLOYD",2,1,1
9870,4111020033,QN,104-24 217 STREET,01,B2,"FILEUS, MIMOSE",2,1,1
9871,4111170028,QN,109-03 214 STREET,01,A1,"MICHEL, CLIFFORD",2,1,1
9872,4112140034,QN,218-39 113 AVENUE,01,B1,"THOMPSON, KEITH",3,2,1
9873,4114990126,QN,97-17 134 ROAD,01,A1,"QUESADA, MARCIA V",2,1,1
9874,4115550035,QN,149-60 HURON STREET,01,A1,"ALVARADO-TORRES, DANIEL",2,1,1
9875,4115960023,QN,109-32 116 STREET,01,B3,"FAZIL, ROSHAN",3,2,1
9876,4116030037,QN,122-09 111 AVENUE,01,B3,"LATCHMAN, SATYA",2,1,1
9877,4116320004,QN,127-08 111 AVENUE,11,V9,111 AVENUE REALTY LLC,2,1,1
9878,4117060017,QN,114-57 114 STREET,01,B3,"LAMAZE, JOSEPH C",2,1,1
9879,4117560070,QN,120-85 132 STREET,01,A1,WILSON DOROTHY,2,1,1
9880,4118960026,QN,150-19 127 STREET,01,B3,"HARNARAIN, LILLAWATTE",2,1,1
9881,4120060073,QN,116-43 146 STREET,01,A1,"KEMRAJ, KESHWAR P",2,1,1
9882,4120140024,QN,117-38 142 PLACE,01,A1,"SMITH, KATIE",2,1,1
9883,4120230104,QN,119-16 144 STREET,01,A1,"SMITH, LILLIETH",2,1,1
9884,4120270047,QN,119-05 146 STREET,01,A1,"TALAWANT , BALRAJ",2,1,1
9885,4120350005,QN,120-31 142 STREET,01,A1,"NANAN, SURUJBALLIE",2,1,1
9886,4120370137,QN,142-33 122 AVENUE,01,A1,"ACHUNIKE, MARTIN",2,1,1
9887,4120680118,QN,128-24 145 STREET,01,B2,"TEJADA, JHONNY",2,1,1
9888,4121060058,QN,147-19 130 AVENUE,01,A1,BRUCE KIRKLAND AND EBONY G. KIRKLAND IRR EVOCABLE,3,2,1
9889,4121840064,QN,150-17 114 ROAD,01,B1,EVA GUZMAN SANTOS,3,2,1
9890,4122040330,QN,150-29 118 AVENUE,01,A1,DENISE MOORE,3,2,1
9891,4122520024,QN,161-34 120 AVENUE,01,A1,"CHRISTMAS, LAWRENCE A.",2,1,1
9892,4127360018,QN,117-26 220 STREET,01,A2,"PROSPER , MARIE",2,1,1
9893,4129100064,QN,130-12 232 STREET,01,A2,SHEILA POWELL,2,1,1
9894,4130450017,QN,218-18 140 AVENUE,01,A1,"BETHEA, TRUSS",2,1,1
9895,4130750064,QN,143-38 181 STREET,01,B2,LEWIS  MARIE,2,1,1
9896,4132710013,QN,159-25 ROCKAWAY BOULEVARD,11,V1,THE BANK OF NEW YORK,2,1,1
9897,4133160028,QN,178-37 145 AVENUE,01,B3,"DWARKA, GAITREE D",2,1,1
9898,4134360066,QN,147-30 224 STREET,01,B2,14730 224TH STREET 2016 INC.,2,1,1
9899,4135760050,QN,142-41 249 STREET,01,B3,"CHRISTOPHER, FABIAN",2,1,1
9900,4135770030,QN,250-02 MEMPHIS AVENUE,01,B3,"MATHIEU, HUGUES",2,1,1
9901,4135980025,QN,140-17 246 STREET,01,A5,"LERAY, DIONE",2,1,1
9902,4136460027,QN,149-74 253 STREET,04,S1,KEVIN D RHULE,3,2,1
9903,4136610025,QN,147-18 257 STREET,01,A5,TALAMO SOPHIE,2,1,1
9904,4141780017,QN,159-24 99 STREET,01,A1,OSZART GRACE,2,1,1
9905,4141990003,QN,97-06 162 AVENUE,01,B3,"ALI, YOUSUF",2,1,1
9906,4142451372,QN,99-52 JAMES COURT,01,A1,HILGENDORF  EDWARD,2,1,1
9907,4153080007,QN,929 SHAD CREEK ROAD,01,A2,TIMOTHY OTT,2,1,1
9908,4154000005,QN,123 6 ROAD,01,A2,CAROL ANN FRANK,2,1,1
9909,4155000080,QN,25 VAN BRUNT ROAD,05,K1,"MARTELLI, ANTHONY",3,2,1
9910,4157140057,QN,10-90 GIPSON STREET,01,B3,"ALFONSO, SANTOS HILARIA",2,1,1
9911,4157170057,QN,11-12 DICKENS STREET,01,B3,LAYNE JONATHAN C,3,2,1
9912,4157880117,QN,29-14 BROOKHAVEN AVENUE,01,B2,"HOSSAIN, MD SHORUB",2,1,1
9913,4160360008,QN,516 BEACH 69 STREET,02,C0,"PLIEGO, FRANCISCO",3,2,1
9914,4160500057,QN,69-44 THURSBY AVENUE,01,B3,"HARRIS , GLORIA  C",2,1,1
9915,4160670033,QN,451 BEACH 72 STREET,01,B3,ROYALE HOMES CORP,2,1,1
9916,4161740023,QN,101-19 ROCKAWAY BEACH BLVD,04,K4,CH102 HOLDING LLC,2,1,1
9917,4162020006,QN,120-07 BEACH CHANNEL DRIVE,01,A1,DELIGIANNIS GEORGE,2,1,1
9918,4162110056,QN,422 BEACH 130 STREET,01,A1,STEPHEN MC DADE,2,1,1
9919,4162430066,QN,540 BEACH 132 STREET,01,B3,DRURY NOEL,2,1,1
9920,4162830059,QN,140 BEACH 139 STREET,01,A3,MARIA COMPAGNONE,2,1,1
9921,4162850068,QN,154 BEACH 141 STREET,01,A1,William G. Schrager,2,1,1
9922,5000540015,SI,81 HIGHVIEW AVENUE,01,B2,JOSEPH F MAHONEY,3,2,1
9923,5000700020,SI,814 RICHMOND TERRACE,06,E1,CAROB HOLDINGS LLC,2,1,1
9924,5000730136,SI,139 HENDERSON AVENUE,01,A1,ROBERT SKOP,2,1,1
9925,5000780032,SI,21 AMELIA COURT,01,A1,"SCHIAZZA, MATTHEW X",2,1,1
9926,5000800025,SI,282 YORK AVENUE,01,B9,KASTRATI VEHAT,2,1,1
9927,5001070030,SI,28 KINGSLEY PLACE,02,C3,ZSTAR GROUP LLC,4,3,1
9928,5001570090,SI,41 ELM STREET,01,B2,"DIAZ GARCIA, FROYLAN",2,1,1
9929,5001600004,SI,622 HENDERSON AVENUE,01,B3,"DIAZ, CLEMENTE",2,1,1
9930,5002120071,SI,252 TAYLOR STREET,01,A1,THOMAS J. ALLEN,2,1,1
9931,5002150081,SI,723 POST AVENUE,01,A1,ANTHONY MARINO JR,2,1,1
9932,5002300028,SI,766 DELAFIELD AVENUE,01,A1,"CHODNICKI, MICHAL",2,1,1
9933,5002490048,SI,31 UNIVERSITY PLACE,01,B9,JOHN A ODDO,2,1,1
9934,5002930037,SI,10 HARTFORD AVENUE,01,A1,CRUZ LUIS,2,1,1
9935,5003420003,SI,147 FAIRVIEW AVENUE,01,A1,JAMES COSTELLO,2,1,1
9936,5003500012,SI,1765 VICTORY BOULEVARD,04,K4,RW DEVELOPMENT CORP,4,3,1
9937,5003650171,SI,29 MERRIMAN AVENUE,01,A1,"MELFI, CHRISTOPHER",2,1,1
9938,5003930001,SI,20 ELDRIDGE AVENUE,01,A1,"COOPER, BRENDA",2,1,1
9939,5004050033,SI,438 COLLEGE AVENUE,01,B2,"PELLARELLA, SCOTT",2,1,1
9940,5004100024,SI,164 SPRINGFIELD AVENUE,01,A0,"MORRIS, JESSICA",2,1,1
9941,5004350009,SI,247 ST JOHN AVENUE,01,A1,PETER G. SIUZDAK,2,1,1
9942,5004470003,SI,235 WATCHOGUE ROAD,01,A2,SONIA NEYROT,2,1,1
9943,5004550024,SI,279 LIVERMORE AVENUE,01,A2,"ARONSEN, STEVEN",3,2,1
9944,5004790042,SI,200 CASWELL AVENUE,01,A2,"CIPRIANO, EMIL P",2,1,1
9945,5004980072,SI,224 BAY STREET,04,K4,MILLWASP REALTY LLC,2,1,1
9946,5005270061,SI,215 CANAL STREET,04,S2,"GALARZA, JOHN",2,1,1
9947,5005770021,SI,41 CRESTON PLACE,01,B1,HOLTERMANN NEIL,2,1,1
9948,5006090055,SI,23 SUNNYSIDE TERRACE,01,A2,"TOCI, NJOMZA",2,1,1
9949,5007170023,SI,42 GANSEVOORT BOULEVARD,01,A1,WESTSIDE GUY REALTY LLC,2,1,1
9950,5007270028,SI, BRADLEY AVENUE,11,V0,KWANG B LEE,2,1,1
9951,5007470012,SI,14 CRAFTON AVENUE,01,B2,SYNIEWSKI GARY,2,1,1
9952,5007850001,SI,665 WOOLLEY AVENUE,01,A2,"KANE, MARGUERITE C",2,1,1
9953,5008240050,SI,428 BRADLEY AVENUE,01,B2,REINALDO GARCIA,2,1,1
9954,5008410032,SI,181 SPRING STREET,01,A3,"CONGIUSTA, ROBERT A",2,1,1
9955,5008600014,SI,140 RIDGE AVENUE,01,A1,"ANANTHARAM, PLACHIKKAT",2,1,1
9956,5009370001,SI,1465 MANOR ROAD,09,Q9,BOY SCOUTS OF AMERICA,13,12,1
9957,5009500398,SI,20 MILBURN STREET,01,A2,"HANNA, CHRISTINE A",2,1,1
9958,5010130055,SI,9 BOND STREET,01,A1,"HERNANDEZ, GERMAN",2,1,1
9959,5010260010,SI,99 SIMONSON PLACE,01,B2,"AGUGLIARO, MICHELANGELO",2,1,1
9960,5010740035,SI,19 FABER STREET,01,B2,TOYIN SOKOYA,2,1,1
9961,5010860107,SI,88 TREADWELL AVENUE,01,B2,"BANKS, FELICIA",2,1,1
9962,5011070036,SI,2581 RICHMOND TERRACE,06,F2,UNAVAILABLE OWNER,13,12,1
9963,5011440010,SI,61 BOWLES AVENUE,01,A1,ANDREA MARTINEZ,2,1,1
9964,5011790012,SI,31 WESTBROOK AVENUE,01,B2,"GARCIA, EULALIA",2,1,1
9965,5011940080,SI,218 SIMONSON AVENUE,01,A1,ADEMOLA SAPARA,2,1,1
9966,5012300046,SI,30 GRIDLEY AVENUE,01,A1,"LEAR, PATRICIA",2,1,1
9967,5012540006,SI,151 SOUTH AVENUE,01,A1,"MOUSTAFA, SHAIMAA",2,1,1
9968,5012610065,SI,285 SOUTH AVENUE,01,B3,"KEMPSTER, ROBERT",2,1,1
9969,5012770266,SI,104 MACORMAC PLACE,01,A9,"ANDERSEN, DEBRA",3,2,1
9970,5021100018,SI,913 TRAVIS AVENUE,01,B9,"MICELI, SR., NICHOLAS",2,1,1
9971,5026610020,SI,4358 VICTORY BOULEVARD,04,K4,"DIECI, LLC",3,2,1
9972,5028440073,SI,58 LYNHURST AVENUE,02,C3,LUKOVIC ABEDIN,2,1,1
9973,5028490031,SI,158 VERMONT AVENUE,01,A2,MICHAIL PAPAMICHALAKIS,2,1,1
9974,5029720018,SI,195 VIRGINIA AVENUE,01,A5,"TAYAG, JOSELITO V",2,1,1
9975,5030400048,SI,26 POUCH TERRACE,01,B1,"ACIERNO, ANNIE L",2,1,1
9976,5031200033,SI,8 CEDAR AVENUE,01,A5,"VISCUSO, CHRISTOPHER",2,1,1
9977,5031830049,SI,65 COLUMBUS AVENUE,05,O7,65 COLUMBUS REALTY LLC,2,1,1
9978,5032800001,SI,11 CAMBRIA STREET,01,A1,YEFIM LEVINTOV,2,1,1
9979,5032800068,SI,72 PIAVE AVENUE,01,A2,"MARINO, NORA C",2,1,1
9980,5033260052,SI,1435 HYLAN BOULEVARD,05,K2,1435-1437 HYLAN BLVD LLC,3,2,1
9981,5033420077,SI,235 SEAVIEW AVENUE,01,A5,VITO PELLICANE,2,1,1
9982,5033430097,SI,147 LIBERTY AVENUE,01,A5,THOMAS PACCIONE,2,1,1
9983,5033930013,SI,29 SCOTT AVENUE,01,A5,"SMAILOVIC, VESEL",2,1,1
9984,5033960034,SI,279 OLYMPIA BOULEVARD,01,B2,ADELE E. CRONIN,2,1,1
9985,5035570055,SI,148 JEFFERSON AVENUE,01,A2,VICTORINO S POTENCION,2,1,1
9986,5036160060,SI,280 PRESCOTT AVENUE,01,B2,"RODRIGUEZ, JORGE",2,1,1
9987,5038860050,SI,379 FREEBORN STREET,01,A2,"BEJAR, CHRISTOPHER",2,1,1
9988,5041920015,SI,65 ROSE AVENUE,04,O8,UNAVAILABLE OWNER,2,1,1
9989,5044310003,SI,321 NATICK STREET,01,A1,WILLIAM A SWEITZER,2,1,1
9990,5044470108,SI,6A REVERE LANE,01,A5,ARDIANA MARISENOVIC,2,1,1
9991,5052640046,SI,280 ROBINSON AVENUE,01,A1,"BOWEN, DENNIS J",2,1,1
9992,5052680146,SI,280 WINCHESTER AVENUE,01,A1,"JESLAR, LLC",2,1,1
9993,5053060026,SI,158 WIMAN AVENUE,01,A1,R GELARDI,2,1,1
9994,5053060081,SI,182 TENNYSON DRIVE,01,A5,MARILYN BARONE,2,1,1
9995,5055310033,SI,3363 RICHMOND AVENUE,04,O8,3363 RICHMOND AVE LLC,2,1,1
9996,5056220032,SI,599 ANNADALE ROAD,01,A5,PATRICIA A CONDON,2,1,1
9997,5056560023,SI,23 ANNADALE ROAD,01,A5,"RABO, MEDIATRIX V",2,1,1
9998,5060150043,SI,14 BELFIELD AVENUE,01,A5,AAM REAL ESTATE HOLDINGS LLC,2,1,1
9999,5062640025,SI,222 RATHBUN AVENUE,01,A1,LAWRENCE SCHREIB,2,1,1
10000,5062650007,SI,257 RATHBUN AVENUE,01,B2,"FODER, FRANK",2,1,1
10001,5062710015,SI,472 JEFFERSON BOULEVARD,01,A1,VIRGINIA REMINI,2,1,1
10002,5063380088,SI,610 SHELDON AVENUE,01,B2,"SAGONA, THOMAS J",2,1,1
10003,5065320013,SI,128 CHESTER AVENUE,01,A1,DOMINICK SCIORTINO,2,1,1
10004,5067410047,SI,132 BURTON AVENUE,01,B2,"DIMAGGIO, SILVANA",2,1,1
10005,5068380004,SI,817 MARCY AVENUE,01,A3,"PACUKU, ANTONIO BEKIM",2,1,1
10006,5068580066,SI,5765 AMBOY ROAD,04,S1,5765 REALTY LLC,2,1,1
10007,5068870056,SI,893 RENSSELAER AVENUE,01,B2,"INGRAVALLO, PIETRO",2,1,1
10008,5070140077,SI,15 WOODROSE LANE,01,A1,"CIABURRI, MICHAEL A",2,1,1
10009,5073190020,SI,112 PEMBROOK LOOP,01,A5,GREGORY DAVIDOV,2,1,1
10010,5077860035,SI,195 BEDELL AVENUE,01,A1,"MORANDI, MICHELLE",2,1,1
10011,5078570090,SI,7455 HYLAN BOULEVARD,08,P7,NYC DEPARTMENT OF PARKS AND RECREATION,2,1,1
10012,5079270024,SI,112 ASPINWALL STREET,01,A1,John M. Puca,2,1,1
10013,5079710005,SI,20 RICHMOND VALLEY ROAD,01,B2,UNAVAILABLE OWNER,2,1,1
10014,5080350017,SI,257 HECKER STREET,01,A1,"SMITH, JESSICA MARIE",2,1,1
10015,1003000021,MN,33 ALLEN STREET,04,C7,SIU YAN REALTY LLC,2,1,1
10016,1004780023,MN,186 BOWERY,04,K4,186 BOWERY LLC,2,1,1
10017,1004920041,MN,5 SPRING STREET,04,C7,AVIV ASSOCIATES LLC,2,1,1
10018,1005260022,MN,194 BLEECKER STREET,02,C6,194 BLEECKER OWNERS CORP,2,1,1
10019,1005750074,MN,49 WEST 11 STREET,02,C1,49 WEST 11TH STREETLLC,2,1,1
10020,1006650014,MN, MARGINAL STREET,07,T2,NYC DEPARTMENT OF SMALL BUSINESS SERVICES,2,1,1
10021,1007090001,MN,456 11 AVENUE,07,G9,U I RLTY INC,2,1,1
10022,1008050007,MN,155 WEST 29 STREET,06,F9,"TOPAL, STEVEN L",2,1,1
10023,1008887501,MN,157 EAST 32 STREET,04,RM,LISOLA CONDOMINIUM,2,1,1
10024,1011340010,MN,60 LINCOLN CENTER PLAZA,09,Q1,NYC DEPARTMENT OF PARKS AND RECREATION,2,1,1
10025,1013730050,MN,900 MAIN STREET,08,I1,NYC HEALTH AND HOSPITALS CORPORATION,4,3,1
10026,1013880116,MN,29 EAST 73 STREET,04,S3,MYRNA DE JESUS,2,1,1
10027,1014750005,MN,500 EAST 63 STREET,03,D3,THE ROCKEFELLER UNIVERSITY,3,2,1
10028,1015790002,MN,1556 YORK AVENUE,03,D1,1556-60 YORK AVENUE LLC,4,3,1
10029,1020250002,MN,265 WEST 139 STREET,01,A5,"ISAM SALAH 2019 REVOCABLE TRUST, ISAM SA LAH AS TTE",2,1,1
10030,1020670001,MN,1861 AMSTERDAM AVENUE,08,I5,1861 AMSTERDAM AVENUE LLC,2,1,1
10031,2023890055,BX,457 EAST 167 STREET,01,B2,"ROMERO, ROCIO",2,1,1
10032,2027000028,BX,1068 HALL PLACE,01,A1,URBANA SANCHEZ,2,1,1
10033,2027710177,BX,415 BARRETTO STREET,06,F4,"WAYPOINT REALTY, LLC",2,1,1
10034,2027770230,BX,1301 RYAWA AVENUE,06,E1,HDH3.1 LLC,3,2,1
10035,2028410078,BX,141 MARCY PLACE,01,A1,CHURCH OF CHRIST THE,2,1,1
10036,2029330025,BX,1362 FRANKLIN AVENUE,01,A1,"JORDAN, ALMA",2,1,1
10037,2029580042,BX,1832 MOHEGAN AVENUE,01,A1,XIPENG CHEN,2,1,1
10038,2029660111,BX,1476 LOUIS NINE BOULEVARD,01,A2,"BERRIOS, MILDRED",2,1,1
10039,2030820022,BX,2164 HUGHES AVENUE,01,A1,"JOHNSON, JOANN",3,2,1
10040,2032900064,BX,2775 POND PLACE,02,C0,"COOPER, HOPE NAOMI",2,1,1
10041,2033800013,BX,4428 VAN CORTLANDT PARK E,01,A1,"GIACCONE, DONALD",2,1,1
10042,2033870041,BX,4347 MARTHA AVENUE,01,B2,AUSTIN RYNNE,2,1,1
10043,2034290343,BX,311 HARDING PARK,01,A1,"ROGNAC, SANDRA",2,1,1
10044,2034570025,BX,236 NEWMAN AVENUE,01,B9,ISRAEL CRUZ,3,2,1
10045,2036980001,BX,866 HAVEMEYER AVENUE,01,A1,"SEETARAM, GOVINDRANAUTH",2,1,1
10046,2037660065,BX,1233 LELAND AVENUE,01,A1,"AZAD, ABUL K",2,1,1
10047,2038620032,BX,1329 ELDER AVENUE,01,B1,"REYES, DIEGO",2,1,1
10048,2038990064,BX,1407 TAYLOR AVENUE,01,B2,"GOBIN, YASUDAS",2,1,1
10049,2039180023,BX,1762 EAST TREMONT AVENUE,02,C3,"GIR, SUNITA",2,1,1
10050,2039350017,BX,1316 PURDY STREET,02,C0,PHULMATTIE MEHMOOD,2,1,1
10051,2040110125,BX,1956 BIRCHALL AVENUE,11,V1,JIMJOR CORPORATION,2,1,1
10052,2040520001,BX,765 MORRIS PARK AVENUE,05,K1,"MJB, LLC",2,1,1
10053,2041930033,BX,1865 EDISON AVENUE,02,C3,"SYRAGAKIS, KRISTINA",2,1,1
10054,2044240017,BX,2428 BRONX PARK EAST,01,A1,BRONX PARK EAST APARTMENTS LLC,2,1,1
10055,2044360038,BX,2445 BARNES AVENUE,02,C0,"DATULAYTA, PAULINE",2,1,1
10056,2044820027,BX,2542 WOODHULL AVENUE,01,B3,"GONZALEZ, ANGEL",2,1,1
10057,2045190007,BX,2714 HONE AVENUE,01,B1,PIETRO ELIA,2,1,1
10058,2046320019,BX,792 MAGENTA STREET,01,B2,OCASIO  LYDIA,2,1,1
10059,2047390046,BX,3222 WILSON AVENUE,01,A5,"S. PERSISTENCE, LLC",2,1,1
10060,2047560031,BX,3205 ELY AVENUE,02,C0,UNAVAILABLE OWNER,2,1,1
10061,2048600080,BX,956 EAST 225 STREET,02,C0,DENNIS BINNS,2,1,1
10062,2050120018,BX,4215 BRUNER AVENUE,01,A1,"GORDON, DONNETTE",2,1,1
10063,2050600001,BX,4317 NEREID AVENUE,08,W2,MARIST BROTHERS,10,9,1
10064,2052630192,BX,3441 BIVONA STREET,08,W1,SCHOOL CONSTRUCTION AUTHORITY,2,1,1
10065,2053110057,BX,2935 HASKIN STREET,01,A2,"ROBINSON, DAVID J",2,1,1
10066,2053320031,BX,1236 PURITAN AVENUE,01,A2,FURNARI MICHAEL T,2,1,1
10067,2053900030,BX,2927 CODDINGTON AVENUE,01,A2,"BRANT, ROBERT J",2,1,1
10068,2054080314,BX,1327 STADIUM AVENUE,01,A1,"MOGAR, MUKUND",2,1,1
10069,2054160034,BX,1639 RESEARCH AVENUE,01,A2,"BALUKAS, DARLA LYNN",2,1,1
10070,2054250041,BX,3011 LAFAYETTE AVENUE,01,A2,"DEJESUS, MICHAEL A",2,1,1
10071,2054750053,BX,750 ELLSWORTH AVENUE,01,A5,"GALIFI, MARIA",2,1,1
10072,2054830006,BX,612 ELLSWORTH AVENUE,01,A1,ROBERT T HUOT,2,1,1
10073,2055180189,BX,3145 WISSMAN AVENUE,01,B2,FRANCIS V SALIMBENE,2,1,1
10074,2056010032,BX,270 EMERSON AVENUE,01,B1,"CLEMENTZ, RAYMOND",2,1,1
10075,2056260290,BX,101 EARLEY STREET,01,A1,"LYNCH, AS LIFE TENANT, RITA V",2,1,1
10076,2056290261,BX,69 CAROLL STREET,01,A1,"AMOS, MARK H",2,1,1
10077,2056440069,BX,149 FORDHAM STREET,04,S2,"FCA & V, LLC",2,1,1
10078,2056460069,BX,490 MINNIEFORD AVENUE,01,A1,VITTINA M PERRONE,2,1,1
10079,2057630554,BX,3425 TIBBETT AVENUE,01,A5,"LOBSIGER, FRANNILBA",2,1,1
10080,2058481758,BX,5658 MOSHOLU AVENUE,01,B9,EUGENE M MONE,2,1,1
10081,3003790009,BK,545 CLINTON STREET,02,C0,"TRANI, ANTHONY III",2,1,1
10082,3006300046,BK,157 18 STREET,01,B9,SIMON KAHN,2,1,1
10083,3006400001,BK,657 4 AVENUE,08,W2,BROOKLYN CULTURAL CENTER OF NEW YORK INC,3,2,1
10084,3006400049,BK,217 21 STREET,01,A2,BLACK ROCK EQUITIES LTD.,2,1,1
10085,3006810001,BK,867 4 AVENUE,11,V1,875 4TH AVENUE ACQUISITION LLC,3,2,1
10086,3008870059,BK,411 20 STREET,01,B2,"HERNANDEZ, HARRY",2,1,1
10087,3009130009,BK,3903 5 AVENUE,04,S2,MMM FAMILY REALTY LLC,2,1,1
10088,3009980018,BK,278 7 STREET,02,C0,"BELLONE, MARK",2,1,1
10089,3012190069,BK,641 ST MARKS AVENUE,02,C1,PROSPECT BROOKLYN REALTY LLC,2,1,1
10090,3012480046,BK,907 ST JOHNS PLACE,02,C2,MHANY 2015 HOUSING DEVELOPMENT FUND CORP,2,1,1
10091,3012860063,BK,1411 CARROLL STREET,01,B1,SHANOWITZ ZALMAN,2,1,1
10092,3012900071,BK,303 CROWN STREET,02,C3,"EMANUEL, NORBERT",2,1,1
10093,3013400011,BK,107 ALBANY AVENUE,02,C3,"VAZIRANI, ROSHAN",2,1,1
10094,3016820058,BK,255 BAINBRIDGE STREET,01,B3,ROBERT E JACKSON,2,1,1
10095,3017040062,BK,897 HERKIMER STREET,02,C1,INSPIRED PROPERTIES NY LLC,2,1,1
10096,3017120022,BK,894 HERKIMER STREET,01,A9,SHERRY A BARKER,3,2,1
10097,3017820019,BK,862 DEKALB AVENUE,04,D7,862-866 DEKALB LLC,3,2,1
10098,3018940050,BK,106 EMERSON PLACE,02,C0,106 EMERSON LLC,2,1,1
10099,3025170150,BK,427 GREENPOINT AVENUE,06,F8,"UNITED BIOFUELS, INC.",2,1,1
10100,3026190030,BK,85 NORMAN AVENUE,01,B9,"MARTEL, WESLEY",2,1,1
10101,3026510017,BK,105 DIAMOND STREET,01,A2,"HREBENKO, ARTUR",2,1,1
10102,3027037501,BK,169 ENGERT AVENUE,02,R2,UNAVAILABLE OWNER,6,5,1
10103,3027710017,BK,192 DEVOE STREET,01,Z0,MILLAMENA JOEL,2,1,1
10104,3028050017,BK,850 MEEKER AVENUE,06,E1,"E & J CAPUTO, LLC",4,3,1
10105,3030510020,BK,137 MANHATTAN AVENUE,02,C1,137 MANHATTAN USA LLC,2,1,1
10106,3031640003,BK,79 CENTRAL AVENUE,02,C2,ZOURTSA HOLDINGS LLC,2,1,1
10107,3032100022,BK,1282 WILLOUGHBY AVENUE,06,E1,GUYANA PLATING LLC,2,1,1
10108,3032360052,BK,1493 DEKALB AVENUE,04,S2,JI PING YU,2,1,1
10109,3032740001,BK,871 BUSHWICK AVENUE,08,N3,BUSHWICK REALTY HOLDINGS LLC,5,4,1
10110,3033680001,BK,503 EVERGREEN AVENUE,04,D7,503 EVERGREEN AVENUE LLC,2,1,1
10111,3033860047,BK,418 CORNELIA STREET,01,B2,"ESPINAL, TEOLINDA",2,1,1
10112,3034250006,BK,837 KNICKERBOCKER AVENUE,04,S1,"HUESCA, CARLOS E",2,1,1
10113,3034250017,BK,308 COVERT STREET,02,C2,INK 308 LLC,2,1,1
10114,3034860021,BK,15 MARGINAL ST EAST,01,B2,15 MARGINAL 2019 LLC,2,1,1
10115,3035810021,BK,301 GRAFTON STREET,01,B1,HARRIS MICHAEL,2,1,1
10116,3036630035,BK,50 BRADFORD STREET,01,B3,"AGUILAR, MELQUIZEDEC",2,1,1
10117,3036910028,BK,471 LIBERTY AVENUE,01,A1,471 LIBERTY LLC,2,1,1
10118,3037130001,BK,1885 PITKIN AVENUE,,Z9,GERSHOW RECYCLING OFBROOKLYN INC,4,3,1
10119,3037420021,BK,2190 PITKIN AVENUE,04,S9,101-7 LLC,2,1,1
10120,3038850187,BK,129 HIGHLAND BOULEVARD,01,B2,"APPARICIO, MYRTLE",2,1,1
10121,3038900423,BK,68 BULWER PLACE,01,A1,"HAMPTON, SAUNDRA  D",2,1,1
10122,3039250050,BK,104 ELTON STREET,01,B2,SHIWNATH DEORAJ,2,1,1
10123,3039270001,BK,189 LINWOOD STREET,10,G0,"PADARATHSKI, DAYE",2,1,1
10124,3041750035,BK,331 GRANT AVENUE,01,B2,MARQUEZ INEZ,2,1,1
10125,3042590022,BK,1485 SUTTER AVENUE,02,C0,RAMJIT WAYNE,2,1,1
10126,3043030066,BK,661 BRADFORD STREET,02,C0,"SAINT-CYR, LEASTA",2,1,1
10127,3045280013,BK,914 CRESCENT STREET,01,B3,"RIVAS, GUADALUPE",2,1,1
10128,3046100054,BK,183 EAST 91 STREET,02,C0,"ADAMS-PIERRE, YOLANDE",2,1,1
10129,3046110058,BK,153 EAST 92 STREET,01,B1,"MINSKY , FLORENCE",2,1,1
10130,3046130049,BK,161 EAST 94 STREET,01,B1,"SYLVESTER, FIMBER",2,1,1
10131,3046590040,BK,233 EAST 53 STREET,01,B1,"ETIENNE, DAVID",2,1,1
10132,3046630036,BK,923 LINDEN BOULEVARD,01,B2,923 LINDEN BLVD LLC,2,1,1
10133,3046700034,BK,365 EAST 95 STREET,02,C3,FELIX PRINCE C,2,1,1
10134,3046810050,BK,5501 CHURCH AVENUE,04,S9,5501-209 NEW OWNERS INC,2,1,1
10135,3046980017,BK,5024 CHURCH AVENUE,04,K4,"YONG & SUNNY, LLC",2,1,1
10136,3048010005,BK,1141 NOSTRAND AVENUE,08,M9,BEULAH UNITED CHURCH OF GOD INC,2,1,1
10137,3048800023,BK,850 TROY AVENUE,01,B1,"CHARLES, MARCUS",2,1,1
10138,3049180001,BK,3304 TILDEN AVENUE,04,S3,TILDEN INC,3,2,1
10139,3049770022,BK,1298 TROY AVENUE,01,A9,"DOUGLAS, DEXTER",2,1,1
10140,3050280088,BK,33 MAPLE STREET,01,A1,LORETTA A RAMBERT,2,1,1
10141,3050300027,BK,326 LINCOLN ROAD,01,B3,RONALD HING,2,1,1
10142,3050490028,BK,158 WINTHROP STREET,08,W1,NYC DEPARTMENT OF EDUCATION,3,2,1
10143,3051700043,BK,2603 CLARENDON ROAD,01,A5,"GOOD, NANCYE L",2,1,1
10144,3052260021,BK,1360 FLATBUSH AVENUE,04,S2,"CLARO, RAMON",2,1,1
10145,3052640036,BK,656 20 STREET,10,G1,RICHARD W GUTEKUNST JR,2,1,1
10146,3052710028,BK,56 EAST 3 STREET,01,B3,"YIP, FU WAH",2,1,1
10147,3052730034,BK,68 EAST 5 STREET,01,B2,EILEEN SULLIVAN,2,1,1
10148,3052780031,BK,250 SHERMAN STREET,02,C0,250 SHERMAN LLC,2,1,1
10149,3054320034,BK,1666 44 STREET,01,A1,"SILBER, AARON",2,1,1
10150,3054340023,BK,1642 45 STREET,01,A1,"GREENFIELD, CIPORAH",2,1,1
10151,3054660022,BK,1632 51 STREET,01,A1,1632 51ST STREET LLC,2,1,1
10152,3055050045,BK,1881 59 STREET,01,B1,"IZRAILEV, ETELA",2,1,1
10153,3055080049,BK,2173 59 STREET,01,B3,"JAROSLAWITZ, MOISHE",2,1,1
10154,3056200017,BK,1026 46 STREET,02,C0,JOHNSON SAMUEL,2,1,1
10155,3056230054,BK,1357 47 STREET,02,C0,1357 47TH ST REALTY LLC,2,1,1
10156,3056290062,BK,1335 48 STREET,08,M9,CONGREGATION BETH YITZHOIT,2,1,1
10157,3056450024,BK,948 50 STREET,01,B1,"WEISZ, FAIGIE",2,1,1
10158,3056487504,BK,1242 50 STREET,02,R1,UNAVAILABLE OWNER,2,1,1
10159,3056890021,BK,1130 56 STREET,02,C0,DANIEL TERDOSLAVICH,2,1,1
10160,3057200069,BK,1425 61 STREET,01,B1,"CHEN, YUN JUAN",2,1,1
10161,3057760038,BK,6812 15 AVENUE,05,K1,IFC  REALTY CORP.,2,1,1
10162,3058560032,BK,530 67 STREET,01,B2,"WU, HUI BING",2,1,1
10163,3058960064,BK,859 71 STREET,01,B2,"LEMMON, RICHARD",2,1,1
10164,3059750132,BK,8070 HARBOR VIEW TERRACE,08,M3,DIOCESE OF ST MARON USA,2,1,1
10165,3059760058,BK,117 80 STREET,01,A1,"ANGELAKIS, EFSTATHIOS",2,1,1
10166,3059900048,BK,8020 6 AVENUE,01,B1,"LIVANOS, DESPINA",2,1,1
10167,3060010061,BK,919 82 STREET,01,B2,VARANO MARK S,2,1,1
10168,3060420028,BK,156 86 STREET,02,C0,"GHEITH, HASAN",2,1,1
10169,3061200029,BK,128 MARINE AVENUE,03,D1,"BOB GEROULANOS,",2,1,1
10170,3061290057,BK,206 MARINE AVENUE,01,B2,"CHANG, LEONA",2,1,1
10171,3061310006,BK,445 99 STREET,01,A5,"ALVAREZ, ROBERTO H",2,1,1
10172,3062230159,BK,1447 76 STREET,01,A9,"CICCOTTO, JENNIFER",2,1,1
10173,3062350057,BK,1547 77 STREET,01,B1,"DILEO, MICHELE",2,1,1
10174,3062650060,BK,2231 79 STREET,01,B1,SHUN HAN ZHANG,2,1,1
10175,3063227501,BK,8405 13 AVENUE,04,RM,DYKER APTS CONDOMINIUM,2,1,1
10176,3063370027,BK,1152 85 STREET,01,B1,LEONARD MANCINI,2,1,1
10177,3064137503,BK,127 BAY 28 STREET,02,R3,UNAVAILABLE OWNER,2,1,1
10178,3065110034,BK,866 EAST 9 STREET,01,A1,"SHAMAH, JOSEPH",2,1,1
10179,3065200083,BK,1013 EAST 7 STREET,01,A1,"STEIN, MICHAEL",2,1,1
10180,3065380031,BK,1350 EAST 3 STREET,01,A9,LIBBA B WARSHAVCHIK,2,1,1
10181,3065460084,BK,1207 EAST 10 STREET,01,B1,"GINDI, STEVEN J",2,1,1
10182,3065670034,BK,1450 EAST 5 STREET,01,B2,"SERUYA, BENJAMIN",2,1,1
10183,3065850055,BK,349 AVENUE O,01,A1,DABAH JACK,2,1,1
10184,3065880074,BK,1469 OCEAN PARKWAY,01,B1,", EIDA FAMILY",2,1,1
10185,3066100061,BK,1673 EAST 3 STREET,01,A5,"COHEN, EZRA",2,1,1
10186,3066450037,BK,1768 WEST 11 STREET,01,B3,NOVINI MARIA R,2,1,1
10187,3066560027,BK,1762 DAHILL ROAD,02,C0,"LEUNG, KWOK HO",2,1,1
10188,3066590041,BK,1858 EAST 3 STREET,01,A5,DABAH DAVID,2,1,1
10189,3066680054,BK,1883 WEST 13 STREET,02,C0,"PIACENTI, MARK",2,1,1
10190,3066760076,BK,1823 WEST 5 STREET,02,C0,"LI, RAYMOND",2,1,1
10191,3066820036,BK,1934 EAST 7 STREET,01,A3,"BALASSIANO, LISA",2,1,1
10192,3067230028,BK,1152 EAST 13 STREET,01,A9,MOSHE NOBLE,2,1,1
10193,3068110039,BK,1796 EAST 29 STREET,01,A1,URI SCHWARTZ,2,1,1
10194,3068867501,BK,14 BAY 47 STREET,02,R3,UNAVAILABLE OWNER,2,1,1
10195,3069040017,BK,25 BAY 49 STREET,01,A5,"ANTONELOS, ANASTRASIOS",2,1,1
10196,3069160065,BK,175 28 AVENUE,11,V0,"LI, DA JIN",2,1,1
10197,3069960060,BK,2716 WEST 15 STREET,06,F5,"FAYMAN, OLEG",2,1,1
10198,3071290056,BK,2189 EAST 2 STREET,02,C0,SALIM D KINDI,2,1,1
10199,3071330031,BK,2218 EAST 7 STREET,02,C3,ELI SAFINA HAMADANI,2,1,1
10200,3071350054,BK,2165 EAST 8 STREET,01,B1,"MUSTACCHI, MENACHEM",2,1,1
10201,3071510094,BK,325 AVENUE W,01,A1,"FRANCO, ALLEN",2,1,1
10202,3071750051,BK,2363 WEST 1 STREET,02,C0,DAVID SIU WING NG,2,1,1
10203,3072910098,BK,1928 EAST 13 STREET,01,B1,"CHAIA, AZOZ",2,1,1
10204,3073020066,BK,1955 EAST 23 STREET,01,A1,"ANTAR, EMILY",2,1,1
10205,3073070031,BK,1958 EAST 29 STREET,01,A5,"WU, YULI",2,1,1
10206,3073190068,BK,2033 EAST 14 STREET,01,B1,A & M 33 REALTY LLC,2,1,1
10207,3073220070,BK,2029 EAST 17 STREET,01,A1,"BUKAI, ALBER",2,1,1
10208,3073250079,BK,2467 OCEAN AVENUE,04,O8,"KRUPITSKY, VICTOR",2,1,1
10209,3073710016,BK,2222 EAST 12 STREET,01,A1,ABRAHAM CHWEKEH,2,1,1
10210,3074220424,BK,2452 EAST 24 STREET,01,B1,"ASAS, EZRA",2,1,1
10211,3074410421,BK,2530 EAST 23 STREET,01,B1,"GAGLIARDI, ROSE MARIE",2,1,1
10212,3075600053,BK,1606 NEW YORK AVENUE,01,A1,"HENRY, STANLEY L",2,1,1
10213,3075910016,BK,969 EAST 27 STREET,01,B1,E1 CAPITAL LLC,2,1,1
10214,3076220009,BK,2201 AVENUE L,08,M1,CONGREGATION TORATHCHAI,2,1,1
10215,3076340003,BK,3411 AVENUE L,01,A1,"ZYSKIND, ISRAEL",2,1,1
10216,3076400082,BK,1286 EAST 23 STREET,01,A1,"WEINBERGER, MOSHE",2,1,1
10217,3077120005,BK,3051 AVENUE R,01,A1,"WEINSTIEN, DAVID",2,1,1
10218,3077130026,BK,1715 MARINE PARKWAY,01,A1,CAPITUMMINO MARIA,2,1,1
10219,3077720020,BK,1315 EAST 46 STREET,01,A5,"MACEUS, NATACHA",3,2,1
10220,3078340079,BK,1336 EAST 55 STREET,01,B1,"ALTMAM, JOSEPH",2,1,1
10221,3082180034,BK,1259 EAST 91 STREET,01,B3,GRACE CHURCH OF BROOKLYN NEW YORK INC,2,1,1
10222,3082430016,BK,1733 ROCKAWAY PARKWAY,01,B3,"JOSEPH, PAUL",2,1,1
10223,3082650053,BK,1226 EAST 101 STREET,01,A5,"BALTHAZAR, JOCELYNE",2,1,1
10224,3084770028,BK,1829 EAST 33 STREET,01,A1,"TERMINI, ROBERT",2,1,1
10225,3084920058,BK,1754 EAST 53 STREET,02,C0,"ATTIQUE, MOHAMMAD",2,1,1
10226,3087250001,BK,3317 CONEY ISLAND AVENUE,09,Q4,"LIMONIK, IGOR",3,2,1
10227,3087280093,BK,27 BEAUMONT STREET,01,A5,MERSON ALEXANDER,2,1,1
10228,3087480193,BK,166 FALMOUTH STREET,01,B3,"DADASHEV, OLEG",2,1,1
10229,3087510454,BK,181 HASTINGS STREET,01,A3,"SHUR, MICHAEL",2,1,1
10230,3087570039,BK,141 NORFOLK STREET,01,A1,"LEVITAN, ARKADY",2,1,1
10231,4000460014,QN,10-37 47 ROAD,06,E2,NAKORN REALTY LLC,2,1,1
10232,4000460130,QN,47-02 11 STREET,02,C2,"MANDRACCHIA, ANTHONY",2,1,1
10233,4002610030,QN,49-25 VAN DAM STREET,07,G3,LEEMILTS PETROLEUM INC,2,1,1
10234,4002940280,QN,30-21 GREENPOINT AVENUE,06,E9,3023 GPT LLC,4,3,1
10235,4003610010,QN,37-23 11 STREET,04,S3,HUMMAY PROPERTIES LLC,2,1,1
10236,4004530029,QN,43-35 10 STREET,06,F5,"SLAVKO, ENTERPRISESINC",2,1,1
10237,4004750026,QN,38-21 9 STREET,05,H3,LGR 9TH STREET LLC,7,6,1
10238,4005360042,QN,14-46 30 AVENUE,01,B1,VOCAL FRANCISCO,2,1,1
10239,4005890031,QN,31-27 30 STREET,02,C1,3 V REALTY LLC,2,1,1
10240,4005890036,QN,31-15 30 STREET,02,C2,KEANE ASSOCIATES L P,2,1,1
10241,4006520080,QN,25-82 37 STREET,03,D1,ASTORIA CITADEL LLC,2,1,1
10242,4006530024,QN,25-31 37 STREET,01,A5,"CALDERON, MANUEL",2,1,1
10243,4007810029,QN,23-34 SOUND STREET,01,A2,COLOPEDO CORP,2,1,1
10244,4007810034,QN,23-22 SOUND STREET,01,B3,"CTORIDES, PAULA",2,1,1
10245,4007840062,QN,21-72 45 STREET,01,A5,MARIO ABELA,2,1,1
10246,4008080045,QN,21-30 38 STREET,01,A5,"GURJIAN, VAHRAM",2,1,1
10247,4008190028,QN,23-21 36 STREET,02,C0,PETER BACKOS,2,1,1
10248,4008250062,QN,36-13 21 AVENUE,02,C0,"HUSOVIC, SABIJA",2,1,1
10249,4008420077,QN,23-18 31 STREET,05,O7,PANTZA REALTY CORP,2,1,1
10250,4008630028,QN,24-17 24 STREET,01,B1,"TSOURISTAKIS, ALEXANDER E",2,1,1
10251,4010440028,QN,24-46 81 STREET,01,B2,"HOSSAIN, NARGIS",2,1,1
10252,4012270067,QN,39-20D 57 STREET,02,C0,"CASTILLO, ANABELLA",2,1,1
10253,4013110032,QN,41-17 71 STREET,02,C0,"CHEUNG, TSZ KON",2,1,1
10254,4013490067,QN,69-41 43 AVENUE,02,C0,NN MANAGEMENT CORP.,2,1,1
10255,4014130054,QN,32-43 83 STREET,01,B1,"ESPINAL , JOSE",2,1,1
10256,4014790022,QN,37-38 92 STREET,04,S1,"IGLESIA DEL DIOS,ETCINC",2,1,1
10257,4014860032,QN,40-08 76 STREET,04,D7,KSM MANAGEMENT LLC,2,1,1
10258,4015430025,QN,48-09 POYER STREET,01,B3,"ZOU, LIN  FEI",2,1,1
10259,4015930020,QN,95-05 40 ROAD,02,C0,RODRIGUEZ FERNANDO,2,1,1
10260,4016300030,QN,101-07 46 AVENUE,02,C0,VEZZA ADAMO,2,1,1
10261,4017530031,QN,34-36 110 STREET,02,C2,54-05 LLC,2,1,1
10262,4017600054,QN,37-23 97 STREET,02,C0,FEI YUN HUANG,2,1,1
10263,4017720036,QN,104-19 37 DRIVE,02,C3,"WANG, ZHEN FENG",2,1,1
10264,4017757501,QN,104-19 39 AVENUE,04,RM,UNAVAILABLE OWNER,2,1,1
10265,4018970001,QN,97-09 55 AVENUE,01,A1,ROYAL QUEENS REALTY INC.,2,1,1
10266,4019420096,QN,103-17 52 AVENUE,01,B2,"ZHU, BEN LIANG",2,1,1
10267,4019430026,QN,103-52 52 AVENUE,02,C0,"BAO, THOMSON",2,1,1
10268,4019570019,QN,58-26 GRANGER STREET,01,B1,"CHICAIZA , ALFONSO",2,1,1
10269,4020030068,QN,108-43 48 AVENUE,01,B2,BIRESH INC.,2,1,1
10270,4020090025,QN,108-58 53 AVENUE,02,C2,COSIMO LILLO,2,1,1
10271,4022440005,QN,69-57 112 STREET,01,A1,JABER FARID,2,1,1
10272,4023270012,QN,48-37 58 PLACE,01,B2,"TRUJILLO, OSCAR",2,1,1
10273,4024380011,QN,50-33 69 STREET,02,C3,FONG CHONG MAN LLC,2,1,1
10274,4026320023,QN,52-20 FLUSHING AVENUE,04,S9,B & B 11 LLC,2,1,1
10275,4026970077,QN,59-77 58 ROAD,02,C0,MARIE SHEEHAN,2,1,1
10276,4027110070,QN,61-54 56 DRIVE,01,B3,"WIN, KYAW KYAW",2,1,1
10277,4027470018,QN,60-90 ELIOT AVENUE,07,G4,ELIOT REALTY LLC,2,1,1
10278,4027520023,QN,57-45 65 STREET,01,B2,J FEELY,2,1,1
10279,4027740028,QN,66-36 GRAND AVENUE,04,S3,"66-36 GRAND AVENUE, LLC",2,1,1
10280,4027920020,QN,57-28 69 LANE,01,A1,"RONZO, KIM MARIE",2,1,1
10281,4029070063,QN,54-53 80 STREET,01,A5,"LIN, GUI",2,1,1
10282,4029100020,QN,58-28 84 STREET,01,A1,JIAN ZHONG LI,2,1,1
10283,4030370042,QN,75-27 JUNIPER VALLEY ROAD,01,A5,"VODENICHAROV, OGNYAN",2,1,1
10284,4030540028,QN,66-52 71 STREET,01,B2,"DOBKOWSKI, STANISLAW",2,1,1
10285,4031480017,QN,85-14 68 AVENUE,02,C0,ELISABETA SPATARU IRREVOCABLE TRUST 5/11 /15,2,1,1
10286,4032930045,QN,111-35 75 AVENUE,03,D4,111-35 75 AVE OWNRS C,2,1,1
10287,4033410058,QN,111-07 76 DRIVE,01,A3,"ASEF, HAMID SAYED",2,1,1
10288,4034180001,QN,1808 WILLOUGHBY AVENUE,09,Q1,NYC DEPARTMENT OF EDUCATION,2,1,1
10289,4035250040,QN,61-10 GROVE STREET,02,C0,"ZHAO, SHENG",2,1,1
10290,4035560023,QN,1628 DECATUR STREET,01,B2,"AQUINO, JOSE",2,1,1
10291,4036850067,QN,71-57 69 PLACE,01,B2,YASPARRO LINDA,2,1,1
10292,4037320011,QN,59-04 COOPER AVENUE,01,B2,"TAVERAS, MASSIEL",2,1,1
10293,4037320103,QN,62-52 80 ROAD,01,A1,JOHN L STAMM,2,1,1
10294,4037820059,QN,79-19 68 AVENUE,01,B2,"BALLINAS, ABAD",2,1,1
10295,4038240052,QN,78-57 74 STREET,01,B2,ROCHE MIGUEL A,2,1,1
10296,4038280014,QN,78-33 79 STREET,01,B2,"KNORPP, WERNER JR.",2,1,1
10297,4040030042,QN,11-10 127 STREET,01,A1,"11-10 127TH STREET, LLC",2,1,1
10298,4041640039,QN,21-20 COLLEGE POINT BLVD,04,S4,2120 CP BLVD. LLC,4,3,1
10299,4042600048,QN,122-25 26 AVENUE,01,A2,"SCHIELER, ERIKA",2,1,1
10300,4045450065,QN,154-68 9 AVENUE,01,A1,"CASANAS, MIGUEL JR",2,1,1
10301,4046220063,QN,14-12 146 STREET,01,A1,THOMAS V GEELAN,2,1,1
10302,4047770036,QN,32-14 PARSONS BOULEVARD,08,P9,SALVATION ARMY,2,1,1
10303,4048340067,QN,151-37 29 AVENUE,01,A2,"RASIZZI, CAROL",2,1,1
10304,4050310018,QN,149-44 ROOSEVELT AVENUE,01,B3,"RODRIGUEZ, GERARD  M",2,1,1
10305,4050340005,QN,150-27 41 AVENUE,01,B2,"WANG , CI DI",3,2,1
10306,4052510008,QN,33-69 166 STREET,01,A1,"GIPPETTI, RICHARD JR",2,1,1
10307,4054170066,QN,43-60 160 STREET,01,B2,"LIN, JI",2,1,1
10308,4054410020,QN,45-41 162 STREET,04,S9,A & J CONSULTING MANAGEMENT INC,2,1,1
10309,4055840058,QN,171-21 COURTNEY AVENUE,01,A1,"CHANG, CHENG YEN",2,1,1
10310,4061660019,QN,36-26 211 STREET,01,A1,"ERICKA TANNENBAUM, TRUSTEE",2,1,1
10311,4062050114,QN,39-26 203 STREET,01,B2,DONNA NEOS,2,1,1
10312,4062420022,QN,39-10 214 PLACE,02,C3,STOESSEL FAMILY IRREVOCABLE TRUST,2,1,1
10313,4062830011,QN,42-15 212 STREET,02,C2,"FMC4215, LLC",2,1,1
10314,4063050017,QN,215-15 43 AVENUE,01,B1,ROSEMARY ZIMMERMAN,2,1,1
10315,4067990085,QN,71-48 161 STREET,01,A1,"XIA, YI",2,1,1
10316,4069000058,QN,61-40 173 STREET,01,B1,61-40 HOLDINGS INC,2,1,1
10317,4069560068,QN,71-46 169 STREET,01,A1,THE MATATOV FAMILY IRREVOCABLE TRUST,2,1,1
10318,4071330062,QN,69-57 180 STREET,01,A1,"LIU, JOHN Y",3,2,1
10319,4072550101,QN,184-36 AVON ROAD,01,A1,"ISAKOVA, JANE",2,1,1
10320,4073620028,QN,48-42 204 STREET,01,A5,"CHEN, TAO",2,1,1
10321,4073860041,QN,50-35 OCEANIA STREET,01,B2,"LISA LAM, TRUSTEE",2,1,1
10322,4079520001,QN,233-79 87 AVENUE,01,A1,"MURAL, ROMAN",2,1,1
10323,4082200042,QN,248-47 VAN ZANDT AVENUE,01,A3,LIYI LU,2,1,1
10324,4082500060,QN,252-89 BRATTLE AVENUE,01,A3,"FERAZZOLI, DANIEL M",2,1,1
10325,4086800076,QN,263-10 UNION TURNPIKE,08,M1,NEW YORK ALL NATIONS CHURCH,2,1,1
10326,4088570071,QN,84-39 85 ROAD,01,B3,CHUCK MEE FAM,2,1,1
10327,4088780006,QN,91-26 85 AVENUE,02,C0,"RODRIGUEZ, GRACIELAE",2,1,1
10328,4089000068,QN,88-11 75 STREET,01,B2,BELKIS GARCIA,2,1,1
10329,4089440028,QN,90-34 75 STREET,01,B2,PETAMBER DALCHAN,2,1,1
10330,4089620064,QN,91-25 82 STREET,01,B9,JACQUELINE J HERNANDE,2,1,1
10331,4089940071,QN,91-07 97 STREET,02,C0,BHAG VEER LLC,2,1,1
10332,4090080033,QN,80-03 97 AVENUE,04,S1,"UDDIN, MOHAMMED Y",3,2,1
10333,4090390021,QN,94-24 97 STREET,01,B9,JOSE MAURICIO ROSALES,3,2,1
10334,4091000054,QN,101-41 93 STREET,01,B2,"RODRIGUEZ, MILEDY",2,1,1
10335,4091920056,QN,84-03 106 STREET,01,B3,CHAN TAK-WING,2,1,1
10336,4091930045,QN,84-11 107 STREET,01,B2,"SINGH, AMARPAL",2,1,1
10337,4092400041,QN,84-17 124 STREET,01,B1,"ZHANG, YUETING",2,1,1
10338,4092750039,QN,12108 HILLSIDE AVENUE,04,S2,UNAVAILABLE OWNER,2,1,1
10339,4092950054,QN,104-17 90 AVENUE,01,B3,MARTINEZ  JUAN,2,1,1
10340,4093360043,QN,87-48 129 STREET,01,B1,"ZOU, ZONG RONG",3,2,1
10341,4093750026,QN,91-07 121 STREET,01,A9,"PERSAUD, DAVID",2,1,1
10342,4093900007,QN,9506 107 STREET,02,C0,"D'COSTA, REBECA",3,2,1
10343,4094860024,QN,101-40 LEFFERTS BOULEVARD,01,A1,"SINGH, MANJIT",2,1,1
10344,4095140020,QN,103-28 110 STREET,01,A9,"BUDHOO, DEONARINE",2,1,1
10345,4095450066,QN,107-29 107 STREET,01,B3,"BHOODAI, NEITHRAM",3,2,1
10346,4095510065,QN,107-31 113 STREET,01,B2,"CARRERA, BERNADETH",2,1,1
10347,4095770022,QN,104-44 124 STREET,01,A1,DAVID RAM SAMMY,2,1,1
10348,4095930043,QN,133-05 107 AVENUE,01,A1,DOLORES MICKENS,2,1,1
10349,4096830043,QN,139-16 88 ROAD,01,A1,CESAR A & JANNETH COBOS,2,1,1
10350,4100500010,QN,145-19 LIVERPOOL STREET,08,I7,ST. PIUS V SENIOR HOUSING DEVELOPMENT FU ND CORP,2,1,1
10351,4101460021,QN,157-08 108 AVENUE,01,A1,"BIGORD, JEAN LUC",2,1,1
10352,4101730032,QN,108-01 164 PLACE,01,A1,"CHABRIA, LUCILA",2,1,1
10353,4102290019,QN,171-40 103 ROAD,01,B2,"UDDIN, GOUS",2,1,1
10354,4102340247,QN,173-22 104 AVENUE,01,B1,ROBINSON ANN R,2,1,1
10355,4103330109,QN,177-11 106 AVENUE,01,B1,FATAL MARIE M,2,1,1
10356,4105580017,QN,90-37 208 STREET,01,A1,SEDA STEPHEN,2,1,1
10357,4105580071,QN,90-62 209 STREET,01,A1,"KOOBAIR, DEVIKA",2,1,1
10358,4106160035,QN,93-68 VANDERVEER STREET,01,B3,"SOOKRAM, JASON",2,1,1
10359,4106530054,QN,89-16 212 PLACE,01,A1,"LORD, WILLIAM I",2,1,1
10360,4107060009,QN,220-20 DAVENPORT AVENUE,01,B3,SINGH SUKHJINDER,3,2,1
10361,4107890057,QN,221-11 99 AVENUE,01,A1,"ROBB, BEVERLY LAING",2,1,1
10362,4108900001,QN,194-04 104 AVENUE,01,B3,"RAMPERSAUD, ROHAN",2,1,1
10363,4108920007,QN,196-14 104 AVENUE,01,A1,"RICHENS, SHELDON P",2,1,1
10364,4109420140,QN,110-11 202 STREET,01,B3,"RIVERA, RACHEL O",2,1,1
10365,4109470054,QN,110-48 207 STREET,01,A1,"KEY, PATRICIA",2,1,1
10366,4109850018,QN,112-01 208 STREET,02,C0,"HACKSHAW, COVID",2,1,1
10367,4110080032,QN,191-41 114 DRIVE,01,A1,"CHANDLER, LESLENE E",2,1,1
10368,4110400049,QN,115-18 200 STREET,01,A1,DOROTHY L WALLEY,2,1,1
10369,4110680102,QN,116-18 197 STREET,01,A1,"GIBBS, KIM",2,1,1
10370,4110770035,QN,205-25 116 ROAD,01,A1,BARBARA DENNIS,2,1,1
10371,4110890044,QN,215-27 102 AVENUE,01,A1,Thomas Linnen,2,1,1
10372,4114010005,QN,90-14 PITKIN AVENUE,01,B2,ALMONTE ELIDA,2,1,1
10373,4114760065,QN,111-02 110 STREET,01,B2,"VEE'S PROPERTY MANAGEMENT 10960, LLC",2,1,1
10374,4116340011,QN,111-12 131 STREET,01,B3,"NAZAIRE, PATRICK",2,1,1
10375,4116870018,QN,116-26 132 STREET,01,A1,ROBERT S GITTENS,2,1,1
10376,4117820036,QN,133-07 123 STREET,01,B2,RADICA BISSRAM,2,1,1
10377,4118580057,QN,135-44 125 STREET,01,B3,"RAMDHANI , RAMNARINE",2,1,1
10378,4119780025,QN,114-40 148 STREET,01,A1,"FRAZIER, ELYSE",2,1,1
10379,4120070276,QN,116-30 148 STREET,01,A1,KATIE WILLIAMS,2,1,1
10380,4120130056,QN,141-14 FOCH BOULEVARD,01,B2,"CHITAMAN, DIPRAJ",2,1,1
10381,4120370144,QN,142-23 122 AVENUE,01,B2,EUGENE KNIGHT,2,1,1
10382,4120390029,QN,142-47 ROCKAWAY BOULEVARD,01,B1,JONES-BAXTER NAOMI,2,1,1
10383,4120640016,QN,126-19 INWOOD STREET,01,B2,GAVI REALTY MANAGEMENT LLC,2,1,1
10384,4121780225,QN,112-62 DILLON STREET,01,B2,"BROWN, DENNIS",2,1,1
10385,4121850021,QN,150-24 114 ROAD,01,A1,VIVECA F JOHNSON,2,1,1
10386,4121920063,QN,150-55 116 AVENUE,01,A1,"ISLAM, MOHAMMAD N",2,1,1
10387,4121930091,QN,155-13 116 AVENUE,01,A1,"SLOCUMB, ROBIN",2,1,1
10388,4122430023,QN,119-06 LONG STREET,01,A2,"RHODEN, JULIA",2,1,1
10389,4123050006,QN,157-16 137 AVENUE,01,B3,ALEXIS MARLENE A/K/A,2,1,1
10390,4123410031,QN,166-01 116 AVENUE,08,W1,NYC DEPARTMENT OF EDUCATION,4,3,1
10391,4123670230,QN,170-41 118 AVENUE,01,B3,"SUTTON, JAMES",2,1,1
10392,4124040052,QN,115-27 173 STREET,01,A1,"PRESCOD-CRICHLOW, DIANA I",2,1,1
10393,4124780050,QN,176-07 ROE ROAD,01,B2,"BONAPARTE, BERNARD",2,1,1
10394,4125800009,QN,174-01 140 AVENUE,01,A2,MANN JAZELLA,2,1,1
10395,4126500014,QN,119-16 195 STREET,01,A1,RICKEY STALLWORTH,2,1,1
10396,4126750074,QN,120-21 193 STREET,01,A1,"ANDERSON, NEUTELLA",2,1,1
10397,4129320077,QN,131-35 222 STREET,01,A1,"WILLIS, DION D",2,1,1
10398,4129340129,QN,131-25 224 STREET,01,A5,"SACASA, SELINA",2,1,1
10399,4129730001,QN,233-15 MERRICK BOULEVARD,08,W1,NYC DEPARTMENT OF EDUCATION,2,1,1
10400,4129840026,QN,132-19 BENNETT COURT,01,A1,NYC HOUSING AUTHORITY,2,1,1
10401,4129840032,QN,132-11 BENNETT COURT,01,A1,FANNIE MAE,2,1,1
10402,4130200040,QN,180-21 140 AVENUE,01,B1,"DAVID, STEVE",2,1,1
10403,4130550079,QN,141-42 185 STREET,01,A1,LEWIS ALVIN,2,1,1
10404,4130570078,QN,141-24 SPRINGFIELD BLVD,01,B3,"LUZ, MANUEL L",2,1,1
10405,4131630060,QN,135-46 230 STREET,01,A1,"AGRIPPA, MAURICE P",2,1,1
10406,4132290011,QN,135 ROAD,11,V0,"RODRIGUEZ BRITO, GIANCARLOS",3,2,1
10407,4133120015,QN,145-02 FARMERS BOULEVARD,08,W2,ROMAN CATHOLIC CHURCH OF CHRIST THE KING,2,1,1
10408,4135120010,QN,230-74 LANSING AVENUE,01,A2,SHEILA BLACKBURN,2,1,1
10409,4142030053,QN,163-19 95 STREET,01,A2,"LANGONA, VINCENT",2,1,1
10410,4142441332,QN,99-51 JAMES COURT,01,A2,"DEONARAIN, CHRISTINE",2,1,1
10411,4153140017,QN,925 CROSS BAY BOULEVARD,05,K1,ALBORROC REALTY INC,3,2,1
10412,4155730085,QN,12-22 CAFFREY AVENUE,01,B3,"RUBIN, MICHAEL L",2,1,1
10413,4157060067,QN,22-59 LORETTA ROAD,11,V0,RAYMOND SMITH,2,1,1
10414,4157100062,QN,11-17 BEACH CHANNEL DRIVE,01,B2,"RAMJISINGH, RAJKUMAR",2,1,1
10415,4159690028,QN,462 BEACH 47 STREET,01,A2,COLEMAN CLAUDIA,3,2,1
10416,4161030077,QN,3-06 BEACH 84 STREET,11,V0,B&H PROPERTIES HOLDINGS INC.,2,1,1
10417,4161360009,QN,1-28 BEACH 91 STREET,02,C0,"SAN-MIGUEL, ROBERT",2,1,1
10418,4162090048,QN,414 BEACH 128 STREET,02,C2,ODED HAZAN,2,1,1
10419,4162710080,QN,2-60 BEACH 138 STREET,01,B2,JESUS LINARES,2,1,1
10420,4162780065,QN,1-40 BEACH 134 STREET,01,A2,"WALEK, WALTER",2,1,1
10421,4162850059,QN,140 BEACH 141 STREET,01,A1,HOWARD COOPER,2,1,1
10422,5000520012,SI,149 YORK AVENUE,01,B2,OLGA DELA CRUZ,3,2,1
10423,5000710106,SI,250 FILLMORE STREET,01,B2,LILLIE SPANN,2,1,1
10424,5001330047,SI,398 KISSEL AVENUE,01,B2,"ALIMOSSY, JOHN S.",2,1,1
10425,5001410009,SI,327 DAVIS AVENUE,01,A1,QUINN EDWARD,2,1,1
10426,5001490178,SI,27 PELTON AVENUE,01,B2,BEATRICE VAN DYKE,2,1,1
10427,5002080015,SI,511 CARY AVENUE,01,B2,ESPINOSA INES R,2,1,1
10428,5003090030,SI,936 FOREST AVENUE,01,A1,"FAUSKE, PAUL M",2,1,1
10429,5003190001,SI,1321 VICTORY BOULEVARD,09,Q1,NYC DEPARTMENT OF PARKS AND RECREATION,19,18,1
10430,5003460281,SI,136 STURGES STREET,01,A5,"BENDIK, LUCILLE",2,1,1
10431,5003580058,SI,293 COLLEGE AVENUE,01,A1,REGINA M PALEAU,2,1,1
10432,5003700134,SI,19 CROWELL AVENUE,01,A0,"BHATTI, AZHAR",2,1,1
10433,5004390005,SI,309 NEAL DOW AVENUE,01,A1,"VALERIO, GIAN CARLO C",2,1,1
10434,5004470010,SI,309 BIDWELL AVENUE,01,A2,"PADILLA, JARROD",2,1,1
10435,5005060059,SI,73 CLINTON STREET,06,E2,1 M REALTY CORP.,4,3,1
10436,5005250020,SI,19 BROAD STREET,04,K4,SALJO ENTERPRISES LTD,2,1,1
10437,5005360053,SI,22 GORDON STREET,01,A1,FABIAN JUMELLES,2,1,1
10438,5005440134,SI,90 TARGEE STREET,01,A1,MARK E MISSALL,2,1,1
10439,5006480076,SI,59 HAMILTON STREET,01,A5,"CHEN, HUANG",2,1,1
10440,5006500022,SI,523 VANDERBILT AVENUE,01,B1,VICTOR A QUIZHPI,3,2,1
10441,5007060001,SI,761 MANOR ROAD,03,D3,NYC HOUSING AUTHORITY,8,7,1
10442,5007240071,SI,45 BRADLEY AVENUE,01,A5,SAM SUED,2,1,1
10443,5007260013,SI,131 WHEELER AVENUE,01,B2,WALTER SANTOS,2,1,1
10444,5007640029,SI,191 PERRY AVENUE,01,A1,GUASTAVINO PHIL,3,2,1
10445,5010490037,SI,488 HEBERTON AVENUE,01,B2,"FISCHER, ALAN",2,1,1
10446,5010950007,SI,191 CHARLES AVENUE,01,B3,"GARCIA, ANTHONY M",2,1,1
10447,5012080095,SI,3387 RICHMOND TERRACE,09,Q8,M H YACHT CLUB INC,4,3,1
10448,5017800085,SI, BLOOMFIELD AVENUE,11,V1,RICHMOND PRECAST INCORPORATED,3,2,1
10449,5019947501,SI,9 LOVELL AVENUE,02,R3,UNAVAILABLE OWNER,74,73,1
10450,5028200134,SI,201 EDGEWATER STREET,05,O5,UNITED NY SANDY HOOK,2,1,1
10451,5028400119,SI,15 GREENFIELD COURT,01,A5,YE HTUT,2,1,1
10452,5029170022,SI,1985 CLOVE ROAD,01,A5,"TAN, ZHI HUA",2,1,1
10453,5029720019,SI,197 VIRGINIA AVENUE,01,A5,JOHN M. PEREZ,2,1,1
10454,5029870020,SI,76 BELL STREET,01,A1,"BIRKBECK, IVANHOE",2,1,1
10455,5031020071,SI,116 LILY POND AVENUE,01,A5,"CHEN, XI",2,1,1
10456,5031160035,SI,83 MILLS AVENUE,01,B2,"SHU CHEN, LI",2,1,1
10457,5032370061,SI,20 MALLORY AVENUE,01,A1,HARTMAN FREDERICK,2,1,1
10458,5032850001,SI,7 WHITAKER PLACE,01,B2,"LIN, DABING",2,1,1
10459,5033620159,SI,11 MC DERMOTT AVENUE,01,B2,"CHEN, DUO",2,1,1
10460,5033920029,SI,12 REID AVENUE,01,A5,VINH V NGUYEN,2,1,1
10461,5035620022,SI,41 BARTON AVENUE,01,B2,"LONUZZI, LISA",2,1,1
10462,5036160053,SI,272 PRESCOTT AVENUE,01,A5,"272 PRESCOTT, LLC",2,1,1
10463,5036440025,SI,267 OTIS AVENUE,01,A1,ROBERT CAPPIELLO,2,1,1
10464,5038080003,SI,35 HEMPSTEAD AVENUE,01,A1,"WONG, MARY LOU",2,1,1
10465,5038810027,SI,516 LINCOLN AVENUE,01,B2,BERNARDO BENVENUTO,2,1,1
10466,5041970035,SI,104 2 STREET,01,B2,"DRURY, SUSAN",2,1,1
10467,5046130131,SI,17 GIBSON AVENUE,01,A1,C TIMOTHY,2,1,1
10468,5046320002,SI,128 DEWEY AVENUE,01,A1,"BELYAYEV, VADIM",2,1,1
10469,5051560064,SI,40 NASH COURT,01,B2,OFFICE OF MENTAL RETARDATION & DEV,2,1,1
10470,5052730023,SI,88 HILLCREST STREET,01,B3,WILLIAM V. NEGHERBON,2,1,1
10471,5053090028,SI,128 GOODALL STREET,11,V0,"PROJECT REBUILD, INC.",4,3,1
10472,5053160044,SI,26 ROBINSON AVENUE,01,A1,DAVID GELFAND AS TRUSTEE OF GELFAND FAMI LY TRUST,2,1,1
10473,5054830048,SI,670 ARMSTRONG AVENUE,01,B2,LAURA B. LEMA,2,1,1
10474,5055070235,SI,27 MARIA LANE,01,A5,MARGARITA DESIN,2,1,1
10475,5056530083,SI,28 LADD AVENUE,01,A5,R LIM,2,1,1
10476,5064020042,SI,16 ALLEN PLACE,01,B2,"MANRIQUE, JOHN  A",2,1,1
10477,5067960009,SI,141 SHARROTT AVENUE,01,A1,MITCHELL B FOLEY,2,1,1
10478,5069250012,SI,909 RATHBUN AVENUE,01,A9,"GIOIOSA-STELLA, PATRICIA",2,1,1
10479,5075500010,SI,6581 AMBOY ROAD,07,G2,"GRAZIANO, JACK E",4,3,1
10480,5075780262,SI,18 MADSEN AVENUE,01,A1,PATRICIA ANN ELLIS,2,1,1
10481,5080430098,SI,252 FISHER AVENUE,01,B2,JOSEPH MCCUE,2,1,1
10482,1003030015,MN,91 BOWERY,05,H2,"93 BOWERY HOLDINGS, LLC",2,1,1
10483,1004750056,MN,33 GREENE STREET,03,D4,33 GREENE ST CORP,2,1,1
10484,1004900027,MN,50 SULLIVAN STREET,01,A7,"HAYES, RACHAEL WINCHESTER",2,1,1
10485,1010800105,MN,564 WEST 52 STREET,04,C7,UNAVAILABLE OWNER,6,5,1
10486,1011500056,MN,164 WEST 79 STREET,03,D4,164 W 79 ST CORP,2,1,1
10487,1011827502,MN,346 W 71ST STREET,03,R4,"CYDONIA W71, LLC",2,1,1
10488,1012330028,MN,203 WEST 85 STREET,04,C7,203 WEST 85TH STREET,2,1,1
10489,1019570105,MN,259 CONVENT AVENUE,08,W5,DASNY,4,3,1
10490,2023310069,BX,291 EAST 149 STREET,04,K4,BRONX 149TH STREET LLC,3,2,1
10491,2025220057,BX,1392 OGDEN AVENUE,05,K1,PINAK REALTY CO  INC,2,1,1
10492,2026170171,BX,667 EAGLE AVENUE,01,A5,ANGEL L LOPEZ,2,1,1
10493,2026910091,BX,1077 HALL PLACE,01,A1,EUNICE BOBO TRUST,2,1,1
10494,2026910094,BX,1071 HALL PLACE,01,A1,"CMC HOMES, INC.",2,1,1
10495,2027080013,BX,723 BECK STREET,01,B1,JUAN M CARCAMO,2,1,1
10496,2027400082,BX,861 MANIDA STREET,01,B1,CYBEALE E ROSS,2,1,1
10497,2030980152,BX,725 EAST 181 STREET,02,C3,EAST 181 HOLDINGS LLC,2,1,1
10498,2031100061,BX,770 EAST 182 STREET,03,D3,EAST 182ND STREET LLC,3,2,1
10499,2033110111,BX,174 EAST 205 STREET,05,O7,"SARDY REALTY, LLC",2,1,1
10500,2033870038,BX,340 EAST 239 STREET,01,A1,"STONE, MICHAEL",2,1,1
10501,2034480029,BX,158 HUSSON AVENUE,01,B3,158 HUSSON AVENUE HOLDING CORP,2,1,1
10502,2035000066,BX,435 WHITE PLAINS ROAD,02,C3,BRIGLALL JAWAHARLALL,2,1,1
10503,2036510044,BX,953 ELDER AVENUE,01,B3,"JEROME, CHIARA L",2,1,1
10504,2036900045,BX,2247 LAFAYETTE AVENUE,01,A1,RONALD CANZIUS,2,1,1
10505,2037107501,BX,1090 CLOSE AVENUE,04,RM,UNAVAILABLE OWNER,2,1,1
10506,2039790088,BX,2455 GLEBE AVENUE,01,A1,PHILIP MATHEW,2,1,1
10507,2040010058,BX,2552 EAST TREMONT AVENUE,04,S9,OVERING REALTY CORP,6,5,1
10508,2040480040,BX,664 RHINELANDER AVENUE,01,B2,"KUTWARU, MUNESH",2,1,1
10509,2041120020,BX,1637 HERING AVENUE,02,C0,"AGOVINO, FRANK J.",2,1,1
10510,2042720046,BX,1920 HAIGHT AVENUE,02,C2,"N & I PROPERTIES, LLC",2,1,1
10511,2044400047,BX,2527 MATTHEWS AVENUE,02,C2,2527 MATTHEWS AVE REALTY LLC,2,1,1
10512,2044730053,BX,2421 FENTON AVENUE,01,A1,"TRUONG, TIFFANY",2,1,1
10513,2044760076,BX,2521 FENTON AVENUE,01,A1,"DEJESUS, MICHAEL",2,1,1
10514,2045870029,BX,1306 ADEE AVENUE,02,C0,CENTAURUS DEVELOPMENT CORP.,2,1,1
10515,2045890012,BX,3010 WILSON AVENUE,01,B3,3010 WILSON AVENUE LLC,2,1,1
10516,2046620048,BX,746 EAST 215 STREET,02,C3,746 EAST 215 ST LLC,2,1,1
10517,2046930073,BX,3523 LACONIA AVENUE,01,B1,GUZMAN VICTOR M,2,1,1
10518,2047870057,BX,2824 KINGSLAND AVENUE,01,B1,"TODARO, JERRY",2,1,1
10519,2048240078,BX,680 EAST 223 STREET,01,B2,"PIERRE NOEL , MARIE",2,1,1
10520,2048370061,BX,726 EAST 224 STREET,01,A1,"TAPIA, ARMANDO MENDEZ",2,1,1
10521,2048540059,BX,818 EAST 230 STREET,01,B1,"ALI, MOHAMMED",2,1,1
10522,2048620030,BX,933 EAST 226 STREET,01,B1,"DALMASI, SALVAYRA",2,1,1
10523,2053060231,BX,3398 EAST TREMONT AVENUE,04,O8,3398 EAST TREMONT AVE LLC,2,1,1
10524,2053320063,BX,1225 MAYFLOWER AVENUE,01,A1,"DORAN, DYMPHNA B",2,1,1
10525,2053440026,BX,3178 WATERBURY AVENUE,01,A1,"RIVAS, JUAN",2,1,1
10526,2053490062,BX,1307 EDWARDS AVENUE,01,A2,"VEGA-GARCIA, JEANNINE",2,1,1
10527,2054030075,BX,1522 HOLLYWOOD AVENUE,01,A1,HUNT BRIAN,2,1,1
10528,2054140178,BX,3305 RADIO DRIVE,01,B1,"LAPIETRA, ORAZIO",2,1,1
10529,2054580018,BX,1021 THROGMORTON AVENUE,01,B1,MICHAEL C MESSINA,2,1,1
10530,2055250010,BX,3086 GIEGERICH PLACE,01,B2,ROSE EGUINO,2,1,1
10531,2055340106,BX,922 SWINTON AVENUE,01,B1,"RAMKISSOON, HENRY T",2,1,1
10532,2055990045,BX,2630 MILES AVENUE,01,B2,"YCAZA, TRISHA L",2,1,1
10533,2056250089,BX,116 PILOT STREET,01,A1,O'CONNELL PATRCIA,2,1,1
10534,2056300013,BX,84 FORDHAM STREET,02,C0,"KRISTIN E. SCHAUMBURG, AS TRUSTEE",5,4,1
10535,2057160725,BX,3350 JOHNSON AVENUE,08,W1,NYC DEPARTMENT OF EDUCATION,4,3,1
10536,2057660882,BX,3633 KINGSBRIDGE AVENUE,06,F4,EGERTON LLC,2,1,1
10537,3004500035,BK,298A CARROLL STREET,01,B3,MARK MUSCHENHEIM,2,1,1
10538,3005770025,BK,15 WOLCOTT STREET,01,B9,"DATTA, KINSHUK",2,1,1
10539,3006440001,BK,730 3 AVENUE,06,E9,NYC DEPARTMENT OF SMALL BUSINESS SERVICES,18,17,1
10540,3006970074,BK,419 37 STREET,01,A5,ROBERT TAYLOR,2,1,1
10541,3007000014,BK,322 37 STREET,08,P5,ABOVEGROUNDCOLLECTIVE LLC,2,1,1
10542,3007600068,BK,829 47 STREET,01,B1,"ESTREICHER, DEVORAH",2,1,1
10543,3007860051,BK,769 50 STREET,05,O5,"HO , PETER K.M.",2,1,1
10544,3008100020,BK,730 52 STREET,01,A9,"TANG, KAI YUAN",2,1,1
10545,3008790021,BK,264 18 STREET,01,B2,"MONTANEZ, SALVADOR",2,1,1
10546,3008910020,BK,264 20 STREET,01,B2,"HANIFF, VANNA O",2,1,1
10547,3009020001,BK,500 20 STREET,09,Z8,GREENWOOD CEMETRY,21,20,1
10548,3009610019,BK,590 CARROLL STREET,01,B3,"BANKER, ABIGAIL H",2,1,1
10549,3011120007,BK,487 7 AVENUE,04,S4,487 7TH AVE LLC,2,1,1
10550,3011220061,BK,867 PACIFIC STREET,02,C0,"JETER, KEVIN",2,1,1
10551,3011510070,BK,195 PROSPECT PLACE,01,B9,"LEONARD, GARRICK H",3,2,1
10552,3012850065,BK,1315 CARROLL STREET,01,A4,"PINSON, MENDEL",2,1,1
10553,3012990029,BK,460 CROWN STREET,01,B3,JOSEPH & ESTHER HURWITZ,2,1,1
10554,3013740038,BK,1558 PARK PLACE,02,C3,CROWN HEIGHTS HOLDINGS LLC,2,1,1
10555,3014240049,BK,897 EMPIRE BOULEVARD,03,D4,897-903 EMPIRE BLVD H,2,1,1
10556,3018000035,BK,652 GREENE AVENUE,02,C0,THE DARREN GRAHAM REVOCABLE LIVING TRUST,4,3,1
10557,3018160001,BK,588 GATES AVENUE,03,D9,745 GATES HDFC,5,4,1
10558,3018670007,BK,537 NOSTRAND AVENUE,05,K1,SASSON AND SASSON LLC,3,2,1
10559,3018780006,BK,37 GRAND AVENUE,06,F2,ECQ RLTY CORP,3,2,1
10560,3018980056,BK,122 FRANKLIN AVENUE,04,S2,FRANKLIN PROPERTIESINC,2,1,1
10561,3019870007,BK,479 CLASSON AVENUE,02,C0,479 CLASSON LLC,2,1,1
10562,3020720013,BK,165 WASHINGTON PARK,02,C3,"LEE, WILLIAM E",2,1,1
10563,3022907502,BK,162 NORTH 12 STREET,03,R4,UNAVAILABLE OWNER,2,1,1
10564,3025500009,BK,94 JAVA STREET,02,C0,PERILLI PAUL,2,1,1
10565,3026540069,BK,746 HUMBOLDT STREET,01,B9,"HIROMARO YASUDA, TRUSTEE",2,1,1
10566,3028290029,BK,125 KINGSLAND AVENUE,02,C1,RLG KINGSLAND LLC,2,1,1
10567,3029130061,BK,949 METROPOLITAN AVENUE,02,C1,METROPOLITAN TERRACE LLC,2,1,1
10568,3032070007,BK,990 WILLOUGHBY AVENUE,02,C2,"DIAZ, ROSA",2,1,1
10569,3034890001,BK,1560 EAST NEW YORK AVENUE,03,D3,NYC HOUSING AUTHORITY,18,17,1
10570,3035750011,BK,355 CHESTER STREET,04,D7,"HP MARCUS GARVEY PRESERVATION HOUSING CO MPANY, INC",4,3,1
10571,3038390041,BK,610 PENNSYLVANIA AVENUE,02,C0,HARVEY NICOLA SR,2,1,1
10572,3039120055,BK,68 HIGHLAND PLACE,01,B2,SINGH  MANGLAWATTI,2,1,1
10573,3039310024,BK,226 RIDGEWOOD AVENUE,02,C0,"MONCADA, MARIA EDITA",2,1,1
10574,3039890034,BK,795 GLENMORE AVENUE,,Z9,LATTARULO WILLIAM,2,1,1
10575,3041060008,BK,10 CYPRESS COURT,01,B2,"JAMES, GORDON O",2,1,1
10576,3041130025,BK,104 ETNA STREET,01,A5,"TRASKY, MELISSA",2,1,1
10577,3041260018,BK,145 LOGAN STREET,01,B3,"TRAN, LONG",3,2,1
10578,3041330060,BK,3401 FULTON STREET,04,S2,"ZHOU, QI YU",2,1,1
10579,3042630030,BK,316 FOUNTAIN AVENUE,01,B3,"ROSUL, MOHAMMAD A",3,2,1
10580,3044730022,BK,238 AMBER STREET,01,A1,PENNELLA CARMINE,2,1,1
10581,3045460044,BK,719 FOUNTAIN AVENUE,01,B2,719 FOUNTAIN AVE CORP.,2,1,1
10582,3046690066,BK,410 EAST 95 STREET,02,C0,"CANTAVE, GREGORY",2,1,1
10583,3047040023,BK,182 EAST 57 STREET,01,B1,"ASHBY, CYNTHIA",2,1,1
10584,3047540059,BK,644 EAST 95 STREET,02,C0,"SINCLAIR BEAUMONT, MOBRIE",2,1,1
10585,3047610020,BK,652 EAST 51 STREET,01,B3,"HINDS, STEPHON J",2,1,1
10586,3048000016,BK,650 MAPLE STREET,01,B2,MAPLE 650 LLC,2,1,1
10587,3048630010,BK,58 EAST 43 STREET,02,C3,"HERCULES, MARTIN",2,1,1
10588,3048640027,BK,601 LINDEN BOULEVARD,01,B1,CONSTANCE NEVERS,2,1,1
10589,3048740026,BK,220 EAST 38 STREET,01,A9,"MAJUMDER , JAHANGIR",2,1,1
10590,3049020019,BK,106 EAST 32 STREET,02,C0,"MCVORRAN, MICHELLE",2,1,1
10591,3049140062,BK,503 EAST 46 STREET,01,A9,"ROBERTS, MARIE CLAIRE",2,1,1
10592,3049520010,BK,3522 CLARENDON ROAD,04,S9,HUR FAMILY OF NY CORP.,2,1,1
10593,3049600032,BK,1232 TROY AVENUE,01,B3,NEVILLE RAMSAROOP,2,1,1
10594,3050060059,BK,638 EAST 32 STREET,01,B3,"BYFIELD, DUDLEY A",2,1,1
10595,3051290041,BK,933 ROGERS AVENUE,03,D3,ROGERS REALTY HOLDINGS LLC,4,3,1
10596,3051300015,BK,30 EAST 29 STREET,02,C1,KINGSLAND FLATBUSH LLC,2,1,1
10597,3051410053,BK,619 CONEY ISLAND AVENUE,07,G4,"BOLLA EM REALTY, LLC",2,1,1
10598,3052120014,BK,412 EAST 26 STREET,01,B2,"HEROD, FRANK",2,1,1
10599,3053190048,BK,179 EAST 5 STREET,01,B2,KISNASAMY SITA,2,1,1
10600,3053760021,BK,394 EAST 8 STREET,01,A1,"WEISSMAN, LAWRENCE A",2,1,1
10601,3054210041,BK,316 WEBSTER AVENUE,01,A5,"RQAMSEY, DARRYL",2,1,1
10602,3054340061,BK,1661 46 STREET,02,C0,ROSALIE HOROWIR,2,1,1
10603,3054390061,BK,43 WEBSTER AVENUE,01,B1,"STEINBERG, FRIDA",2,1,1
10604,3054770069,BK,1515 54 STREET,01,B3,"LEIFER, CONSTANCE",2,1,1
10605,3054810041,BK,1982 53 STREET,01,A9,MEYER LOWINGER,2,1,1
10606,3054930030,BK,1760 56 STREET,02,C0,"GOLDSTEIN, JUDY",2,1,1
10607,3054950043,BK,1924 54 STREET,01,A5,"HALBERSTAM, SAMUEL",2,1,1
10608,3055020054,BK,1559 59 STREET,08,M1,CONGREGATION TZLOSAD'SHLOMO,2,1,1
10609,3055040011,BK,1714 58 STREET,01,B1,1714 REALTY LLC,2,1,1
10610,3055040036,BK,1772 58 STREET,01,B1,RACHEL WETTENSTEIN,2,1,1
10611,3055220004,BK,6015 21 AVENUE,01,B1,"DRESDNER, JAIME",2,1,1
10612,3055350027,BK,2052 62 STREET,01,A3,"GLUCK, HINDY B",2,1,1
10613,3056270052,BK,1156 47 STREET,02,C0,"CRUM LYNNE REALTY, L",2,1,1
10614,3056610012,BK,1116 52 STREET,01,B1,EPHRAIM LOWY AND JACOB EDELSTEIN AS TRUS TEES,2,1,1
10615,3056640043,BK,5224 15 AVENUE,01,B1,CONG. & YESHIVA SHEARITH ISRAEL,2,1,1
10616,3056680039,BK,1182 53 STREET,01,B1,"MENDLOWITS, JOSEPH",2,1,1
10617,3056730080,BK,923 55 STREET,01,B1,ZION AVIDAR,2,1,1
10618,3056930001,BK,5723 8 AVENUE,04,S9,5723 8TH AVENUE LLC,2,1,1
10619,3056980006,BK,5709 13 AVENUE,01,B1,STANLEY SOLOMON,4,3,1
10620,3057520030,BK,1156 65 STREET,02,C0,"HUI, TIMMY",2,1,1
10621,3058880067,BK,75 72 STREET,01,B2,"LIBRIZZI, DANIELLE",2,1,1
10622,3059470034,BK,84 76 STREET,01,A5,ROBERT FADEL,2,1,1
10623,3059470045,BK,7616 COLONIAL ROAD,01,A5,"CARMOSINO, MARY D.",2,1,1
10624,3060050050,BK,165 83 STREET,01,A1,"MOUKDAD, JIHAD",2,1,1
10625,3060080053,BK,475 83 STREET,01,B1,"ALSAIDA, ABDO",2,1,1
10626,3060230019,BK,130 84 STREET,01,A1,"ANGLE, RICHARD",2,1,1
10627,3060530036,BK,32 GATLING PLACE,01,A5,"MCFARRELL, DONNA",2,1,1
10628,3061110022,BK,36 94 STREET,01,A1,BILL STATHAKOS,2,1,1
10629,3061750009,BK,2110 70 STREET,01,B2,ERIC TUNG,2,1,1
10630,3062480047,BK,7714 18 AVENUE,04,S1,7714 18TH AVENUE LLC,2,1,1
10631,3062960060,BK,1823 82 STREET,02,C0,"ZHENG DE CHONG, TIAN JUAN",2,1,1
10632,3063620015,BK,61 BAY 11 STREET,02,C0,"CHIN, YING NON",2,1,1
10633,3063630066,BK,54 BAY 13 STREET,02,C2,"GARGANO, ANNA",2,1,1
10634,3064600186,BK,281 BAY 11 STREET,01,B2,"FISCHETTI, ALESSANDRO",2,1,1
10635,3065170076,BK,1037 EAST 4 STREET,01,A9,"GINDI, MAURICE",2,1,1
10636,3065190016,BK,1026 EAST 7 STREET,01,A1,CHARLES KRAIEM,2,1,1
10637,3065210061,BK,975 EAST 8 STREET,01,A1,"GINDI, VICTOR S",2,1,1
10638,3065240033,BK,1154 EAST 2 STREET,01,A3,"GERSTNER , MIRIAM",2,1,1
10639,3065270033,BK,1158 EAST 7 STREET,01,A1,"DWECK, NATHAN",2,1,1
10640,3065280055,BK,1173 EAST 7 STREET,01,A1,GABRIEL KHEZRIE,2,1,1
10641,3065330074,BK,1233 EAST 7 STREET,01,A1,"GINDI, VICTOR",2,1,1
10642,3065420028,BK,1340 EAST 7 STREET,01,B2,"CHAIM SHABSI BROYDE, TRUSTEE",2,1,1
10643,3065870072,BK,1561 EAST 5 STREET,01,A9,"SAFDEYE, JUDAH",2,1,1
10644,3066410001,BK,1603 EAST 9 STREET,01,A1,SOPHIA BILDIRICI,2,1,1
10645,3066410028,BK,1654 EAST 10 STREET,01,A1,"MASSRE, AS TRUSTEE, EFRAT",2,1,1
10646,3066410031,BK,1660 EAST 10 STREET,01,B2,"IMANOEL, HELEN",2,1,1
10647,3066420001,BK,1004 AVENUE P,01,B2,HASSIB BAGHDADI,2,1,1
10648,3066810243,BK,1912 EAST 4 STREET,01,A9,GAIL SUTTON 2018 REVOCABLE TRUST,2,1,1
10649,3066840011,BK,1816 EAST 9 STREET,01,B3,SUSAN SUTTON,2,1,1
10650,3066850135,BK,913 1 COURT,01,A9,"SHALOM, ALBERT",2,1,1
10651,3067280055,BK,1201 EAST 17 STREET,01,A1,REZNIK JEFF,2,1,1
10652,3067490043,BK,1484 EAST 12 STREET,01,B2,"BALAS, YOUSSEF",2,1,1
10653,3067490078,BK,1769 CONEY ISLAND AVENUE,07,G5,EBTWENTY TWO SERVICE STATIONS INC,2,1,1
10654,3067560032,BK,1468 EAST 19 STREET,01,B1,"BERNSTEIN, MARCEL",2,1,1
10655,3067780079,BK,1617 EAST 15 STREET,01,A1,"BARSKAYA, YELENA",2,1,1
10656,3067817501,BK,1641 EAST 18 STREET,03,R4,UNAVAILABLE OWNER,2,1,1
10657,3067940016,BK,1124 KINGS HIGHWAY,04,K4,1122 KINGS HIGHWAY LLC,3,2,1
10658,3068100034,BK,1766 EAST 28 STREET,01,A5,ARI WEINSTOCK,2,1,1
10659,3068260024,BK,1938 EAST 21 STREET,01,A1,BARBARA SHAMMAH,2,1,1
10660,3068310005,BK,2512 AVENUE R,01,A1,EPHREM WERTENTEIL C/O,2,1,1
10661,3068310056,BK,3975 BEDFORD AVENUE,01,A3,"ARIEL SOUDRY, TRUSTEE",2,1,1
10662,3069130005,BK,2713 CROPSEY AVENUE,01,B3,FRANCES DRAXDORF,2,1,1
10663,3070160159,BK,2822 WEST 22 STREET,01,A5,"WU, MING XING",2,1,1
10664,3070240092,BK,4202 MANHATTAN AVENUE,02,C0,"WERCZBERGER, LAZER",2,1,1
10665,3070460001,BK,2911 WEST 36 STREET,04,D7,FRIENDSET APTS HOUSING DEVELOPMENT FUND CORPORATIO,3,2,1
10666,3070830078,BK,1931 WEST 6 STREET,02,C0,NING LI,2,1,1
10667,3070980076,BK,2023 WEST 8 STREET,01,B1,"CHEN, JIAN YONG",2,1,1
10668,3071020057,BK,287 VAN SICKLEN STREET,01,B1,ANTHONY MORRONE,2,1,1
10669,3071040393,BK,2054 EAST 1 STREET,01,A5,"ALTILIO, MARIO",2,1,1
10670,3071040472,BK,2082 EAST 2 STREET,01,A3,"LEVY, JOSEPH",2,1,1
10671,3071210066,BK,2125 WEST 6 STREET,02,C0,JOMAR VENTURES LLC,2,1,1
10672,3071310072,BK,2177 EAST 4 STREET,01,A3,"ELO, ELLIOT",2,1,1
10673,3071590029,BK,2252 EAST 8 STREET,01,A1,"JAMMAL, HILLEL",2,1,1
10674,3071590047,BK,721 AVENUE W,01,A1,"BAWABEH, JOYCE",2,1,1
10675,3072920075,BK,1929 EAST 13 STREET,01,B1,"FOUERTI, YOUSSEF",2,1,1
10676,3072960079,BK,1923 EAST 17 STREET,01,B2,"HANONO, ALBER",2,1,1
10677,3073000037,BK,2006 EAST 22 STREET,01,A9,"GIAHN, LAURIE",2,1,1
10678,3073960026,BK,1104 SHEEPSHEAD BAY ROAD,01,A2,1102 SHEEPSHEAD BAY ROAD LLC,2,1,1
10679,3074310042,BK,1121 AVENUE Z,01,A1,KUPERMAN MANAGEMENT CORP.,2,1,1
10680,3074400076,BK,2535 EAST 19 STREET,01,A5,"MEI, BAO HANG",2,1,1
10681,3075620051,BK,860 EAST 35 STREET,02,C2,862 E 35 ST LLC,2,1,1
10682,3075790147,BK,3522 AVENUE H,01,A9,HAZEL BROWN,2,1,1
10683,3075900076,BK,976 EAST 27 STREET,01,B1,SIYATA DISHMAYA TRUST,2,1,1
10684,3076010061,BK,1082 EAST 38 STREET,01,B2,EUGENE JOSEPH DUPERVAL,2,1,1
10685,3076290110,BK,1185 EAST 29 STREET,01,A9,"MALETTE, MARIE LESLIE",2,1,1
10686,3076460053,BK,1218 EAST 29 STREET,01,A1,"MENDELSOHN, HADASA",2,1,1
10687,3076630010,BK,1383 EAST 27 STREET,01,A1,"FEUER, SAMUEL",2,1,1
10688,3076740057,BK,1534 EAST 21 STREET,01,A3,PEARLMAN ARTHUR,2,1,1
10689,3076740085,BK,1594 EAST 21 STREET,01,A9,"DAVIDOWITZ, YITZCHOK",2,1,1
10690,3078280011,BK,1511 EAST 48 STREET,01,B3,WASHINGTON BETTY,3,2,1
10691,3078980014,BK,1685 EAST 53 STREET,01,A1,"GERENA, ARMANDO",2,1,1
10692,3078980054,BK,1600 EAST 54 STREET,01,A1,"JEAN-BAPTISTE, MELISSA",2,1,1
10693,3079920051,BK,636 EAST 88 STREET,01,B9,"SIMPSON, CAMILLE B",2,1,1
10694,3081150060,BK,710 EAST 98 STREET,07,G2,"FIVE STAR ASSOCIATES,",2,1,1
10695,3081650028,BK,1017 EAST 96 STREET,01,B2,"FOLKES, SHARON",2,1,1
10696,3082000016,BK,1229 EAST 92 STREET,01,B2,"KAYE, KADAN",2,1,1
10697,3082120022,BK,963 EAST 104 STREET,01,B1,"LOGAN, NATHALIA",2,1,1
10698,3082560059,BK,1454 EAST 92 STREET,01,B2,"HERRERA , IDA",2,1,1
10699,3084560013,BK,2445 EAST 69 STREET,01,A5,"2445 E 69TH ST,LLC",2,1,1
10700,3084700150,BK,7000 AVENUE Y,07,Y7,NYC DEPARTMENT OF SMALL BUSINESS SERVICES,4,3,1
10701,3084701090,BK,2184 MILL AVENUE,06,F5,IRA AND LARRY WEINSTEIN,2,1,1
10702,3084730023,BK,1829 MADISON PLACE,01,B3,DOUDA ALEXANDER,2,1,1
10703,3086690088,BK,2997 OCEAN PARKWAY,08,M1,CHABAD LUBAVITCH OFWEST BRIGHTON-MANHATT AN BEACH,2,1,1
10704,3086720042,BK,3051 BRIGHTON 2 STREET,01,B2,"AMAR, SAJJAD",3,2,1
10705,3087240207,BK,253 CORBIN PLACE,01,B1,"KRANTS, PAUL",2,1,1
10706,3087330057,BK,130 BEAUMONT STREET,01,B3,"PETRUSHANSKY, MICHAEL",2,1,1
10707,3087520015,BK,135 IRWIN STREET,01,A1,LEON GOLDEN,2,1,1
10708,3088451670,BK,1 NOEL AVENUE,01,B3,"MIZRACHI, RONNIE",2,1,1
10709,3088561584,BK,26 HYMEN COURT,01,A1,"ARLEO, JACQUELINE K",2,1,1
10710,3089140088,BK,100 CANTON COURT,11,V0,"BORCHELT, PETER",2,1,1
10711,3089550364,BK,109 FANE COURT,01,B3,FARRELL JUNE,2,1,1
10712,4000490124,QN,45-38 11 STREET,01,B1,45 38 11TH STREET LLC,2,1,1
10713,4003490001,QN,36-42 21 STREET,07,G5,SEVIM MGT INC,2,1,1
10714,4003840009,QN,38-17 29 STREET,01,B9,"MUNOZ, NICOLAS A",2,1,1
10715,4005360142,QN,14-46A 30 AVENUE,01,B1,"IPPOLITO, ANTONIO",2,1,1
10716,4005420040,QN,23-25 NEWTOWN AVENUE,08,M3,OUR LADY OF MT CARMEL,2,1,1
10717,4005870009,QN,32-71 30 STREET,01,B1,"DE VINCENT, JAMES J",2,1,1
10718,4006500080,QN,30-86 36 STREET,02,C1,PLAZA GROUP 36 LLC,2,1,1
10719,4007210013,QN,28-33 47 STREET,02,C0,TENCIC FAMILY TRUST,2,1,1
10720,4007810046,QN,23-08 SOUND STREET,02,C0,JOHN STRATIGAKIS,2,1,1
10721,4007840048,QN,21-36 45 STREET,01,B3,"MOONEY, JOHN",2,1,1
10722,4008550061,QN,27-11 23 AVENUE,04,S4,F & G 23RD AVENUE LLC,2,1,1
10723,4008660005,QN,22-71 CRESCENT STREET,01,B3,"AHMED, MOHAMMED NAZIR",2,1,1
10724,4008840077,QN,25-39 21 STREET,01,B1,"FAKIRIS, PETROULA",2,1,1
10725,4008850001,QN,26 27 AVENUE,03,D1,NY CAROL AVENUE LLC (AS TO 17% TIC INTER EST),2,1,1
10726,4010440025,QN,24-42 81 STREET,01,B2,"SHAHED, ABDUS",2,1,1
10727,4010860050,QN,23-59 92 STREET,01,B1,"CARPIO, JORGE",2,1,1
10728,4012620027,QN,34-40 76 STREET,01,A5,"STOCHMAL, INGRID D",2,1,1
10729,4013730046,QN,25-78 100 STREET,01,A5,CARL P CHONG,2,1,1
10730,4014770060,QN,37-39 89 STREET,01,B1,"CAZHCO , SEGUNDO  D",2,1,1
10731,4014790021,QN,37-36 92 STREET,01,B1,IGLESIA DEL DIOS VIVO COLUMNA Y APOYO DE  LA VERDAD,2,1,1
10732,4014940044,QN,41-22 75 STREET,04,S4,41-22 WOODSIDE REALTY INC.,2,1,1
10733,4015480039,QN,51-21 VAN LOON STREET,01,B3,"HE, JIN MING",2,1,1
10734,4015910081,QN,94-23 42ND AVENUE,01,B3,"CHEN, MIN",2,1,1
10735,4016520043,QN,25-31 HUMPHREYS STREET,01,A5,"FLORES, JOSE A",2,1,1
10736,4016920026,QN,105-11 32 AVENUE,01,A1,GODLEY RAYMOND L,2,1,1
10737,4017170020,QN,33-26 103 STREET,02,C2,JOSE A MARIN,2,1,1
10738,4017470069,QN,35-31 105 STREET,02,C0,"CHEN, BAO XIONG",2,1,1
10739,4017780001,QN,108-12 37 DRIVE,02,C0,"CHEN, SHENG FAN",2,1,1
10740,4017810030,QN,111-29 38 AVENUE,01,B2,"ZHANG, ZHIYUAN",2,1,1
10741,4019440021,QN,103-15 MARTENSE AVENUE,01,A1,"ZHENG, JIN YUN",2,1,1
10742,4019860063,QN,104-37 43 AVENUE,02,C0,"SHAN, WEI GUANG",2,1,1
10743,4021810031,QN,11058 63 AVENUE,01,B1,HUI JIAN CHEN,2,1,1
10744,4022190029,QN,108-48 69 AVENUE,01,A1,STELLA BABAYEVA,2,1,1
10745,4023700003,QN,64-03 55 AVENUE,01,A1,"VALENTINO, LEOPORDO",2,1,1
10746,4023800024,QN,54-21 65 PLACE,01,A1,"LIN, XIU ZHI",2,1,1
10747,4023900005,QN,47-11 65 STREET,01,B2,"XU, FUPING",2,1,1
10748,4024240009,QN,50-55 67 STREET,04,S1,"FIDAN, ERGUN",2,1,1
10749,4024270012,QN,68-03 GARFIELD AVENUE,01,B1,"MCCORMACK, MICHELLE",2,1,1
10750,4026490139,QN,59-76 59 PLACE,01,A9,DAWN M.FAWCETT,2,1,1
10751,4027040086,QN,60-29 56 DRIVE,01,B1,"HYLKA, THOMAS",2,1,1
10752,4027590127,QN,64-49 60 AVENUE,01,A5,"GUADAGNO, LOUIS A",2,1,1
10753,4028120037,QN,73-09 58 AVENUE,02,C0,"DAI, LILI",2,1,1
10754,4028300007,QN,69-26 59 DRIVE,02,C0,"ANTONELLA A. NATALE, AS TRUSTEE",2,1,1
10755,4028440092,QN,59-05 74 STREET,02,C0,"DJURETIC, SRDJAN",2,1,1
10756,4028910101,QN,84-29 55 AVENUE,02,C0,"CHIU, WILLIAM",2,1,1
10757,4029240004,QN,61-71 69 STREET,01,A5,"TIRYAKI, SITKI",2,1,1
10758,4030420063,QN,65-21 79 PLACE,01,B3,"LEVEROCK, SHAUN T",2,1,1
10759,4030600029,QN,75-04 JUNIPER VALLEY ROAD,01,A1,"HENGLEIN, HELEN M",2,1,1
10760,4030670025,QN,66-26 79 STREET,01,B3,FRIEDLAND PROPERTIES LIMITED,2,1,1
10761,4031570130,QN,66-48 BOOTH STREET,01,B3,"LEE, DINO CHAO CHUN",2,1,1
10762,4032110050,QN,69-31 LOUBET STREET,01,A1,JAMES D. GOLDEN,2,1,1
10763,4033880012,QN,475 WOODWARD AVENUE,02,C1,475 WOODWARD AVE LLC,3,2,1
10764,4035790103,QN,75-06 60 PLACE,01,A9,"CALDERON, HECTOR",2,1,1
10765,4036510030,QN,69-31 67 PLACE,01,A9,LIVOTI ANTONIA,2,1,1
10766,4036870080,QN,71-33 71 STREET,02,C0,"LONGO, TOMASA",3,2,1
10767,4038150024,QN,77-26 79 STREET,01,A1,COLLINS PATRICK,2,1,1
10768,4039360001,QN,5-11 119 STREET,01,B1,DWAYNE TRANQUADA,2,1,1
10769,4040000006,QN,124-05 14 AVENUE,01,B1,NIJO REALTY HOLDINGS LLC,2,1,1
10770,4040220115,QN,10-20 116 STREET,01,A5,PATRICIA M KELLY,2,1,1
10771,4044290020,QN,141-10 13 AVENUE,01,A1,"KORZENIECKI, MAREK",2,1,1
10772,4044420068,QN,144-15 SOUTH DRIVE,01,A3,"SEDITA, ROSALIA",2,1,1
10773,4044680020,QN,2-34 148 STREET,01,A1,"SACCO, GINA",2,1,1
10774,4044980022,QN,7-22 150 STREET,01,A1,"BRAWE-HEFFERNAN, LOR",2,1,1
10775,4046320040,QN,146-11 20 ROAD,01,A1,PETER J TUOHY,2,1,1
10776,4046580034,QN,147-47 24 AVENUE,01,A5,"PUN, YUET KUI",2,1,1
10777,4047560001,QN,16-37 160 STREET,02,C6,CLEARVIEW GARDENS SIXTH CORP,88,87,1
10778,4048280034,QN,32-28 MURRAY LANE,01,A1,"SUN, YUNZHONG",2,1,1
10779,4048450060,QN,154-35 24 ROAD,01,A1,"NEMETH, THOMAS",2,1,1
10780,4049500013,QN,33-53 FARRINGTON STREET,05,H4,33-53 FARRINGTON LLC,2,1,1
10781,4049520011,QN,32-17 LINDEN STREET,02,C1,"MING GARDEN REALTY, LLC",2,1,1
10782,4049840040,QN,145-35 34 AVENUE,01,A1,MULLAN MICHAEL W,2,1,1
10783,4051480056,QN,137-37 JUNIPER AVENUE,01,B2,"ZHU, ZHENZHEN",2,1,1
10784,4052640028,QN,35-28 154 STREET,05,K2,"KIM, BONG KYUN",2,1,1
10785,4053900006,QN,42-45 159 STREET,01,B3,"XU, LISHENG",2,1,1
10786,4053910013,QN,42-31 160 STREET,01,B2,HARRY GONG,2,1,1
10787,4054190057,QN,43-50 162 STREET,04,S9,162 REALTY MANAGEMENT LLC,2,1,1
10788,4056340026,QN,196-64 49 AVENUE,01,B3,"GIANNOUTSOS, KONSTANTINA",2,1,1
10789,4059800085,QN,203-23 28 AVENUE,01,B1,"ZHANG, JIAN GUO",2,1,1
10790,4060260047,QN,32-37 JORDAN STREET,01,A5,BAVUSO ROCCO J,2,1,1
10791,4066060158,QN,138-29 77 AVENUE,01,A5,MERIK STARAYEV,2,1,1
10792,4066700001,QN,78-11 MAIN STREET,02,C6,KEW TERRACE OWNERS,10,9,1
10793,4070140032,QN,80-09 164 STREET,04,S2,GAM W CHU,3,2,1
10794,4072570052,QN,186-09 80 DRIVE,01,A1,MAVASHEV ALIK,2,1,1
10795,4072780020,QN,82-34 190 STREET,01,A3,"BEZALEL, YEHUDA",2,1,1
10796,4073080057,QN,206-51 46 ROAD,01,B1,"CHIMBO, OLGER E",2,1,1
10797,4073190021,QN,205-05 48 AVENUE,01,B2,"SUN, QIANG",2,1,1
10798,4074180043,QN,53-35 OCEANIA STREET,01,A1,"MALDONADO, ORIELA",2,1,1
10799,4074600015,QN,58-20 210 STREET,01,B3,"FRANGIOSA, NICOLA",3,2,1
10800,4074650031,QN,58-58 215 STREET,01,A2,DANILO L PECSON JR./MARIA LETICIA PECSON,2,1,1
10801,4079590051,QN,86-20 241 STREET,01,A1,"HEINFLINK, MARCOS",2,1,1
10802,4080020036,QN,92-33 240 STREET,01,B1,"KHAN,   MOHAMMAD   K.",2,1,1
10803,4080170014,QN,318 KENMORE ROAD,01,A1,"CAMERATA, JOSEPH",2,1,1
10804,4086590018,QN,91-19 245 STREET,01,A1,DEAN MARILYN,2,1,1
10805,4087900031,QN,260-10 HILLSIDE AVENUE,05,K5,HILLSIDE COARD LLC,2,1,1
10806,4088300040,QN,87-90 256 STREET,01,A1,MICHAEL VETACK,2,1,1
10807,4089610015,QN,81-04 91 AVENUE,01,B3,"BISNAUTH, RAKESH",2,1,1
10808,4089650011,QN,80-38 89 AVENUE,01,B9,"LANDIRES, LILIAN",2,1,1
10809,4090250033,QN,95-21 87 STREET,01,B2,"RICHARDS, ARCHIBALD",2,1,1
10810,4090660005,QN,92-08 97 AVENUE,01,B1,"BALGOBIND, AMAR SINGH",3,2,1
10811,4091580045,QN,105-33 91 STREET,01,B3,VELEZ OSVALDO,2,1,1
10812,4092040079,QN,86-21 108 STREET,01,B2,"JEPP, ERIK",2,1,1
10813,4093750272,QN,131-11 ATLANTIC AVENUE,06,F2,131-11 ATLANTIC REAL ESTATE INC,2,1,1
10814,4094240045,QN,106-03 103 AVENUE,01,A1,LESLIE CALDERON,2,1,1
10815,4095440020,QN,107-28 107 STREET,01,A1,"BEGUM, FERDAUS",2,1,1
10816,4096700036,QN,138-53 82 DRIVE,01,B3,"MAXIMOV, VLADIMIR",2,1,1
10817,4098100008,QN,90-16 175 STREET,01,B2,"ISHMAEL, MUSTAFA",2,1,1
10818,4098840061,QN,175-32 DEVONSHIRE ROAD,02,C0,JOHN K NAZARETIAN,2,1,1
10819,4099050081,QN,90-20 184 PLACE,01,A1,"PERSAUD, RAMDEI T",2,1,1
10820,4100300041,QN,97-17 WALTHAM STREET,01,B2,LUIS ALBERTO YAGUAL,2,1,1
10821,4100410013,QN,104-16 PINEGROVE STREET,01,A1,"MONROE, LATONIA",2,1,1
10822,4100730011,QN,107-40 PINEGROVE STREET,01,B3,"DALJEET, KOJENDRA",2,1,1
10823,4100740032,QN,143-13 LAKEWOOD AVENUE,01,A1,"MOHABIR, DEVANAND",2,1,1
10824,4102100249,QN,168-51 92 ROAD,01,A5,"ROZARIO, CHITRA P",2,1,1
10825,4102190035,QN,172-36 93 AVENUE,01,A1,WILLIE STEVENS,2,1,1
10826,4102390051,QN,105-46 171 STREET,01,B2,DONNA BRISBANE,2,1,1
10827,4102520064,QN,106-30 RUSCOE STREET,01,B1,"COHEN, DAVID",2,1,1
10828,4103180027,QN,92-09 178 PLACE,01,A1,"MCNEIL, VERONICA",2,1,1
10829,4104100016,QN,185-21 ILION AVENUE,01,A1,"COX , IRENE",2,1,1
10830,4104440001,QN,90-31 188 STREET,01,A1,"DHOMAN, RAYMOND",2,1,1
10831,4104790085,QN,94-12 FRANCIS LEWIS BLVD,01,B2,EDWARD MCCALL,2,1,1
10832,4105160065,QN,87-22 PALERMO STREET,01,A1,ABDUL HAMID,2,1,1
10833,4106440034,QN,90-34 212 PLACE,01,B2,"SHEWTAHAL, SASENARINE",2,1,1
10834,4107180032,QN,90-43 219 STREET,01,A1,ANGELA L PARISELLI,2,1,1
10835,4107330032,QN,220-05 93 AVENUE,01,B2,"LONDONO, CARLOS E",2,1,1
10836,4107480039,QN,222-25 FAIRBURY AVENUE,01,A1,JOHN D. MOORE,2,1,1
10837,4108700044,QN,100-49 203 STREET,01,A1,"ADEOYE, VICTOR",2,1,1
10838,4108830012,QN,104-27 192 STREET,01,A0,"TOLES, ALLEN W",2,1,1
10839,4109850036,QN,112-32 209 STREET,01,A1,"JONES, LASEAN",2,1,1
10840,4109980009,QN,113-27 203 STREET,01,A1,"FLYNN, LOUISE M.",2,1,1
10841,4110110003,QN,194-05 114 DRIVE,01,A1,"EDIONNE, ERIC",2,1,1
10842,4110880042,QN,214-17 104 AVENUE,01,A1,SATYAWATTEE SINGH,2,1,1
10843,4111180006,QN,215-11 110 AVENUE,01,A1,CEDRIC B BECKFORD,2,1,1
10844,4116080012,QN,109-12 128 STREET,01,B2,"SINGH BHANGU, AMANDEEP",3,2,1
10845,4116120015,QN,109-18 133 STREET,01,B3,109TH DEVELOPERS GROUP LLC,2,1,1
10846,4116500057,QN,114-25 123 STREET,01,A1,"SAHADEO, RUSSELL",2,1,1
10847,4116760058,QN,115-19 133 STREET,01,A1,MARGARET TAYLOR,2,1,1
10848,4116810010,QN,124-18 116 AVENUE,02,C0,"TAGE NARINE SINGH, AS TRUSTEE",3,2,1
10849,4116870006,QN,116-02 132 STREET,01,B3,JEET N JAIRAM,2,1,1
10850,4116890051,QN,116-31 133 STREET,01,A1,"PERSAUD, SHEM P",2,1,1
10851,4117930029,QN,133-02 133 AVENUE,01,A1,BUTLER MARTHA R,2,1,1
10852,4119640291,QN,111-29 147 STREET,01,A1,"DICKS, NADINE",2,1,1
10853,4119900027,QN,145-27 116 AVENUE,02,C3,"WANG, ZUOWEI",3,2,1
10854,4120600255,QN,127-21 142 STREET,01,A5,DEBORAH DAVIS,2,1,1
10855,4120600257,QN,127-17 142 STREET,01,A5,"SIMON-COLLIER, NEFERA",3,2,1
10856,4120650184,QN,142-16 SUTTER AVENUE,01,A1,"SUTHERLAND, JASON",2,1,1
10857,4120760206,QN,131-31 140 STREET,01,B2,"BHIM, SAISNARINE",2,1,1
10858,4120910029,QN,145-35 135 AVENUE,01,A1,GAVIN SOMERSEL,2,1,1
10859,4121420017,QN,109-58 153 STREET,01,B3,"SHAW, WALTON",2,1,1
10860,4121710027,QN,156-20 111 AVENUE,01,B2,RALEIGH W HALL,2,1,1
10861,4122020075,QN,150-57 116 DRIVE,01,A1,"SHADDI, DEBBIE",2,1,1
10862,4122250019,QN,155-26 116 ROAD,01,A1,"FOREMAN, CHARMAINE P",2,1,1
10863,4122960023,QN,134-38 158 STREET,01,B3,RONALD E DAVIS II,2,1,1
10864,4123350100,QN,165-09 FOCH BOULEVARD,01,B1,MARTIN MC GEE,2,1,1
10865,4123720258,QN,171-19 119 AVENUE,01,B3,"BOATENG, JANET",2,1,1
10866,4123810044,QN,120-15 165 STREET,01,B2,"CANNON, VIVIAN BARKER",2,1,1
10867,4124950065,QN,126-10 BAISLEY BOULEVARD,08,W1,NYC DEPARTMENT OF PARKS AND RECREATION,5,4,1
10868,4125880051,QN,140-18 171 STREET,01,A2,PATRICIA TAYLOR,2,1,1
10869,4126180013,QN,117-14 198 STREET,01,B3,CHRISTOPHER SMART,2,1,1
10870,4127020032,QN,122-13 NELLIS STREET,01,B3,"REID, DERRICK T",2,1,1
10871,4129200103,QN,244-28 STEPHANIE DRIVE,01,A1,UNAVAILABLE OWNER,2,1,1
10872,4129610010,QN,222-15 MERRICK BOULEVARD,08,Y1,FIRE DEPARTMENT OF NEW YORK,2,1,1
10873,4130450051,QN,218-31 141 AVENUE,01,A1,PULLIN GEORGE T,2,1,1
10874,4130500030,QN,180-17 143 AVENUE,01,B3,"WALTER, KELVIN SR",2,1,1
10875,4130780027,QN,182-22 143 AVENUE,01,A1,"GUACCI, JOSEPH M JR",2,1,1
10876,4131820029,QN,138-11 233 STREET,01,A1,"ALLEN, MARLON A",2,1,1
10877,4132600017,QN,138-29 234 STREET,01,A1,LEONARD KENNEDY,2,1,1
10878,4132750020,QN,144-08 176 STREET,01,B2,"DUPERVAL, MARILYN",2,1,1
10879,4132910025,QN,144-58 177 PLACE,01,A5,"ELLIOT, TRACIA C",2,1,1
10880,4133420049,QN,178-34 145 DRIVE,01,A1,DARI BRUZUALTAITT,2,1,1
10881,4133460054,QN,146-15 181 STREET,01,B2,JOSEPH BURT,2,1,1
10882,4133510070,QN,146-20 181 STREET,01,B3,DEBORAH LEWIS,2,1,1
10883,4134360028,QN,223 STREET,,Z9,"223RD STREET DEVELOPMENT, LLC",2,1,1
10884,4136420063,QN,245-29 148 DRIVE,01,B2,LUIGI NARDUZZI,2,1,1
10885,4136470076,QN,253-10 147 AVENUE,01,A5,"BLAISE, MARC J",2,1,1
10886,4136580018,QN,149-72 255 STREET,01,B2,"GRANT, JOHNATHAN",2,1,1
10887,4141600029,QN,99-19 158 AVENUE,01,B2,GENNARO BONOMO,2,1,1
10888,4141720099,QN,156-45 102 STREET,01,A1,T GALINI,2,1,1
10889,4142461200,QN,102-27 163 ROAD,01,A2,"GIUNTA TRUST 50%, JOHN A",2,1,1
10890,4154000042,QN,536 CROSS BAY BOULEVARD,01,A1,"PEARCE, DANIEL T.",2,1,1
10891,4154510018,QN,14 6 ROAD,01,A1,KNAPP JOHN,4,3,1
10892,4155260051,QN,21-18 BIRDSALL AVENUE,01,A1,FIR0T BAPT CHUR,2,1,1
10893,4155420014,QN,11-28 NEILSON STREET,01,B3,"FAHIE-HARMON, ESTHER",2,1,1
10894,4156630110,QN,13-25 MCBRIDE STREET,01,B2,SINGER  HOWARD,2,1,1
10895,4157900023,QN,25-22 DEERFIELD ROAD,02,C0,"LIVINGSTON, DAVID",2,1,1
10896,4160650048,QN,527 BEACH 72 STREET,01,B2,"PROJECT REBUILD, INC.",3,2,1
10897,4162390083,QN,170 BEACH 130 STREET,01,A1,"DIBATTISTA, JOHN",2,1,1
10898,4162760060,QN,128 BEACH 132 STREET,01,A1,"OSTRANDER, JOANNA",2,1,1
10899,4163030005,QN,146-11 NEWPORT AVENUE,01,A1,GRAY  ANDREW A,2,1,1
10900,5000350120,SI,127 BROOK STREET,04,S0,P & P REALTY GROUP LLC,2,1,1
10901,5000780148,SI,101 BARD AVENUE,01,A1,"LAWSON, JEFFERY",2,1,1
10902,5001260062,SI,342 CASTLETON AVENUE,01,B1,RENU AHUJA,2,1,1
10903,5001320025,SI,485 KISSEL AVENUE,01,A1,SHARON A ROESCH,2,1,1
10904,5001490249,SI,523 HENDERSON AVENUE,01,A1,JAMES OLIVE,2,1,1
10905,5002150242,SI,12 DUBOIS AVENUE,01,B2,"12 DUBOIS AVE REALTY, LLC",2,1,1
10906,5002240020,SI,730 DELAFIELD AVENUE,04,S1,DELAFIELD PROPERTY MANAGEMENT LLC,3,2,1
10907,5002430017,SI,82 BEVERLY AVENUE,01,A2,"HESSION, MICHAEL",2,1,1
10908,5002620033,SI,6 HURON PLACE,01,A1,"CHANELL, LORNA",2,1,1
10909,5003310068,SI,120 ROYAL OAK ROAD,01,A1,FRANCIS D CORRADO,2,1,1
10910,5003390014,SI,196 DRAKE AVENUE,01,A0,"BILLE, ERIK",2,1,1
10911,5003470033,SI,162 FAIRVIEW AVENUE,01,B2,"MELI, ANNETTE N",2,1,1
10912,5003650044,SI,25 CONSTANT AVENUE,01,A1,KONSTANTA LLC,2,1,1
10913,5003910489,SI,53 NORTH AVENUE,01,B2,"LEBIDA, HALINA",2,1,1
10914,5004170014,SI,140 WOOLLEY AVENUE,01,A1,"ARONICA, PETER J",3,2,1
10915,5004530001,SI,261 WOOLLEY AVENUE,01,A1,"DUFFY, COLLEEN",2,1,1
10916,5004840028,SI,421 WILLOWBROOK ROAD,01,B2,"CAMA, FREDERIC",2,1,1
10917,5005320011,SI,2 QUINN STREET,01,B2,2 QUINN STREET PARTNERS LLC,4,3,1
10918,5005720036,SI,4 NIXON AVENUE,01,B1,"ALOMIA, SALVATORE",2,1,1
10919,5006720020,SI,7 NORTHERN BOULEVARD,01,A5,"FAYAD, KHALED",2,1,1
10920,5007130021,SI,115 MOUNTAINVIEW AVENUE,01,A1,KATHERINE ZERINO,2,1,1
10921,5007130044,SI,69 MOUNTAINVIEW AVENUE,01,B2,"LIU , SANDY",2,1,1
10922,5007240066,SI,55 BRADLEY AVENUE,01,A9,GINA M. DELPRIORE,3,2,1
10923,5008130033,SI,144 GRAVES STREET,01,B3,"TORNABENE, JOYCE",3,2,1
10924,5008880037,SI,15 WESTENTRY ROAD,01,A3,"ZAWISNY, MARK",2,1,1
10925,5010790004,SI,57 HARRISON AVENUE,01,A1,"BICE-HOWARD, SANDRA D",2,1,1
10926,5010970013,SI,19 CRITTENDEN PLACE,01,B2,STANLEY & GERALDINE KOPACZ,2,1,1
10927,5011480061,SI,72 BOWLES AVENUE,02,C3,PAVLIDIS KONSTANTINOS,2,1,1
10928,5011700064,SI,352 PULASKI AVENUE,01,B2,"TAYLOR, CHERYL ANN",2,1,1
10929,5012430069,SI,184 HARBOR ROAD,02,C3,I.D.G.S. LLC,2,1,1
10930,5014830075,SI,150 VEDDER AVENUE,01,B2,"JABER, NESREEN M",2,1,1
10931,5015040062,SI,127 HAWTHORNE AVENUE,01,A9,"INDYMAC BANK, F.S.B.",2,1,1
10932,5015160021,SI,570 WEST CASWELL AVENUE,01,A1,BRAVO LIMA ALPHA MANAGEMENT LLC,2,1,1
10933,5017000075,SI,26 EUNICE PLACE,01,A1,"BREEDEN, DARRYL T",2,1,1
10934,5021140067,SI,37 ROCKVILLE AVENUE,01,B2,"PAPRANIKU, SALAUDIN",2,1,1
10935,5022700028,SI,248 ST GEORGE ROAD,01,A1,"SALIMENI , CARLO",2,1,1
10936,5022880108,SI,387 EDINBORO ROAD,01,A1,"ERRICHIELLO, MICHAEL J",2,1,1
10937,5024017501,SI,4 RACAL COURT,02,R3,HONEY BEE CONDOMINIUMI,30,29,1
10938,5028100096,SI,356 MEREDITH AVENUE,01,A1,"364 MEREDITH AVENUE, LLC",2,1,1
10939,5030720087,SI,1490 BAY STREET,01,A1,"PETRELA, ORAWAN",2,1,1
10940,5031530038,SI,1850 CLOVE ROAD,08,Y1,FIRE DEPARTMENT OF NEW YORK,2,1,1
10941,5032890001,SI,1298 RICHMOND ROAD,04,S2,"GAMBINO, STEVEN",2,1,1
10942,5033270052,SI,1461 HYLAN BOULEVARD,05,K1,PAROLISI FAMILY PARTN,2,1,1
10943,5033600039,SI,196 EVERGREEN AVENUE,01,B2,RIFAT LJIKOVIC,2,1,1
10944,5035770051,SI,31 COLFAX AVENUE,01,A5,"HENRY, JASON",2,1,1
10945,5038040033,SI,1099 OLYMPIA BOULEVARD,01,A1,JACQUELINE REYES,2,1,1
10946,5038370009,SI,721 BUEL AVENUE,11,V0,HOUSING TRUST FUN CORPORATION,2,1,1
10947,5040430029,SI,65 MILTON AVENUE,01,B2,"EPPEL, SUSE A M",2,1,1
10948,5040850016,SI,151 MARINE WAY,01,A2,JOANNE OLSEN,2,1,1
10949,5042160011,SI,109 8 STREET,01,A1,"SMITH , THOMAS P JR",2,1,1
10950,5042190001,SI,63 CODDINGTON AVENUE,01,B1,"ASENG, CARISSA",2,1,1
10951,5042230025,SI,300 ROSE AVENUE,01,A1,ROSEANN LO SCHIAVO,2,1,1
10952,5044210057,SI,301 AMBER STREET,01,A1,WILLIAMSON MICHAEL F,2,1,1
10953,5045830032,SI,417 CORBIN AVENUE,01,A1,SBLENDIDO FRANK,2,1,1
10954,5051130014,SI,24 KEATS STREET,01,B2,"ACITO, LAURA",2,1,1
10955,5052230035,SI,1A SHERWOOD PLACE,01,B2,"IMPERATO, GERARD  T",2,1,1
10956,5052930024,SI,109 RIDGECREST AVENUE,01,B1,"RICHARD ALEXANDER, AS TRUSTEE",2,1,1
10957,5053070032,SI,46 GOODALL STREET,01,A1,"ZHOU, CHAO PING",2,1,1
10958,5054890269,SI,141 GENESEE AVENUE,01,A1,"MATTHEW R. PALCIC, AS TRUSTEE",2,1,1
10959,5056150078,SI,71 VAN BRUNT STREET,01,B3,"GOTTLEIB, ARNOLD",2,1,1
10960,5056260018,SI,102 PETRUS AVENUE,01,A1,"HANAFY, SHERIF",2,1,1
10961,5057400211,SI,25 ASPEN KNOLLS WAY,01,A5,"STREK, ADAM",2,1,1
10962,5060120020,SI,509 JEFFERSON BOULEVARD,01,A1,GERTRUDE E HOLLS,2,1,1
10963,5061420001,SI,70 MASON BOULEVARD,01,B9,"OTTRANDO, NEIL",2,1,1
10964,5064690039,SI,16 COTTONTAIL COURT,01,B2,"CORSO , STEPHANIE  M",2,1,1
10965,5065590056,SI,70 ARBUTUS AVENUE,01,B2,IRENE NIKHAMOV,2,1,1
10966,5067750249,SI,42 SHERWOOD AVENUE,01,B2,"KELLY, KATHLEEN",2,1,1
10967,5068560039,SI,39 WHEELING AVENUE,01,A1,"SLEAP, KENNETH M",2,1,1
10968,5068710036,SI,1721 CARLTON AVENUE,01,A2,CHRISTOPHER HANSEN,2,1,1
10969,5075720084,SI,47 MADSEN AVENUE,01,A1,"GIAMBANCO, SALVATORE",2,1,1
10970,5075720126,SI,127 MADSEN AVENUE,01,B2,"ROMAN, RAQUEL",2,1,1
10971,5076640300,SI,4 BEDELL STREET,01,A1,MORALES MAURICIO E,2,1,1
10972,5078530012,SI,345 BREHAUT AVENUE,01,A1,"HANSEN, LUKE",2,1,1
10973,5078540059,SI,322 BREHAUT AVENUE,01,A1,CRISTINE THIRO,2,1,1
10974,5078640083,SI,537 ROCKAWAY STREET,01,B2,"WASSEF, GIRGIS",2,1,1
10975,5078640094,SI,7104 HYLAN BOULEVARD,01,A2,JOHN DUCEY,2,1,1
10976,5078670095,SI,441 SLEIGHT AVENUE,01,A1,"TROIANO, VINCENT",2,1,1
10977,5078920045,SI,212 BRIGHTON STREET,01,A1,ROBERT M. VERTICCHIO,2,1,1
10978,5079660066,SI,42 SATTERLEE STREET,01,B2,ROBERT R BUTLER,2,1,1
10979,5080310053,SI,479 CRAIG AVENUE,01,B2,"WAKIE, JENNIFER",2,1,1
10980,5080460090,SI,230 YETMAN AVENUE,01,B3,YETMAN AVENUE REALTY HOLDING LTD,2,1,1
10981,1006090062,MN,133 WEST 13 STREET,04,S5,"ROSENBLUM, KENNETH",2,1,1
10982,1006750039,MN,606 WEST 30TH ST,11,V1,WEST 30TH STREET LLC,2,1,1
10983,1007340001,MN,466 10 AVENUE,07,G3,NAPA REALTY CORP,2,1,1
10984,1008230042,MN,166 5 AVENUE,05,O6,"166 FIFTH AVENUE,LLC",2,1,1
10985,1008960032,MN,230 EAST 15 STREET,03,D4,RUTHERFORD TENANTS CORP,2,1,1
10986,1011460002,MN,303 AMSTERDAM AVENUE,04,S9,301-303,2,1,1
10987,1012600020,MN,27 WEST 44 STREET,05,H5,HARVARD CLUB OF NEW YORK CITY,2,1,1
10988,1013390027,MN,833 1 AVENUE,09,Q1,NYC DEPARTMENT OF PARKS AND RECREATION,2,1,1
10989,1015100052,MN,1205 LEXINGTON AVENUE,04,C7,1201 LEX,2,1,1
10990,2023220028,BX,2522 PARK AVENUE,07,G9,YELLOW CAB REALTY LLC,3,2,1
10991,2023490101,BX, EXTERIOR STREET,10,G1,NYC PARKS DEPT,2,1,1
10992,2023790007,BX,404 EAST 158 STREET,04,D7,SENIOR LIVING OPTIONS INC,2,1,1
10993,2024100061,BX,319 EAST 150 STREET,01,B2,"KUBI, MATHIAS APPLAH",2,1,1
10994,2025730041,BX,354 JACKSON AVENUE,07,G2,2910 PARK AVENUE CORPORATION,2,1,1
10995,2027060062,BX,1139 TIFFANY STREET,02,C3,ADEBAYO JOBI,2,1,1
10996,2027220065,BX,878 TIFFANY STREET,01,A9,R C CHURCH ST ATHANAS,2,1,1
10997,2027720084,BX,1310 OAK POINT AVENUE,10,G1,"1310 OAK POINT, LLC",3,2,1
10998,2028690034,BX,45 WEST TREMONT AVENUE,04,C7,RECLAIM ROUND II HOUSING DEVELOPMENT FUN D CORPORAT,2,1,1
10999,2029680034,BX,1284 UNION AVENUE,01,A1,"BRYAN, GLADYS",2,1,1
11000,2030370037,BX,4418 PARK AVENUE,02,C0,PARK HOUSE INC,2,1,1
11001,2031630003,BX,2238 CRESTON AVENUE,04,D7,"2238 CRESTON AVENUE, LLC",2,1,1
11002,2032580063,BX,3372 FT INDEPENDENCE ST,01,A1,ROSE MARIE SABANGAN,2,1,1
11003,2032950022,BX,2776 BRIGGS AVENUE,02,C0,"BYRNE, KEVIN",2,1,1
11004,2033420061,BX,297 EAST 206 STREET,01,A1,GLAD TIDINGS ASSEMBLY OF GOD,2,1,1
11005,2033790006,BX,4340 KEPLER AVENUE,01,A1,"IBRAHIM, IBRAHIM",2,1,1
11006,2034420047,BX,1621 HARDING PARK,01,A1,OWL ASSETS INC,2,1,1
11007,2034560048,BX,1928 O'BRIEN AVENUE,01,A1,"CHOWDHURY, BODRUL H",2,1,1
11008,2034750037,BX,356 WHITE PLAINS ROAD,01,B3,CARMEN CAINES,2,1,1
11009,2035960047,BX,742 COMMONWEALTH AVENUE,02,C0,"MEJIAS , KEITH",2,1,1
11010,2036860005,BX,870 OLMSTEAD AVENUE,01,B1,"DIAZ, BENJAMIN",3,2,1
11011,2036910037,BX,2262 HERMANY AVENUE,01,A1,EILEEN HOETZEL,4,3,1
11012,2037320059,BX,1057 WHITE PLAINS ROAD,02,C0,"NG, WUNG FONG",2,1,1
11013,2038380260,BX,1400 FERRIS PLACE,11,V1,FERRIS PE CP,9,8,1
11014,2038620026,BX,1341 ELDER AVENUE,02,C0,"PALMAY, JOHN O",2,1,1
11015,2038850001,BX,1544 EAST 174 STREET,05,K1,1544 E LLC,4,3,1
11016,2039080018,BX,1180 EAST 178 STREET,02,C0,1180 178TH ST LLC,2,1,1
11017,2039090024,BX,1198 EAST TREMONT AVENUE,07,G4,"GTY-CPG (QNS/BX) LEASING, INC.",2,1,1
11018,2039790070,BX,2476 ST RAYMOND AVENUE,04,S2,"UDDIN , MOHAMMED ASHAB",2,1,1
11019,2040670008,BX,1520 PAULDING AVENUE,02,C0,TRACKSIDE HOMES LLC,2,1,1
11020,2041110007,BX,1653 YATES AVENUE,01,A1,MARIA DEROSA,2,1,1
11021,2042450001,BX,2002 HOBART AVENUE,01,B2,"BERNARDONE, JAMES",2,1,1
11022,2042700062,BX,1952 HONE AVENUE,01,B3,"RIVERA, JOSEPH",2,1,1
11023,2044500033,BX,2560 PAULDING AVENUE,02,C0,"DONSANJH, HARINDER",2,1,1
11024,2044730051,BX,2425 FENTON AVENUE,01,A2,"C & S FENTON, LLC",2,1,1
11025,2045480030,BX,2992 HOLLAND AVENUE,01,A5,"YAYA, MOUNIROU",2,1,1
11026,2045670103,BX,1458 EAST GUN HILL ROAD,04,S4,"JEUNG, SHING",2,1,1
11027,2046050003,BX,841 BURKE AVENUE,04,S1,"BALIKCIOGLU, INGRIT",2,1,1
11028,2046320050,BX,774 EAST GUN HILL ROAD,08,W9,NYC DEPARTMENT OF EDUCATION,2,1,1
11029,2046460040,BX,3668 OLINVILLE AVENUE,01,B3,"SANGANOO, MARGARET",2,1,1
11030,2046730060,BX,822 EAST 215 STREET,02,C0,"THOMAS , GARY A",2,1,1
11031,2046810020,BX,937 EAST GUN HILL ROAD,04,S5,RSP HOLDING CORP.,4,3,1
11032,2047260123,BX,3525 MICKLE AVENUE,01,B1,"DELGADO, HERENIA",2,1,1
11033,2047340012,BX,3363 WILSON AVENUE,01,A5,3363 WILSON CORP.,2,1,1
11034,2047420053,BX,3252 FENTON AVENUE,01,A5,PATRICK ERNESTINE,2,1,1
11035,2048530060,BX,816 EAST 229 STREET,02,C0,"JOHNSON, LAURA",2,1,1
11036,2048810001,BX,1449 EAST 222 STREET,06,F5,"1449 EAST 222ND VENTURES,",2,1,1
11037,2048850061,BX,3412 ELY AVENUE,01,B1,"CUASCUT, ALEIDA",3,2,1
11038,2049690042,BX,4048 SECOR AVENUE,01,A1,DENISE A KNIGHT,2,1,1
11039,2050080014,BX,4159 WICKHAM AVENUE,01,B2,"HENRIQUEZ, RAMON A",2,1,1
11040,2051100024,BX,659 EAST 243 STREET,01,B1,"U.S. BANK TRUST, N.A., AS TRUSTEE",2,1,1
11041,2051230006,BX,4512 HILL AVENUE,01,A1,MERINA NEAL,2,1,1
11042,2053920022,BX,1421 CROSBY AVENUE,02,C0,FERRIELLO CHIARINA,2,1,1
11043,2054090317,BX,3315 AGAR PLACE,01,B1,"BUJAJ, LUIGJ",2,1,1
11044,2054110249,BX,1511 DWIGHT PLACE,01,B3,GIUSEPPE PIRRAGLIA,2,1,1
11045,2054130122,BX,1647 STADIUM AVENUE,02,C0,"BLEJEC, ANTON",2,1,1
11046,2054140003,BX,1456 STADIUM AVENUE,01,B1,"CENTINEO, ANNA",2,1,1
11047,2054140122,BX,3324 RADIO DRIVE,01,B3,THOMAS E COZZI,2,1,1
11048,2054650005,BX,3258 LAYTON AVENUE,01,A1,"CIOFFI, MICHAEL",2,1,1
11049,2056070085,BX,2590 SCHURZ AVENUE,01,A1,KILROY CATHERINE,2,1,1
11050,2056260178,BX,3 REYNOLDS STREET,01,A2,"PHILLIPS, AMY E",2,1,1
11051,2056370091,BX,186 ROCHELLE STREET,01,A1,PASSO STANLEY,2,1,1
11052,2056510049,BX,1449 ROOSEVELT AVENUE,01,A9,ELM ASSOCIATES,2,1,1
11053,2057120060,BX,317 WEST 230 STREET,07,G4,P.B.C.A. REALTY CORP.,2,1,1
11054,2059450075,BX,555 WEST 252 STREET,01,A3,A 1 CAPITAL CORP,2,1,1
11055,3002810001,BK,70 COLUMBIA STREET,07,T2,PORT AUTHORITY OF NY AND NJ,17,16,1
11056,3003210040,BK,132 KANE STREET,01,A9,NRL URF LLC,2,1,1
11057,3003730026,BK,38 4 PLACE,02,C3,ALISON J RUSSELL,2,1,1
11058,3004270061,BK,615 SACKETT STREET,06,F5,601 SACKETT PROPERTY OWNER LLC,2,1,1
11059,3004370036,BK,316 BOND STREET,02,C3,UNION BOND REALTY LTD,2,1,1
11060,3006760024,BK,142A 31 STREET,01,B9,"GOLDFARB, JASON",2,1,1
11061,3007280048,BK,361 44 STREET,01,B9,ERICA Y-TU ONG,2,1,1
11062,3008030005,BK,2A 52 STREET,07,Y6,NYC DEPARTMENT OF SMALL BUSINESS SERVICES,11,10,1
11063,3008180011,BK,5301 7 AVENUE,08,W8,JOHN TRAN,2,1,1
11064,3008587501,BK,5805 7 AVENUE,04,RM,UNAVAILABLE OWNER,2,1,1
11065,3009130049,BK,559 40 STREET,01,B9,ARRASMITH TYNDALL,2,1,1
11066,3009150003,BK,3917 7 AVENUE,02,C0,"JIN, REN YI",2,1,1
11067,3009300032,BK,424 DEAN STREET,08,M1,SWED IMMANUEL M E CH,2,1,1
11068,3009720043,BK,201 3 STREET,07,G9,GOWANUS OWNER LLC,2,1,1
11069,3010270019,BK,176 12 STREET,01,B2,"TSE, HING TO",2,1,1
11070,3011490031,BK,906 BERGEN STREET,11,V0,906 BERGEN STREET LLC,2,1,1
11071,3012910031,BK,1300 CARROLL STREET,01,A4,"THOONEN-RODRIGUEZ, INGRID",2,1,1
11072,3013600025,BK,1150 ST MARKS AVENUE,02,C3,MERVIN RUSSELL,2,1,1
11073,3014010026,BK,1618 UNION STREET,01,B3,"LIBEROW, ISRAEL",2,1,1
11074,3014130051,BK,699 CROWN STREET,01,A5,KATZMAN CHAVI,2,1,1
11075,3014200014,BK,816 CROWN STREET,02,C3,BLACK DOROTHY V,2,1,1
11076,3014220061,BK,709 EMPIRE BOULEVARD,01,B1,709 EMPIRE LLC,2,1,1
11077,3014460066,BK,1891 BERGEN STREET,01,B1,"SIMON, PAULA V",2,1,1
11078,3014750035,BK,1412 EASTERN PARKWAY,07,G5,"1412 EASTERN, LLC",2,1,1
11079,3015040034,BK,556 DECATUR STREET,01,B1,"MARONE, GUILHERME",2,1,1
11080,3016790035,BK,416 LEWIS AVENUE,04,S2,DECATUR REALTY CORP,2,1,1
11081,3017260120,BK,194 HOPKINS STREET,01,B9,F&F TRUST,2,1,1
11082,3020300003,BK,43 CUMBERLAND STREET,02,C1,"43 CUMBERLAND, LLC",2,1,1
11083,3022140033,BK,285 PENN STREET,02,C3,"LEIFER, NACHMAN",2,1,1
11084,3022160006,BK,711 KENT AVENUE,07,G4,713 KENT AVE REALTY CORP,2,1,1
11085,3023270012,BK,140 NORTH 7 STREET,01,B2,NICHOLAS A HILL,2,1,1
11086,3024720350,BK,1155 MANHATTAN AVENUE,06,F9,MANHATTAN AVE HOLDING CORPORATION,2,1,1
11087,3026630016,BK,66 VAN DAM STREET,06,F5,C & L ASSOCIATES,2,1,1
11088,3027340032,BK,143 FROST STREET,06,E9,MANCIA REALTY CORP,2,1,1
11089,3027410017,BK,235 MEEKER AVENUE,05,H4,"GANGESHWAR, LLC",2,1,1
11090,3027440012,BK,150 WITHERS STREET,02,C2,"CASA 150, LLC",2,1,1
11091,3027620013,BK,622 METROPOLITAN AVENUE,04,S2,622 METROPOLITAN AVENUE LLC,2,1,1
11092,3027690009,BK,106 DEVOE STREET,01,B9,ANGELINA DIGIOIA,2,1,1
11093,3027710004,BK,316 GRAHAM AVENUE,02,C0,CERASUOLO FAMILY 2015 IRREVOCABLE TRUST,2,1,1
11094,3029510005,BK,208 VARICK AVENUE,,Z9,190 VARICK AVE RLTY CORP,2,1,1
11095,3030620028,BK,203 JOHNSON AVENUE,01,B1,"CRUZ, ALICIA",2,1,1
11096,3031620019,BK,126 MELROSE STREET,02,C2,126 MELROSE LLC,2,1,1
11097,3032530013,BK,14 STOCKHOLM STREET,01,B3,"ZELOUF, DAVID",2,1,1
11098,3032720042,BK,411 HIMROD STREET,02,C2,MANHATTAN EAST CORP,2,1,1
11099,3033210009,BK,22 GROVE STREET,01,B2,"CHAPARRO, JULIO",2,1,1
11100,3034710032,BK,103 VANDERVEER STREET,01,B2,ANJONIC OPPORTUNITY ZONE BUSINESS LLC,2,1,1
11101,3035210005,BK,181 CHESTER STREET,04,S2,"GRIFFITH, TROY",2,1,1
11102,3036880011,BK,179 NEW JERSEY AVENUE,02,C3,"VERSOZA, PETER",2,1,1
11103,3037200026,BK,206 PENNSYLVANIA AVENUE,01,B1,206 PENN AVE LLC,2,1,1
11104,3038420007,BK,659 VERMONT STREET,02,C1,VERMONT REALTY PARTNERS LLC,2,1,1
11105,3039530010,BK,173 ASHFORD STREET,01,B2,"MCCALL, MARY",2,1,1
11106,3039710047,BK,737 LIBERTY AVENUE,04,S3,737 LIBERTY AVE LLC,2,1,1
11107,3039950001,BK,353 HENDRIX STREET,03,D1,MRC HOUSING DEVELOPMENT FUND COMPANY INC,2,1,1
11108,3040140012,BK,2326 PITKIN AVENUE,03,D1,"NORTH CORE ASSOCIATES, L.P.",2,1,1
11109,3041650044,BK,31 HILL STREET,02,C0,"ISLAM, ZARIHUL",3,2,1
11110,3042120020,BK,994 GLENMORE AVENUE,08,M1,GLENMORE AVE PRESBYTERIAN CHURCH,2,1,1
11111,3042320029,BK,506 EUCLID AVENUE,01,B2,"AHMED, FARUQUE",2,1,1
11112,3042400009,BK,2906 PITKIN AVENUE,01,B2,"HASSAN, MOINUL",2,1,1
11113,3042460034,BK,284 FOUNTAIN AVENUE,02,C0,"GOLDEN, CECIL G",2,1,1
11114,3044220009,BK,940 JEROME STREET,02,C0,"YOUNG, DI-NOLA",2,1,1
11115,3045290009,BK,1162 STANLEY AVENUE,01,B2,CALISE ROSEANN,2,1,1
11116,3046750059,BK,365 EAST 49 STREET,02,C0,"BIRD, JOAN",2,1,1
11117,3046920019,BK,446 EAST 96 STREET,02,C3,"BROWN, OMAR",2,1,1
11118,3047380020,BK,450 EAST 54 STREET,01,A1,"ROUZEAU, NELATON E",2,1,1
11119,3048730060,BK,875 BROOKLYN AVENUE,01,B2,"RAHMAN, ASIF",2,1,1
11120,3049360033,BK,3617 CLARENDON ROAD,01,B2,"GALLOP, ELSIE",2,1,1
11121,3049480064,BK,357 EAST 31 STREET,01,A9,NATAN 1 LLC,2,1,1
11122,3049770035,BK,1330 TROY AVENUE,01,B3,"WALTERS-HINDS, ALECIA F",2,1,1
11123,3050480061,BK,393 PARKSIDE AVENUE,01,B1,MICHAEL LENT,2,1,1
11124,3051080039,BK,180 ERASMUS STREET,02,C1,180 ERASMUS EQUITIES LLC,2,1,1
11125,3051290029,BK,2715 TILDEN AVENUE,01,B1,"LUBOW, ALLYSON",2,1,1
11126,3051700040,BK,2611 CLARENDON ROAD,01,B3,"JONES, JOHN",2,1,1
11127,3052370240,BK,1427 GLENWOOD ROAD,01,A1,"SAAD, AHMED L",2,1,1
11128,3052900035,BK,1112 38 STREET,11,V1,3801 YKY LLC,3,2,1
11129,3053000062,BK,1327 38 STREET,08,W2,MOSHE KRAMER TRUSTEE OF THE BNEI TORAH T RUST,2,1,1
11130,3053140011,BK,51 LOUISA STREET,02,C0,"MEDISHAH, AGHA Y",2,1,1
11131,3053750035,BK,506 EAST 7 STREET,01,B2,"ARYEH BELSKY, AS TRUSTEE",2,1,1
11132,3054020149,BK,611 EAST 8 STREET,01,B1,ROYAL REAL ESTATE DEV LLC,2,1,1
11133,3054240016,BK,214 NEWKIRK AVENUE,04,S3,"ALI, SHAFQAT",4,3,1
11134,3054330063,BK,1535 46 STREET,02,C0,"BERKOWITZ, SARAH/TR",2,1,1
11135,3054440047,BK,1763 48 STREET,01,A9,KLEIN REBECCA,2,1,1
11136,3054730054,BK,1765 53 STREET,01,B2,YOSEF MERMELSTEIN,2,1,1
11137,3054750034,BK,1966 52 STREET,01,B1,"STERN, SARA",2,1,1
11138,3054810014,BK,1922 53 STREET,01,B3,"VALLACH, SHULIM J",2,1,1
11139,3054860143,BK,5420 18 AVENUE,01,A5,DAVID O SCHWARTZ,2,1,1
11140,3054900001,BK,1703 56 STREET,01,A1,"BAUM, SAMUEL",2,1,1
11141,3054910033,BK,1564 56 STREET,01,B2,MALKIE WEISS,2,1,1
11142,3055000024,BK,2040 57 STREET,01,B2,WEBCADE REALTY LLC,2,1,1
11143,3055260020,BK,1836 61 STREET,01,A5,"HALBERSTAM, YECHESKEL",2,1,1
11144,3055720011,BK,2116 67 STREET,01,A5,"LIU, XIAO YAN",2,1,1
11145,3055720042,BK,2171 68 STREET,04,K4,H & Y HOLDING GROUP INC,2,1,1
11146,3055760061,BK,1767 BAY RIDGE AVENUE,01,B3,"DINICOLA, MARY",3,2,1
11147,3056130035,BK,972 45 STREET,08,M9,CONG MACHZEKI HADAS O,2,1,1
11148,3057060067,BK,1425 59 STREET,02,C0,"SCHONFELD, DAVID",2,1,1
11149,3057160054,BK,1051 61 STREET,06,E1,GRANITE REALTY CORP.,2,1,1
11150,3057440049,BK,6408 11 AVENUE,04,K4,6408 11TH AVENUE LLC,2,1,1
11151,3057980017,BK,222 62 STREET,01,B2,"CHEN, TAIDI",2,1,1
11152,3058560082,BK,515 SENATOR STREET,01,B3,"LIN, JI DONG",2,1,1
11153,3058710048,BK,6908 3 AVENUE,04,S2,PECONIO LAURA,2,1,1
11154,3059150067,BK,49 74 STREET,01,A3,"DUAN, HAIOU",2,1,1
11155,3059790067,BK,339 80 STREET,01,A1,CAFIERO JOHN,2,1,1
11156,3060310032,BK,80 85 STREET,01,B2,"SIBLEY, MICHAEL",2,1,1
11157,3060840049,BK,171 92 STREET,01,B1,"AYOUB, BASSAM",2,1,1
11158,3062660043,BK,7918 12 AVENUE,01,B1,"RANIERI, FRANK",2,1,1
11159,3063130041,BK,8126 BAY 16 STREET,02,C0,"ZHU, WEN HUA",2,1,1
11160,3063220020,BK,1336 84 STREET,01,B2,"BERARDELLI, GENNARO",2,1,1
11161,3064117502,BK,135 BAY 26 STREET,02,R3,UNAVAILABLE OWNER,2,1,1
11162,3065110064,BK,875 EAST 8 STREET,01,A1,"MANN, JOAN",2,1,1
11163,3065280079,BK,1117 EAST 7 STREET,01,A1,"JOSEPH S. SUTTON, TRUSTEE",2,1,1
11164,3065290019,BK,1034 EAST 9 STREET,01,A3,MISHAAN FLORA,2,1,1
11165,3065340015,BK,1122 EAST 9 STREET,01,A1,"DAVID, YISROEL",2,1,1
11166,3065420019,BK,1312 EAST 7 STREET,01,B2,"RAHMEY, STEPHEN S",2,1,1
11167,3065660007,BK,318 AVENUE M,01,B2,EDUARD PEVSNER,2,1,1
11168,3065670021,BK,1418 EAST 5 STREET,01,B2,"MATUT, NATHAN",2,1,1
11169,3065820090,BK,1435 DAHILL ROAD,01,B1,"SHUR, DMITRIY",2,1,1
11170,3065890043,BK,1478 EAST 8 STREET,01,B1,"SHALOM, ALICE",2,1,1
11171,3065900045,BK,1488 EAST 9 STREET,01,A1,DAVID GADELOFF,2,1,1
11172,3065960082,BK,1525 WEST 11 STREET,02,C1,BAYWEST REATLY,2,1,1
11173,3066130083,BK,1533 OCEAN PARKWAY,01,B2,"IMIR , YAKUP",2,1,1
11174,3066130085,BK,1527 OCEAN PARKWAY,01,B1,"IMIR, HARUN",2,1,1
11175,3066140003,BK,710 AVENUE O,01,B1,PEARL HERSKOVITS IRREVOCABLE GRANTOR TRU ST,2,1,1
11176,3066420065,BK,1631 EAST 10 STREET,01,B2,"NAKASH, YOSEF",2,1,1
11177,3066640037,BK,1795 EAST 7 STREET,01,B2,"BERENBAUM, REICHEL",2,1,1
11178,3066850112,BK,906 1 COURT,01,A9,"DAYAN, RAYMOND",2,1,1
11179,3066960031,BK,860 EAST 13 STREET,01,A9,HOE WOODS REALTY CORP,2,1,1
11180,3067120046,BK,945 EAST 19 STREET,01,A1,JEFFREY ZAGELBAUM,2,1,1
11181,3067240038,BK,1176 EAST 14 STREET,01,B1,"WEISSMAN, AHRON",2,1,1
11182,3067817502,BK,1686 EAST 19 STREET,04,RM,UNAVAILABLE OWNER,2,1,1
11183,3068050001,BK,2202 QUENTIN ROAD,01,A1,"OVED,DARREN",2,1,1
11184,3068750070,BK,8732 24 AVENUE,01,B1,"CHI, ANDY GUOFENG",2,1,1
11185,3069730047,BK,3817 LAUREL AVENUE,01,A1,"ZUSMAN, OLEG",2,1,1
11186,3069730064,BK,3851 LAUREL AVENUE,01,A9,FREUND LEO,2,1,1
11187,3070000049,BK,3721 NEPTUNE AVENUE,01,B2,"YANG, CHANG R",2,1,1
11188,3070160164,BK,2836 WEST 22 STREET,01,A5,PO CHU SETO,2,1,1
11189,3070370083,BK,4725 BEACH 47 STREET,02,C5,B4725 LLC,2,1,1
11190,3070850108,BK,150 VAN SICKLEN STREET,01,A1,150 VAN SICKLEN LLC,2,1,1
11191,3071100079,BK,2079 EAST 7 STREET,01,A5,"SASSON, LINDA",2,1,1
11192,3071520048,BK,349 AVENUE W,01,B1,"SAKKAL, CHILA",2,1,1
11193,3072920028,BK,1954 EAST 14 STREET,01,A1,MIZRAHI GARY,2,1,1
11194,3073430020,BK,2134 EAST 12 STREET,01,A2,"NAHUM, MILENE",2,1,1
11195,3075950037,BK,921 EAST 31 STREET,01,A9,"RUDICH, MOSHE",2,1,1
11196,3076220026,BK,1215 EAST 22ND STREET,01,B3,1215 EAST 22ND LLC,2,1,1
11197,3076430003,BK,2515 AVENUE M,01,B2,"BROWN, ALAN",2,1,1
11198,3076520023,BK,1411 EAST 34 STREET,01,A1,MARC PUDERBEUTEL,2,1,1
11199,3076940004,BK,3215 AVENUE P,01,B1,"AZAM, RAFIQUE",2,1,1
11200,3076960023,BK,1597 EAST 34 STREET,01,A9,"GREENBERGER, CHAIM DO",2,1,1
11201,3077290228,BK,4606 GLENDALE COURT,01,A9,"LEWISON, PETER",2,1,1
11202,3077550029,BK,1189 EAST 51 STREET,01,B3,VIOLETA LEBELL,2,1,1
11203,3078220060,BK,2038 EAST 41 STREET,01,A5,ALONSO-RAINSFOR VIRGINIA M,2,1,1
11204,3078390001,BK,2164 RALPH AVENUE,08,M1,TEMPLE HILLEL OF FLATLANDS INC,2,1,1
11205,3079010072,BK,1464 EAST 57 STREET,01,A9,MARGARET FLOOD,2,1,1
11206,3079490033,BK,5335 KINGS HIGHWAY,05,GU,JA PROPERTIES INC,2,1,1
11207,3080040022,BK,737 EAST 83 STREET,01,A2,"HILL, ROBERTA",3,2,1
11208,3080100011,BK,761 EAST 89 STREET,01,B1,"RILEY, SEAN",2,1,1
11209,3081800109,BK,9207 FLATLANDS AVENUE,04,S1,DNB BROOKLYN 9207 LLC,2,1,1
11210,3082380080,BK,1409 EAST 92 STREET,04,S1,"HICKS, SONMI",2,1,1
11211,3084420006,BK,7301 AVENUE W,01,A1,"LOCCISANO, NATALE F",2,1,1
11212,3085210066,BK,2056 EAST 36 STREET,01,A5,"CIRINO AS TRUSTEE, HENRY J",2,1,1
11213,3085400061,BK,2136 COLEMAN STREET,01,A2,"HAIDER, ASIF MAHMOOD",3,2,1
11214,3086040010,BK,2369 56 DRIVE,01,A3,BORIS ITSKOVICH,2,1,1
11215,3086720043,BK,3047 BRIGHTON 2 STREET,02,C2,"3047 BRIGTHON 2ND STREET, LLC",2,1,1
11216,3086720067,BK,250 OCEAN VIEW AVENUE,01,B3,"MENG , XIAOZHUAN",2,1,1
11217,3086720080,BK,3038 BRIGHTON 3 STREET,01,B3,ROY ALEX L,2,1,1
11218,3087150037,BK,3080 BRIGHTON 13 STREET,04,O8,"CHERFAS, RUT",2,1,1
11219,4000470030,QN,10-54 46 ROAD,01,B2,"RODRIGUEZ, LUIS E.",2,1,1
11220,4002360003,QN,36-13 GREENPOINT AVENUE,01,B1,LMM ESTATE HOLDING LLC,2,1,1
11221,4003190013,QN,33-71 10 STREET,01,A2,"NASSIS, DIMITRIOS",2,1,1
11222,4004180019,QN,41-05 29 STREET,04,D7,41-05 29TH STREET OWNER LLC,2,1,1
11223,4005180030,QN,12-36 31 AVENUE,08,I5,NYC DEPARTMENT OF HEALTH AND MENTAL HYGIENE,2,1,1
11224,4005970110,QN,26-26 30 STREET,02,C1,26-26 30TH STREET LLC,2,1,1
11225,4006470006,QN,32-79 36 STREET,02,C0,UNAVAILABLE OWNER,2,1,1
11226,4007230008,QN,47-15 34 AVENUE,04,K4,ASHLEY YOUNG LLC,3,2,1
11227,4008650039,QN,24-14 23 AVENUE,01,B3,"MALAMIS, AMALIA",2,1,1
11228,4008650139,QN,24-16 23 AVENUE,01,A5,"ELIAS , MARIA",2,1,1
11229,4008750019,QN,23-59 23 STREET,01,B1,CATERINA J. VILLAREALE REVOCABLE TRUST,2,1,1
11230,4008820073,QN,20-48 23 STREET,01,B1,VENANCIO GUZMAN,2,1,1
11231,4009030027,QN,26-11 9 STREET,01,B3,"SERAT, CATHERINE",3,2,1
11232,4009700050,QN,21-31 74 STREET,01,B1,"ANGELOPOULOS, PAULA",2,1,1
11233,4011950066,QN,34-24 57 STREET,02,C0,"CHEN, RUIYUE",2,1,1
11234,4012837501,QN,37-22 73 STREET,04,RM,UNAVAILABLE OWNER,2,1,1
11235,4013080045,QN,41-30 69 STREET,01,B2,RAFAEL SIERRA,2,1,1
11236,4014840083,QN,37-11 WARREN STREET,02,C0,"FLORES-FRANCO, ERIKA",2,1,1
11237,4015030024,QN,40-26 FORLEY STREET,01,A5,RICHARD F HARMS,2,1,1
11238,4017020088,QN,32-21 107 STREET,02,C3,JULIO C. PLAZA,2,1,1
11239,4017510021,QN,108-27 36 AVENUE,01,B3,THOMAS AYOUNG,2,1,1
11240,4017690087,QN,37-35 103 STREET,05,K1,"BALAN, JOSE LUIS",2,1,1
11241,4017750043,QN,38-26 108 STREET,04,S2,"KONG, JOHN J.W.",2,1,1
11242,4017810028,QN,37-22 112 STREET,02,C0,"MARINE LUNA, RAFAEL A",2,1,1
11243,4018820051,QN,47-43 98 PLACE,01,B3,"ARICHABALA, CARMEN",2,1,1
11244,4021860004,QN,65-11 110 STREET,01,A5,"LEVIYEV, MIKHAIL",2,1,1
11245,4022210056,QN,108-21 70 AVENUE,04,S1,"SHIMONOV, IMONIEL",2,1,1
11246,4023660013,QN,64-08 55 AVENUE,01,A1,"POWER, DEREK A",2,1,1
11247,4024210025,QN,67-12 51 ROAD,01,B1,"CHAN, KAM C",2,1,1
11248,4024320041,QN,46-12 70 STREET,05,O5,QB DEVELOPMENT OWNER LLC,2,1,1
11249,4024880006,QN,52-51 73 STREET,01,B2,PLUNKETT FERGUS,2,1,1
11250,4025050082,QN,71-11 GRAND AVENUE,04,K4,RADIGAN JOHN,2,1,1
11251,4026520038,QN,59-70 60 STREET,01,B1,"ZYWIEC, TOMASZ",2,1,1
11252,4026540030,QN,59-29 59 STREET,02,C2,MANSOUR ZANDIEH,3,2,1
11253,4026900001,QN,56-47 59 STREET,01,B1,"PIASECKA, EWELINA",2,1,1
11254,4027290027,QN,60-34 59 ROAD,01,B2,JAMES E. O'NEILL,2,1,1
11255,4027310069,QN,59-81 60 PLACE,01,B2,"DOPART, ARTUR",2,1,1
11256,4027530249,QN,64-38 58 ROAD,01,A5,"CAVANAGH, DONNA",2,1,1
11257,4028100036,QN,57-18 73 PLACE,01,A2,JEANETTE BRACCIA,2,1,1
11258,4028550006,QN,87-14 56 AVENUE,01,B2,"SULTANA , NASRIN",2,1,1
11259,4028570074,QN,90-32 QUEENS BOULEVARD,07,G2,MCO LTD,2,1,1
11260,4031770023,QN,90-14 POLO PLACE,01,A5,"ARIAS, SANDRA",2,1,1
11261,4031930042,QN,68-17 OLCOTT STREET,01,A1,DEBRA CASSIDY,2,1,1
11262,4035190005,QN,62-81 60 PLACE,08,M3,CH OUR LADY MIRACUL M,2,1,1
11263,4035610006,QN,891 CYPRESS AVENUE,04,S9,"WINNIE TC, INC.",2,1,1
11264,4036670381,QN,67-38 73 PLACE,02,C0,"MICHELE PERRICONE, AS TRUSTEE",2,1,1
11265,4036840054,QN,69-11 MYRTLE AVENUE,04,K4,RUSSO VINCENZO,2,1,1
11266,4036860070,QN,71-57 70 STREET,01,B2,"TARNAWA, KINGA",2,1,1
11267,4036890044,QN,71-53 72 STREET,01,B3,PHILIP CANOVA,2,1,1
11268,4038180005,QN,77-55 79 PLACE,01,A1,"ORSZULAK, ANDRZEJ",2,1,1
11269,4038290001,QN,78-61 79 PLACE,01,B3,"STUDLEY, EMMA",2,1,1
11270,4039480032,QN,5-13 124 STREET,01,B2,John Heckelman,2,1,1
11271,4040350001,QN,114-01 14 AVENUE,06,F4,"COLLEGE PT. HOLDINGS I, LLC",2,1,1
11272,4040410064,QN,12-27 120 STREET,01,B1,"TOBAR, HERNAN",2,1,1
11273,4045650066,QN,14-52 157 STREET,01,A1,"ROBINSON, RUDOLPH",2,1,1
11274,4046120073,QN,168-27 CRYDERS LANE,01,A2,MOHSEN NECOLA,2,1,1
11275,4046720019,QN,149-27 22 AVENUE,01,B1,"YE, SONG-LIN",2,1,1
11276,4046730057,QN,149-30 22 AVENUE,01,B1,"LIN, HUANCHUN",2,1,1
11277,4048100052,QN,149-51 25 DRIVE,01,A1,STEVEN S SIM,2,1,1
11278,4049570043,QN,34-12 UNION STREET,04,S2,UNION 34 ASSOICATES,2,1,1
11279,4051010033,QN,132-70 SANFORD AVENUE,03,D1,"132-70 SANFORD AVENUE, LLC",2,1,1
11280,4052030018,QN,45-36 SMART STREET,01,B2,"HO, JULIA",2,1,1
11281,4052360023,QN,33-38 153 STREET,01,A1,PAUL L WANKMULLER,2,1,1
11282,4052410068,QN,33-50 157 STREET,01,A1,"JI, DAXIONG",2,1,1
11283,4052590008,QN,33-08 191 STREET,01,A1,BRADLEY JOH,2,1,1
11284,4052770001,QN,40-30 159 STREET,08,M1,"DAR, UL ADL LLC",2,1,1
11285,4052920029,QN,35-25 168 STREET,01,A1,"LIN, ZHAN H",2,1,1
11286,4054340032,QN,45-78 156 STREET,01,A1,SEUNG HYUN YOO,2,1,1
11287,4054580050,QN,46-50 160 STREET,01,A2,RADOVAN CARICIC,2,1,1
11288,4056080024,QN,47-32 192 STREET,01,A5,"ZHENG, DAPENG",2,1,1
11289,4056630047,QN,53-23 192 STREET,01,A3,"REN, TAO TAO",2,1,1
11290,4056900006,QN,58-06 187 STREET,04,S1,"SINGH, GRACIELA",2,1,1
11291,4059730006,QN,201-10 26 AVENUE,01,A1,"KIM, DOMINICK",3,2,1
11292,4060370057,QN,32-17 204 STREET,01,A5,"YAM, ANTHONY W",2,1,1
11293,4060750012,QN,33-14 200 STREET,01,A5,"COSICA, LISA M",2,1,1
11294,4062850024,QN,43-16 212 STREET,02,C0,KEI C. YEUNG,2,1,1
11295,4063100001,QN,216-06 43 AVENUE,01,B3,LEONARD SANTEUFEMIA,3,2,1
11296,4065010016,QN,63-38 136 STREET,01,A5,SHAW NANCY A,2,1,1
11297,4069000023,QN,61-23 172 STREET,01,B1,KI-KON CHAN LIVING TRUST,2,1,1
11298,4072550090,QN,84-50 CHEVY CHASE STREET,01,A1,"CHAZBANI          , DIKLA",2,1,1
11299,4074380007,QN,56-06 210 STREET,01,A1,"XIE, WEI WEN",3,2,1
11300,4074400006,QN,211-16 56 AVENUE,01,A1,MICHAEL PALERMO,2,1,1
11301,4086520061,QN,244-21 89 AVENUE,04,S1,"PAULINO, JEFFERSON",2,1,1
11302,4086680067,QN,253-44 87 DRIVE,01,A5,GREGORY ROSLONOWSKI,2,1,1
11303,4086730012,QN,77-70 271 STREET,01,A0,"CHINTAKUNTA, ASHOK K",2,1,1
11304,4088300043,QN,87-96 256 STREET,01,A1,"SHERIDAN, THOMAS",2,1,1
11305,4090460052,QN,97-21 DREW STREET,01,B2,"HOSSAIN, ENAYET",2,1,1
11306,4090810069,QN,81-21 102 AVENUE,01,B9,"SURIEL, ARGENIS",2,1,1
11307,4091090006,QN,89-08 103 AVENUE,01,B2,"GOMEZ, JASON",2,1,1
11308,4092240018,QN,86-26 111 STREET,01,B2,"MARMOL, ALBERTO",2,1,1
11309,4093010072,QN,87-72 112 STREET,01,A1,"SHARMA, SWAPNA",2,1,1
11310,4093180082,QN,91-14 112 STREET,01,A5,"MOTTA, ROSE",3,2,1
11311,4093350221,QN,127-01 89 AVENUE,01,A5,"CARSELLA , JOSEPH",2,1,1
11312,4093490005,QN,117-18 91 AVENUE,01,B1,"KAUR, RANJIT",2,1,1
11313,4093830042,QN,95-13 103 STREET,10,G0,"EDUN, SHABEER",2,1,1
11314,4094240102,QN,106-06 101 AVENUE,04,S2,"GIORDANO,  CHRISTINE",2,1,1
11315,4094350035,QN,117-09 95 AVENUE,01,B2,"SINGH, AMNINDER",2,1,1
11316,4094490035,QN,94-22 134 STREET,01,A1,"RAHMAN, REZAUR",2,1,1
11317,4094830010,QN,134-20 97 AVENUE,01,B3,MARIA E FANA,2,1,1
11318,4094920012,QN,101-12 126 STREET,01,B3,"KAUR, GURWINDER",3,2,1
11319,4095490052,QN,107-59 111 STREET,01,B3,"SURUJBHAN, VERANJANIE",2,1,1
11320,4095800068,QN,104-53 126 STREET,01,A2,SAMUEL WALLS JR.,2,1,1
11321,4095930026,QN,105-50 134 STREET,01,A5,"MOQUETE, ELIZABETH A",2,1,1
11322,4096310042,QN,135-01 87 AVENUE,02,C0,"MARAJH, AARTI",2,1,1
11323,4096850033,QN,139-31 88 AVENUE,02,C0,"MOHAMMED, NUR",2,1,1
11324,4096970016,QN,150-18 HILLSIDE AVENUE,04,O8,"ARABI, DAVID",2,1,1
11325,4097010041,QN,87-55 143 STREET,01,B1,"RABBY, REZAUL H",2,1,1
11326,4097080077,QN,139-19 87 AVENUE,02,C0,"ALLY, EMANUDEEN",2,1,1
11327,4098280023,QN,89-19 172 STREET,01,B3,JAMEEL RAHAMAN,2,1,1
11328,4098730007,QN,169-05 84 AVENUE,01,B3,"CHEUNG, HENRY",2,1,1
11329,4098950023,QN,90-55 179 STREET,01,A1,SAM JAGASSAR,2,1,1
11330,4099830037,QN,90-27 143 STREET,01,B2,"DOOBAY, ANNIE",2,1,1
11331,4099850011,QN,145-06 JAMAICA AVENUE,04,S2,"145-06 REALTY, INC.",2,1,1
11332,4100840008,QN,145-48 SHORE AVENUE,01,A1,ANNA SPIRES,2,1,1
11333,4101330027,QN,154-12 107 AVENUE,01,B2,"OLALEYE, ELIZABETH",2,1,1
11334,4101490032,QN,108-01 160 STREET,01,B3,BURKE LLOYD,2,1,1
11335,4101630080,QN,104-70 165 STREET,01,A1,"KHULDIPH, ANTHONY",2,1,1
11336,4101660055,QN,107-46 164 STREET,01,B2,"ALEXANDER, MELONDY",2,1,1
11337,4101840056,QN,164-18 109 ROAD,01,A1,AZARIA MARKETING LLC,2,1,1
11338,4102250103,QN,168-25 105 AVENUE,01,B3,DIANE E REED REYES,2,1,1
11339,4102490034,QN,173-01 108 AVENUE,08,M1,ST PAULS METH CHURCH,3,2,1
11340,4102820125,QN,111-16 173 STREET,01,A1,"DAVIS , DJUANA T",2,1,1
11341,4103170017,QN,92-19 178 STREET,01,A1,"BORKOWSKI, JERZY",2,1,1
11342,4108280051,QN,197-01 HIAWATHA AVENUE,01,A5,"MENDEZ, ANDRES T",2,1,1
11343,4108290055,QN,198-26 JAMAICA AVENUE,04,S2,ACRE GROUP LLC,2,1,1
11344,4108670059,QN,100-17 200 STREET,01,A1,"DALLARD, KEMORINE",2,1,1
11345,4108850029,QN,191-10 105 AVENUE,01,A1,"ORJI, STANLEY",2,1,1
11346,4109460180,QN,110-11 205 STREET,01,A1,205 EQUITY LLC,2,1,1
11347,4109670175,QN,111-19 208 STREET,01,A1,SULFANE NAPOLEON,2,1,1
11348,4109850001,QN,112-45 208 STREET,01,B3,"NNOCHIRI , FRANCIS",2,1,1
11349,4111090001,QN,217-65 HOLLIS AVENUE,08,M1,ST JOACHIM&ST ANNE R,3,2,1
11350,4115320014,QN,137-20 96 PLACE,01,B3,"WATTON, KAREN",2,1,1
11351,4116150073,QN,109-45 135 STREET,01,B3,DAVIS-MORRIS LORNA,2,1,1
11352,4116740009,QN,131-18 115 AVENUE,01,A1,"BEBRON, LUIS",2,1,1
11353,4116970051,QN,117-27 133 STREET,08,M1,AS-SIDDIQ MUSLIM ORGANIZATION,3,2,1
11354,4117250046,QN,130-20 LEFFERTS BOULEVARD,01,B3,"ALTAMIRANO, XAVIER",2,1,1
11355,4117390022,QN,133-25 118 STREET,01,A1,"OSTLING, CARL",2,1,1
11356,4117410034,QN,120-06 GAR 133 AVENUE,01,B3,"SINGH, MANPREET",2,1,1
11357,4118030062,QN,135-44 117 STREET,01,A5,"BUDHOO, SURESH",2,1,1
11358,4118180005,QN,117-07 150 AVENUE,01,B3,ANGELO & VINCENZA MESSINA,2,1,1
11359,4118300056,QN,115-15 NORTH CONDUIT AVENUE,01,B3,RATTRAY MILLICENT,2,1,1
11360,4119340055,QN,144-20 109 AVENUE,01,A1,ADAMS JOSEPH J,2,1,1
11361,4119700022,QN,114-34 141 STREET,01,A1,"JUMAN, FEYAAZ M",2,1,1
11362,4119750014,QN,114-20 INWOOD STREET,01,B3,RUTH G TULL,2,1,1
11363,4120220041,QN,147-07 119 AVENUE,01,A1,"PERSAUD, PARSRAM",2,1,1
11364,4120350001,QN,120-39 142 STREET,01,A1,NORMA WILSON,2,1,1
11365,4122040336,QN,150-17 118 AVENUE,01,B3,"GORDON, KIMIKO",2,1,1
11366,4122060012,QN,118-17 152 STREET,01,A9,"SIBDHANNY, FAIZAL",2,1,1
11367,4122080041,QN,118-16 154 STREET,01,A9,"HICKS, WANDA",2,1,1
11368,4123170056,QN,140-46 LATHAM LANE,01,B3,"JUDD, JANICE",2,1,1
11369,4123430250,QN,115-27 168 STREET,01,A1,ARTHUR JOHN RAWLINS,2,1,1
11370,4125370064,QN,130-32 177 STREET,01,A2,"WRIGHT, WANDA",2,1,1
11371,4126130020,QN,117-26 196 STREET,01,A1,"CUFFY, ELIJAH",2,1,1
11372,4126180001,QN,117-03 197 STREET,01,B2,KEHINDE AKOJENU,2,1,1
11373,4126490059,QN,119-13 193 STREET,01,B2,"MERCHANT, MARJORIE",2,1,1
11374,4127580158,QN,118-60 222 STREET,01,B3,"ANDRE, MARYLIN",2,1,1
11375,4128750025,QN,128-31 234 STREET,01,A1,KEITH EVA M,2,1,1
11376,4129290210,QN,132-32 220 STREET,01,B3,SHAWN WELLINGTON,2,1,1
11377,4130410045,QN,183-01 141 AVENUE,01,B1,BROOKS FAMILY HOLDINGS LLC,2,1,1
11378,4130660026,QN,141-40 224 STREET,04,S1,"STAIR, HAROLD",2,1,1
11379,4131060027,QN,134-37 225 STREET,01,A1,THOMAS ALONZO,2,1,1
11380,4131120040,QN,136-14 220 PLACE,01,A2,MEADE BLONDELLE,2,1,1
11381,4131740032,QN,137-05 232 STREET,01,A1,CHALMERS MILLER,2,1,1
11382,4131800039,QN,138-06 232 STREET,01,B3,"CARSON, CLARA",2,1,1
11383,4132090050,QN,245-02 MERRICK BOULEVARD,05,K1,245-02 OWNER LLC,2,1,1
11384,4133120001,QN,177-68 SOUTH CONDUIT AVENUE,07,G4,"BOLLA EM REALTY, LLC",2,1,1
11385,4135010054,QN,144-40 231 STREET,01,B2,SAHAND HOLDINGS LLC,2,1,1
11386,4135010057,QN,144-46 231 STREET,01,B2,ALPINE JAMES,2,1,1
11387,4136760035,QN,149-41 WELLER LANE,01,B2,"PEART, JULIUS",2,1,1
11388,4141680012,QN,158-12 99 STREET,01,A2,"POLIZZI, JOSEPH B",2,1,1
11389,4154600017,QN,8-07 CHURCH ROAD,01,A1,"HENGLEIN, FRANCIS",2,1,1
11390,4155710145,QN,8-28 DORIAN COURT,01,A1,SHAYA HEIMLICH,2,1,1
11391,4155790134,QN,803 CAFFREY AVENUE,01,A1,"ROSENBLUM, MOSHE T",2,1,1
11392,4157380067,QN,29-15 MARTIN COURT,01,B2,"SALAKO, ADEDAYO",2,1,1
11393,4160330017,QN,536 BEACH 67 STREET,02,C0,"CRISPIN, ANGELO",2,1,1
11394,4160760014,QN,71-10 BEACH CHANNEL DRIVE,10,G1,SMILEYS TWO LLC,2,1,1
11395,4161250081,QN,3-25 BEACH 91 STREET,01,A5,"WESTCOTT, CHRIS",2,1,1
11396,4162290030,QN,153 BEACH 119 STREET,02,C0,GREENBERG JOANNE,2,1,1
11397,4162420054,QN,518 BEACH 131 STREET,11,V0,"MANCINI, VITO",2,1,1
11398,4162530035,QN,409 BEACH 130 STREET,01,A1,"FULLERTON, KEVIN",2,1,1
11399,4162540059,QN,432 BEACH 132 STREET,01,A9,"GEORGE, DAMIEN",2,1,1
11400,4162840042,QN,131 BEACH 139 STREET,01,A3,BRIAN ELGART,2,1,1
11401,5000390078,SI,177 BENZIGER AVENUE,01,B2,SEMER PROPERTIES LLC,2,1,1
11402,5000480006,SI,223 YORK AVENUE,01,B2,OUR DWELLING LLC,2,1,1
11403,5001090054,SI,267 VICTORY BOULEVARD,02,C3,"VASQUEZ, RAFAEL A",2,1,1
11404,5001200001,SI,37 FOREST AVENUE,01,A5,"SIEGEL, MICHELE A",2,1,1
11405,5001240066,SI,68 PORTLAND PLACE,01,A1,"WILLIS, CASSANDRA",2,1,1
11406,5001320276,SI,90 ELWOOD PLACE,01,A1,SMITH KEVIN,2,1,1
11407,5001530019,SI,398 DAVIS AVENUE,01,B2,LLAMBI KOSTRISTA,2,1,1
11408,5001800031,SI,402 CARY AVENUE,01,B2,"CHITTICK, EDWIN L",2,1,1
11409,5002190083,SI,177 MYRTLE AVENUE,01,B3,JUAN O TINEO NUNEZ,2,1,1
11410,5002460074,SI,138 BEVERLY AVENUE,01,A1,"KAMBOURIS, CLAUDIA",2,1,1
11411,5002500102,SI,185 HART BOULEVARD,01,B3,"MAFFETTONE, ROBERT",2,1,1
11412,5002530006,SI,412 FOREST AVENUE,05,K5,"WALDMAN, STUART",3,2,1
11413,5002540175,SI,14 PARK COURT,01,A1,"SDAO, JONATHAN D",2,1,1
11414,5002940079,SI,818 DAVIS AVENUE,01,A1,"GIUZIO, ANDRE",2,1,1
11415,5003530058,SI,244 DUBOIS AVENUE,01,A1,"CLARO, AUDREY G",2,1,1
11416,5003550066,SI,125 RAVENHURST AVENUE,01,B2,CICERONE RAYMOND,2,1,1
11417,5003580010,SI,318 KINGSLEY AVENUE,10,G0,"ROCCO FAMILY HOLDINGS, L.L.C.",2,1,1
11418,5003630009,SI,130 KINGSLEY AVENUE,01,A0,ALBERT TERRIBILE,2,1,1
11419,5003660076,SI,23 KEIBER COURT,01,A0,ROBERT ALVERSON,2,1,1
11420,5003680141,SI,52 MARGARETTA COURT,01,A1,COMITO MICHAEL,2,1,1
11421,5003690172,SI,84 GOODWIN AVENUE,01,A0,"AMATO, VINCENT",2,1,1
11422,5004110005,SI,189 LATHROP AVENUE,01,A1,ROBERT BOCIGNONE,2,1,1
11423,5004380043,SI,296 WILLARD AVENUE,01,B2,A MONDELLO,2,1,1
11424,5004580053,SI,108 WATCHOGUE ROAD,01,B3,"CHAN, YUNG YUI",2,1,1
11425,5004980071,SI,222 BAY STREET,04,K4,MILLWASP REALTY LLC,2,1,1
11426,5005070026,SI,253 VAN DUZER STREET,01,B2,"JOMAR, BRAS",2,1,1
11427,5005420002,SI,42 GORDON STREET,01,A1,ISMET TALA,2,1,1
11428,5005630091,SI,208 GORDON STREET,01,A1,208 GORDON  ASSOCIATES LLC,2,1,1
11429,5005930575,SI, HOWARD AVENUE,07,Y9,FIRE DEPARTMENT OF NEW YORK,2,1,1
11430,5006370012,SI,347 VANDERBILT AVENUE,08,M1,N Y CONG OF JEHOVAH W,2,1,1
11431,5006520038,SI,35 SENECA AVENUE,01,A1,"FRID, VEVGENIYA",2,1,1
11432,5006970001,SI,995 MANOR ROAD,07,G3,995 MANOR ROAD LLC,2,1,1
11433,5008240088,SI,43 SUNSET AVENUE,01,B3,KONAX LLC,2,1,1
11434,5008690061,SI,88 DALEMERE ROAD,01,A1,JACOBSON JENNIFER,2,1,1
11435,5008690611,SI,76 CHAPIN AVENUE,01,A3,"YEGOROV, ANTON",2,1,1
11436,5008780133,SI,64 ANNFIELD COURT,01,A3,64 ANNFIELD COURT,2,1,1
11437,5009490032,SI,57 SUMMIT AVENUE,01,A1,RICHARD HOFFMANN,2,1,1
11438,5010470004,SI,417 PORT RICHMOND AVENUE,05,K1,KPV OF NEW YORK LLC,2,1,1
11439,5010480065,SI,29 RAINBOW AVENUE,01,A1,RAMONA SCHATZER,2,1,1
11440,5010640047,SI,152 HAGAMAN PLACE,01,A1,MARCINEK VERONICA,2,1,1
11441,5010700068,SI,2239 RICHMOND TERRACE,01,B3,EDKINS AUTO SALES INC,4,3,1
11442,5010730110,SI,104 PORT RICHMOND AVENUE,05,K1,TOLONA REALTY CORP,2,1,1
11443,5010740089,SI,66 MAPLE AVENUE,01,B2,"TANG, WILSON",2,1,1
11444,5010840116,SI,82 SHARPE AVENUE,01,B2,82 SHARPE AVE VENTURES LLC,2,1,1
11445,5011230082,SI,48 JOHN STREET,01,A1,MICHAEL S MORMILE,2,1,1
11446,5011510008,SI,21 HOUSMAN AVENUE,06,F9,MIROSLAV MACHOVEC,7,6,1
11447,5011960114,SI,244 VAN NAME AVENUE,01,B2,ANTHONY BURROUGHS,2,1,1
11448,5014350010,SI,607 COLLEGE AVENUE,01,B2,"BAIO FAMILY IRREVOCABLE TRUST OF JAN 30,  2018",3,2,1
11449,5015970203,SI,321E HILLMAN AVENUE,01,A5,"LI, YAN  C",2,1,1
11450,5016110019,SI,30 GLOBE AVENUE,01,A5,PAMELA L FORAN,2,1,1
11451,5023960122,SI,11 ROCKNE STREET,01,B2,"DIDIA, ALBERTO",2,1,1
11452,5026320012,SI,12 WATSON AVENUE,01,A1,JEFFREY ANDERSEN,2,1,1
11453,5028200140,SI,200 EDGEWATER STREET,06,E1,REYNOLDS SHIPYARD CORP,2,1,1
11454,5028350038,SI,71 HARBOR VIEW PLACE S,01,A1,"71 HARBOR VIEW, LLC",2,1,1
11455,5028610032,SI,106 ST JOHNS AVENUE,01,A5,"FENG, ZHI MIN",2,1,1
11456,5028630068,SI,57 EVELYN PLACE,01,A1,"ESPINO, MARY JEAN",2,1,1
11457,5029060016,SI,334 ODER AVENUE,01,B9,HALIL ARDOLIC,2,1,1
11458,5029740033,SI,27 AMITY STREET,01,A1,"PARVEZ, SAJID MOHAMMAD",2,1,1
11459,5030230028,SI,30 NARROWS ROAD SOUTH,04,C7,UNAVAILABLE OWNER,4,3,1
11460,5031110124,SI,153 ARTHUR AVENUE,01,A5,BARBARA BUONINCONTRO,2,1,1
11461,5032900010,SI,1336 RICHMOND ROAD,02,C1,"COBOVIC, HATIGJE",2,1,1
11462,5032970009,SI,98 RARITAN AVENUE,01,B2,"LEVINE, JEFFREY",2,1,1
11463,5033760007,SI,367 CROMWELL AVENUE,01,A1,ADRIENNE PAEZ TRUSTEE,2,1,1
11464,5033780086,SI,1690 HYLAN BOULEVARD,05,K7,1690 HYLAN BLVD LLC,2,1,1
11465,5033800012,SI,375 LIBERTY AVENUE,01,A5,"GAMBARDELLA, RICHARD",2,1,1
11466,5034120098,SI,15 PEARSALL STREET,01,B2,"DONADIO, MARIE",2,1,1
11467,5035640005,SI,15 BEDFORD AVENUE,01,B2,THE GIACOMO & ANNA ZACCHEO FAMILY IRREV.  TRUST AGR,2,1,1
11468,5036070040,SI,124 BANCROFT AVENUE,01,B3,MELISSA HERTMAN,2,1,1
11469,5036350087,SI,315 EDISON STREET,01,A1,"GOLABEK, JAKUB",2,1,1
11470,5038010007,SI,557 MIDLAND AVENUE,01,B2,NORBERT SCHIRMER,2,1,1
11471,5038140030,SI,295 COLONY AVENUE,01,A6,SHTEIMAN RENTALS LLC,2,1,1
11472,5040920011,SI,49 NEUTRAL AVENUE,01,A2,"STONICK, SOPHIA",2,1,1
11473,5040930030,SI,58 NEUTRAL AVENUE,01,A1,TIMOTHY R MARSHALL,2,1,1
11474,5042380048,SI,17 RENO AVENUE,01,A1,"BARRY, GINA M",2,1,1
11475,5052820034,SI,70 WILLIAM AVENUE,01,B3,"ALI, SHAHBAZ",2,1,1
11476,5053060065,SI,226 WIMAN AVENUE,01,A5,"226 WIMAN PROPERTIES, INC.",2,1,1
11477,5054420191,SI,190 GIFFORDS LANE,01,A1,"KORENBLYUM, LEONID",2,1,1
11478,5055260035,SI,634 LEVERETT AVENUE,01,A5,"BIAGINI, JOHN",2,1,1
11479,5055900036,SI,60 SYLVIA STREET,01,B2,WILLIAM J. NICHOLS,2,1,1
11480,5060230200,SI,71 GREEN VALLEY ROAD,01,B9,"AHMED, SAMAR H",2,1,1
11481,5060450016,SI,28 EVERTON AVENUE,01,A1,"AGUANNO, VITO",2,1,1
11482,5062490646,SI,39 TENAFLY PLACE,01,B2,"THAN, HTAY",2,1,1
11483,5064520001,SI,44 ZEPHYR AVENUE,01,A3,"DIGLIO, MARYANN",2,1,1
11484,5065830036,SI,996 HUGUENOT AVENUE,01,A2,"PUGLISSI, JOHN",2,1,1
11485,5067230090,SI,23 FLORENCE PLACE,01,A1,"MANGER, DAVID",2,1,1
11486,5069200044,SI,592 RAMONA AVENUE,01,B2,ANTHONY M. NAVARRA,2,1,1
11487,5069330004,SI,600 FOSTER ROAD,01,B2,FOXBEACH CONSTRUCTION CORP,2,1,1
11488,5073140052,SI,529 SHARROTTS ROAD,01,A1,PATRICK DALESSIO JR,2,1,1
11489,5074200050,SI,14 SARCONA COURT,01,B2,"GRISPINO-ALESE , ADELINE",2,1,1
11490,5074200065,SI,80 BLOOMINGDALE ROAD,01,A2,"HANSSON, GLENN",2,1,1
11491,5075960070,SI,122 ANDROVETTE STREET,01,A1,LADONNA REITER,3,2,1
11492,5078650069,SI,517 YETMAN AVENUE,01,A1,SALVATORE VALENZIANO,2,1,1
11493,5078670053,SI,144 SPRAGUE AVENUE,01,B2,"ROMANO, PETER",2,1,1
11494,5078800058,SI,433 MANHATTAN STREET,01,A1,THOMAS IADANZA,2,1,1
11495,5078910012,SI,164 MANHATTAN STREET,01,B2,"DIGIOIA, MICHAEL",2,1,1
11496,5079960055,SI,179 ELLIS STREET,01,A2,JOHN GARNER,2,1,1
11497,5079970058,SI,5309 ARTHUR KILL ROAD,02,C3,"DARAGJATI, MICHAEL",2,1,1
11498,5080410086,SI,234 BREHAUT AVENUE,01,B2,"MEYLER, DERRICK",2,1,1
11499,1002700032,MN,227 MADISON STREET,08,I1,NYC HEALTH AND HOSPITALS CORPORATION,2,1,1
11500,1004260022,MN,13 STANTON STREET,04,C7,COOPER SQUARE MUTUAL HOUSING ASSOC,2,1,1
11501,1005420046,MN,109 MAC DOUGAL STREET,04,S2,109 MACDOUGAL STREET PARTNERS LLC,2,1,1
11502,1006760005,MN,WEST 33 STREET,11,V1,MTA - LIRR,3,2,1
11503,1007917502,MN,126 WEST 16 STREET,04,RM,UNAVAILABLE OWNER,2,1,1
11504,1008310002,MN,838 AVENUE OF THE AMER,05,O5,YUNG BROTHERS REAL ESTATE CO.,2,1,1
11505,1008930033,MN,149 EAST 37 STREET,02,C5,"MOSS RENTALS, LLC",2,1,1
11506,1011520056,MN,242 WEST 61 STREET,03,D3,"242-244 WEST 61ST STREET CO., LLC",2,1,1
11507,1012400036,MN,676 AMSTERDAM AVENUE,04,D7,NEXT TO 92 EQUITIES LLC,2,1,1
11508,1012400052,MN,2495 BROADWAY,04,D6,L&M 93RD STREET LLC,2,1,1
11509,1013250016,MN,229 EAST 51 STREET,08,W2,CONGREGATION BETH ETC,2,1,1
11510,1014970041,MN,1036 PARK AVENUE,03,D4,1036 PARK CORP,2,1,1
11511,1015630045,MN,412 EAST 84 STREET,01,A4,SMLM LLC,2,1,1
11512,1015780001,MN,1540 YORK AVENUE,03,D4,YORK HILL HOUSING INC,2,1,1
11513,1016740010,MN,315 EAST 102 STREET,04,D7,NYC HOUSING AUTHORITY,2,1,1
11514,1017080022,MN,265 PLEASANT AVENUE,04,D7,215 ENTERPRISES LLC,2,1,1
11515,1018660001,MN,1091 AMSTERDAM AVENUE,08,I1,ST LUKE'S/ROOSEVELT HOSPITAL,4,3,1
11516,1020300045,MN,228 WEST 145 STREET,07,G4,BILL WOLF PETROLEUM CORP,2,1,1
11517,1022430385,MN,91 PARK TERRACE WEST,02,C2,"JANSZ, ANDREA",2,1,1
11518,2028790104,BX,175 WEST TREMONT AVENUE,04,S1,175 WEST TREMONT LLC,2,1,1
11519,2029700017,BX,1350 PROSPECT AVENUE,02,C0,1350 PROSPECT OWNERS INC.,2,1,1
11520,2029740182,BX,917 HOME STREET,01,A5,"SAEZ, RUBEN",3,2,1
11521,2030520011,BX,4547 3 AVENUE,05,K1,GLOBAL ASSET PROPERTIES LLC,2,1,1
11522,2030550024,BX,2375 LORILLARD PLACE,01,A9,2375 LORILARD REALTY LLC,2,1,1
11523,2032180062,BX,2295 UNIVERSITY AVENUE,04,S3,IGLESIA BAUTISTA HISPANA,2,1,1
11524,2033320010,BX,3044 HULL AVENUE,08,M1,DEPARTMENT OF EDUC.ARCHDIOCESE OF NEW YO RK,2,1,1
11525,2034570065,BX,229 STEPHENS AVENUE,01,A2,"BUTT, SHAH",2,1,1
11526,2035930001,BX,715 NOBLE AVENUE,03,D1,NYC HOUSING AUTHORITY,5,4,1
11527,2036110043,BX,2124 VIRGIL PLACE,02,C0,"AZAM, GOLAM",2,1,1
11528,2037620006,BX,1769 GLEASON AVENUE,01,B2,"BRENES, EDUARDO",2,1,1
11529,2037690046,BX,1241 BRONX RIVER AVENUE,02,C3,"WORTHY , MAISIE",2,1,1
11530,2037980022,BX,2024 BLACKROCK AVENUE,02,C2,"KHUBBA, KRISHNANAND",2,1,1
11531,2038950065,BX,1467 ROSEDALE AVENUE,02,C3,"SUN, YI WEN",2,1,1
11532,2039160001,BX,1460 ST LAWRENCE AVENUE,02,C0,"HASAJ, GIOVANNI",2,1,1
11533,2039770042,BX,2411 FRISBY AVENUE,02,C1,"WEND REALTY, LLC",2,1,1
11534,2041580005,BX,2875 MIDDLETOWN ROAD,01,B3,JOSE R VAZQUEZ,2,1,1
11535,2041680026,BX,3002 ROBERTS AVENUE,01,B1,"ACEVEDO, DANIEL",2,1,1
11536,2042470023,BX,2052 CONTINENTAL AVENUE,01,A1,"CELLI, JEANETTE MARIA",2,1,1
11537,2043020023,BX,1035 NEILL AVENUE,01,A1,"MCRORIE, JESSICA M",2,1,1
11538,2043640001,BX,1085 ASTOR AVENUE,02,C0,"PHAM, TAM THI",2,1,1
11539,2044610047,BX,2411 BOUCK AVENUE,01,A1,"CHAUDHARY, MOHAMMAD",2,1,1
11540,2045650045,BX,2923 MORGAN AVENUE,01,A0,GEORGE C BLOUNT,2,1,1
11541,2046770048,BX,810 EAST 219 STREET,01,B1,"BENT, WAYNE",2,1,1
11542,2047400034,BX,3212 FISH AVENUE,01,A5,"BERNARD, ROSALIE",2,1,1
11543,2048500022,BX,839 EAST 225 STREET,01,A1,"GAYLE, ANDY",2,1,1
11544,2048560067,BX,830 EAST 232 STREET,01,B2,BARRETT DEVON,3,2,1
11545,2048710054,BX,1030 EAST 225 STREET,02,C0,"NIOLA, CRISTIAN",2,1,1
11546,2049290011,BX,3943 ELY AVENUE,01,B1,"FUNDERBURK, LORENE",2,1,1
11547,2050110028,BX,1777 BUSSING AVENUE,01,B3,HARRIS MIGNONETTE,2,1,1
11548,2050950071,BX,2011 NEREID AVENUE,01,B2,"SEEPERSAD, DAVANAND",2,1,1
11549,2051100016,BX,669 EAST 243 STREET,01,B3,"WHYTE, COLEEN",2,1,1
11550,2051240006,BX,4514 MONTICELLO AVENUE,01,B2,"HIBBERT, PAUL",2,1,1
11551,2053240042,BX,1151 VINCENT AVENUE,01,A2,"COLT, CHRISTOPHER",2,1,1
11552,2053570011,BX,2885 LA SALLE AVENUE,01,A2,"SCHOEPS, DARCIE",2,1,1
11553,2053840064,BX,2811 WELLMAN AVENUE,01,B2,"KAPURIA, SUBODH R",2,1,1
11554,2053950035,BX,2939 ZULETTE AVENUE,02,C0,ZAPPONE ANTHONY JR,2,1,1
11555,2054100062,BX,3200 RANDOLPH PLACE,01,B1,"CASALIGGI, DAWN",2,1,1
11556,2054100163,BX,3190 SPENCER DRIVE,01,A2,"LOPEZ, SUSAN B",2,1,1
11557,2054330014,BX,726 LOGAN AVENUE,01,B3,"COSTANZO, VINCENZO",2,1,1
11558,2054760044,BX,722 VINCENT AVENUE,01,A1,722 VINCENT LLC,2,1,1
11559,2054870059,BX,527 ELLSWORTH AVENUE,01,B3,"DICRISTINA, VICTOR",2,1,1
11560,2055050050,BX,111 PENNYFIELD AVENUE,07,G2,SILVER BEACH GARDENS CORPORATION,5,4,1
11561,2055770014,BX,453 REVERE AVENUE,02,C0,"CABA GARCIA, CRISTINA DEL CARMEN",2,1,1
11562,2056260292,BX,99 EARLEY STREET,01,A1,"JAWSKI, MICHAEL JR",2,1,1
11563,3003360006,BK,215 COLUMBIA STREET,04,S2,215 COLUMBIA LLC,2,1,1
11564,3004470018,BK,490 PRESIDENT STREET,02,C0,"LIANG, CHE",2,1,1
11565,3004530033,BK,458 CARROLL STREET,04,S1,"COHEN, MICHEL",2,1,1
11566,3007190016,BK,424 41 STREET,02,C0,"YI JIA REALTY, INC",2,1,1
11567,3007890001,BK,5001 2 AVENUE,07,G2,5001 2ND AVENUE,3,2,1
11568,3008900077,BK,1913 10 AVENUE,05,K1,MIRANDA CAROLINA,2,1,1
11569,3009150020,BK,748 39 STREET,02,C3,"CHEN, LIANG JIAN",2,1,1
11570,3009157503,BK,729 40 STREET,04,RM,PRECIOUS STONES CONDOMINIUM,2,1,1
11571,3009940019,BK,366 6 STREET,01,B1,OLIVER DAVID,2,1,1
11572,3010960026,BK,532 11 STREET,08,Y1,FIRE DEPARTMENT OF NEW YORK,2,1,1
11573,3010970012,BK,578 11TH STREET,02,C3,578 11TH STREET LLC,2,1,1
11574,3011740048,BK,497 ST JOHNS PLACE,01,B9,"FABER, COLIN",2,1,1
11575,3012460025,BK,128 ROGERS AVENUE,02,C3,LOUISE LOVELL,2,1,1
11576,3012650005,BK,289 KINGSTON AVENUE,04,S4,LIMRINK REALTY CORP.,2,1,1
11577,3012950061,BK,295 MONTGOMERY STREET,02,C1,MONTGOMERY REALTY NY LLC,2,1,1
11578,3012990055,BK,629 MONTGOMERY STREET,01,B1,SARA KATZMAN,2,1,1
11579,3013080021,BK,256 SULLIVAN PLACE,01,B1,"GREISMAN, MENACHEM T",2,1,1
11580,3013180068,BK,101 LEFFERTS AVENUE,01,A4,"BERGEN, LORETTA VAN",2,1,1
11581,3013880043,BK,955 EASTERN PARKWAY,01,A4,TESSLER EFRAIM,2,1,1
11582,3014140035,BK,1668 CARROLL STREET,02,C0,"LANGSAM, YOSEF",2,1,1
11583,3016010013,BK,920 DEKALB AVENUE,02,C0,KAREN M GEORGES,2,1,1
11584,3019030042,BK,208 WASHINGTON AVENUE,01,B3,DEBORAH P WRIGHT,2,1,1
11585,3019490066,BK,125 CLIFTON PLACE,02,C0,125 CLIFTON PLACE LLC,2,1,1
11586,3019900046,BK,181 PUTNAM AVENUE,01,B9,"SNAGG, MILDRED",2,1,1
11587,3020170050,BK,35 BREVOORT PLACE,02,C2,IMPACCT HOUSING DEVELOPMENT FUND CORPORA TION,2,1,1
11588,3020300005,BK,39 CUMBERLAND STREET,10,G1,"CUMBERLAND REALTY HOLDINGS, INC.",2,1,1
11589,3022630059,BK,521 FLUSHING AVENUE,04,S2,MIX-AD CONSTRUCTION CORP,2,1,1
11590,3023400004,BK,1 NORTH 4 PLACE,03,D8,"NORTH 4TH PLACE, LLC",2,1,1
11591,3023670021,BK,302 METROPOLITAN AVENUE,04,S5,MINNOW METROPOLITAN LLC,2,1,1
11592,3024170036,BK,109 SOUTH 3 STREET,02,C3,"C & YSW, LLC",2,1,1
11593,3025590040,BK,187 GREENPOINT AVENUE,01,A9,NUNZIATA JAMES,3,2,1
11594,3026450047,BK,940 LORIMER STREET,02,C1,LORIMER COURT LLC,2,1,1
11595,3027290017,BK,573 MEEKER AVENUE,11,V0,573 MEEKER AVENUE LLC,3,2,1
11596,3027590016,BK,148 CONSELYEA STREET,02,C2,"M&T UNLIMITED, LLC",2,1,1
11597,3027650027,BK,189 DEVOE STREET,02,C0,PRISCO FRANK,2,1,1
11598,3027750014,BK,190 AINSLIE STREET,02,C0,RECCARDI CRAIG J,2,1,1
11599,3028330026,BK,2 MONITOR STREET,01,A9,"CARROLL, JOSEPH",2,1,1
11600,3030880017,BK,97 GRAHAM AVENUE,04,S9,VADIS RLTY CP,2,1,1
11601,3031710051,BK,65 TROUTMAN STREET,01,B2,"MARMOL, EFRAIN",2,1,1
11602,3036110051,BK,920 HOPKINSON AVENUE,02,C0,OTHNIEL C MORRISON,3,2,1
11603,3037490030,BK,515 SUTTER AVENUE,06,E2,"HINSDALE COMMERCIAL PROPERTY, LLC",2,1,1
11604,3038850222,BK,199 HIGHLAND BOULEVARD,01,B3,"COOK, KELLIE G",2,1,1
11605,3038910451,BK,331 HIGHLAND BOULEVARD,01,A3,FREDERICK UNDERWOOD,2,1,1
11606,3040490001,BK,959 BLAKE AVENUE,01,A5,"BLOUNT, SYLVIA",2,1,1
11607,3040880041,BK,569 NEW LOTS AVENUE,07,G2,"UBIERA, ELVIS",2,1,1
11608,3041050114,BK,78 CRESCENT STREET,01,B3,"CRUZ, ALEXIS B",2,1,1
11609,3041700004,BK,395 CRESCENT STREET,02,C0,THAKUR D. SINGH,2,1,1
11610,3041890001,BK,149 MILFORD STREET,02,C2,CYPRESS CORNERS L.P.,2,1,1
11611,3043380001,BK,910 HEGEMAN AVENUE,03,D1,ESSEX TERRACE INC.,15,14,1
11612,3043820021,BK,912 ELTON STREET,01,B2,JOHN MCCLAIN,2,1,1
11613,3045980030,BK,38 EAST 96 STREET,02,C3,"PETERS, ISAAC",2,1,1
11614,3046090032,BK,184 EAST 91 STREET,02,C3,"MAULE-OTTLEY, LORNA M",2,1,1
11615,3046420025,BK,925 LENOX ROAD,02,C3,"SYLVESTER, ANDRE",2,1,1
11616,3046480057,BK,331 EAST 93 STREET,02,C3,"ALLEYNE, SYLVIA",2,1,1
11617,3046720048,BK,393 ROCKAWAY PARKWAY,02,C3,JOAN CASEY,2,1,1
11618,3046720058,BK,367 ROCKAWAY PARKWAY,02,C3,"FITZPATRICK, MICHAEL",2,1,1
11619,3047190021,BK,520 EAST 48 STREET,01,A1,JEAN ULRICK VICTOR,2,1,1
11620,3047250020,BK,376 EAST 54 STREET,01,B1,KEITH COLLINS,2,1,1
11621,3047540042,BK,9418 AVENUE A,01,B1,"BANNISTER, GILLIAN C",2,1,1
11622,3047580005,BK,4712 BEVERLEY ROAD,01,A1,"YARDE, JOHNATHAN D",2,1,1
11623,3047700002,BK,4906 CLARENDON ROAD,01,A9,ENID F JACOB,2,1,1
11624,3047940018,BK,626 EAST NEW YORK AVENUE,01,A5,"STERNBERG, SHLOMO",2,1,1
11625,3048030006,BK,460 MIDWOOD STREET,04,S5,579 BROOKLYN AVENUE CORP,4,3,1
11626,3048370017,BK,310 CLARKSON AVENUE,04,D6,"SANDY CLARKSON, LLC",2,1,1
11627,3048500024,BK,677 LENOX ROAD,01,A5,"JOSEPH, CHRISTINE J",2,1,1
11628,3048710014,BK,124 EAST 35 STREET,01,A5,"BROWN, KENNETH",2,1,1
11629,3048900023,BK,288 EAST 37 STREET,01,B3,MAURICE CLEMENT,2,1,1
11630,3048990057,BK,437 EAST 45 STREET,01,B1,"SUQUINAGUA-MOROCHO, ROSA E",2,1,1
11631,3049490066,BK,351 EAST 32 STREET,02,C3,"LUMBSDEN, IRIS",2,1,1
11632,3049550046,BK,3809 AVENUE D,01,A1,"LEWIS, WAYDE E",2,1,1
11633,3052600038,BK,25 SEELEY STREET,01,B2,"FERNANDEZ, BERNARD",2,1,1
11634,3052650001,BK,307 VANDERBILT STREET,04,S2,PROSPECT PARK LOVE LLC,3,2,1
11635,3053040063,BK,3542 12 AVENUE,01,B1,ARMANDO MUNOZ,2,1,1
11636,3053640034,BK,1566 40 STREET,01,B1,"WEISZ, BARI",2,1,1
11637,3053640065,BK,1535 41 STREET,01,B1,1535 41ST LLC,2,1,1
11638,3054000017,BK,654 EAST 7 STREET,08,N3,WOMEN'S LEAGUE COMMUNITY,2,1,1
11639,3054370028,BK,1650 46 STREET,01,A1,"KLEIN, CHAIM SHEA",2,1,1
11640,3054430027,BK,1642 47 STREET,01,A1,JOSEPH BERKOVITS,2,1,1
11641,3054550043,BK,1775 50 STREET,01,A1,YISROEL CHAIM ILOWITZ,2,1,1
11642,3054670034,BK,1764 51 STREET,01,B1,"SCHLAFF, AVROHOM DOV",2,1,1
11643,3054690066,BK,1921 52 STREET,01,B3,FISCHER MATTHEW,2,1,1
11644,3054740043,BK,5208 19 AVENUE,01,B1,"5208 REALTY, LLC",2,1,1
11645,3054810026,BK,1946 53 STREET,01,A9,MICHAEL KATZ,2,1,1
11646,3054840005,BK,5415 15 AVENUE,01,B1,"FEDERMAN, RUVANE",2,1,1
11647,3054870047,BK,1881 55 STREET,01,B2,"LIPSCHITZ, DAVID",2,1,1
11648,3055000056,BK,2059 58 STREET,01,A1,DEBORAH A. ROTH,2,1,1
11649,3055070054,BK,2065 59 STREET,01,B1,"NEUSTADT, JACOB/HR",2,1,1
11650,3055110066,BK,1731 60 STREET,01,A1,"SABEL, YOEL",2,1,1
11651,3055770051,BK,1853 BAY RIDGE AVENUE,02,C0,"FALANGA, MAURIZIO",3,2,1
11652,3055920020,BK,1126 41 STREET,01,B2,BNH REALTY LLC,2,1,1
11653,3056160025,BK,1250 45 STREET,01,B1,JEK 3-11 TRUST,2,1,1
11654,3056160026,BK,1254 45 STREET,01,B2,"KESSLER, BENZION",2,1,1
11655,3056357503,BK,1333 49 STREET,02,R3,UNAVAILABLE OWNER,2,1,1
11656,3056480053,BK,1259 51 STREET,04,C7,MKS 1259 LLC,2,1,1
11657,3056660020,BK,5300 FT HAMILTON PARKWAY,08,M9,SISTER ADORES OF THE PRECIOUS BLOOD,4,3,1
11658,3056740021,BK,1050 54 STREET,01,B1,FRIEDMAN WOLF,2,1,1
11659,3056740048,BK,1057 55 STREET,01,B1,SBS FAMILY GUARANTY TRUST,2,1,1
11660,3056810030,BK,1068 55 STREET,11,V0,DAVID SZLAFROK,2,1,1
11661,3056950051,BK,1071 58 STREET,02,C0,"GOLD, JACOB",2,1,1
11662,3057127503,BK,1344 59 STREET,02,R3,UNAVAILABLE OWNER,2,1,1
11663,3057697501,BK,1428 67 STREET,02,R3,LAUREN COURT CONDOMINIUM,2,1,1
11664,3059870052,BK,265 81 STREET,01,B1,"NG, SHUN KWAI",3,2,1
11665,3059980027,BK,452 81 STREET,01,B3,"GAMBINO, CALOGERO",2,1,1
11666,3061400001,BK, BOBBY BELLO FIELD,09,Q1,NYC DEPARTMENT OF PARKS AND RECREATION,5,4,1
11667,3061780033,BK,1364 71 STREET,02,C0,"CATALANO, JOSEPH",2,1,1
11668,3062050052,BK,7318 19 AVENUE,01,B2,"ZHAO, JESSIE SHUXIAN",2,1,1
11669,3062810054,BK,1441 81 STREET,01,A1,"BUETI, DOMINICK JR",2,1,1
11670,3062870059,BK,2045 81 STREET,01,A5,JILL JULIANO,2,1,1
11671,3063630016,BK,8661 16 AVENUE,02,C2,XMONDI INC,2,1,1
11672,3064340034,BK,1736 BATH AVENUE,04,S4,18 REALTY NY CORP,2,1,1
11673,3065160083,BK,1039 EAST 3 STREET,01,A9,"SASSOON, IRVING",2,1,1
11674,3065330088,BK,1205 EAST 7 STREET,01,B1,"COHEN, EDWARD  V",2,1,1
11675,3065430063,BK,1355 EAST 7 STREET,01,A1,"CHETRIT, ABRAHAM",2,1,1
11676,3065450063,BK,1259 EAST 9 STREET,01,B2,"WEINBERGER, MORRIS B",2,1,1
11677,3065710040,BK,1384 EAST 9 STREET,01,A5,"MIZRAHI, JOSEPH D",2,1,1
11678,3065860026,BK,1528 EAST 5 STREET,01,A9,"JEMAL, EDWARD J",2,1,1
11679,3065870092,BK,1509 EAST 5 STREET,01,A1,"COHEN, REBECCA",2,1,1
11680,3065890006,BK,716 AVENUE N,01,A7,"HOULLOU, ALBERT",2,1,1
11681,3066130011,BK,630 AVENUE O,01,A1,AZRAK 2016 FAMILY TRUST,2,1,1
11682,3066150066,BK,1571 EAST 8 STREET,01,B1,"SUTTON, SARI",2,1,1
11683,3066160072,BK,1549 EAST 9 STREET,01,B2,THE DOVID AND CHAVA ROTH FAMILY TRUST,2,1,1
11684,3066810348,BK,469 AVENUE S,01,A3,469 AVENUE S LLC,2,1,1
11685,3067240037,BK,1172 EAST 14 STREET,01,B1,"WEISS, JOSHUA/TR",2,1,1
11686,3068680012,BK,69 BAY 40 STREET,01,A5,"CHAMIDES, GRACE",2,1,1
11687,3069710013,BK,3746 MAPLE AVENUE,01,B1,"SHPUNGINA, DINA",2,1,1
11688,3070350070,BK,4923 BEACH 49 STREET,01,B3,VENEZIA LINDA C,2,1,1
11689,3070890016,BK,1922 EAST 8 STREET,08,W9,CONGREGATION KETER S,2,1,1
11690,3070980069,BK,2039 WEST 8 STREET,01,B1,"LIN, HANG",2,1,1
11691,3071620071,BK,2311 WEST 12 STREET,02,C0,"SUN, ZHI CHENG",2,1,1
11692,3071730038,BK,124 STRYKER STREET,01,B2,"CHERA, SAM",2,1,1
11693,3071840121,BK,712 CRAWFORD AVENUE,01,B3,"ABADI, FARYAL",2,1,1
11694,3072940056,BK,1977 EAST 15 STREET,01,B2,COHEN ABRAHAM,2,1,1
11695,3072980078,BK,1933 EAST 19 STREET,01,A9,PROGRAM DVLPT SVCS INC,3,2,1
11696,3073170062,BK,2049 HOMECREST AVENUE,02,C0,MALEH RALPH,2,1,1
11697,3073270072,BK,2053 EAST 22 STREET,01,A1,"SHREM, LYNN",2,1,1
11698,3073370046,BK,2985 AVENUE U,01,A9,"CAO, CONG YONG",2,1,1
11699,3073430038,BK,2174 EAST 12 STREET,01,A1,TAWIL MOUSSA,2,1,1
11700,3073480062,BK,2139 EAST 15 STREET,01,A1,ANN M QUINLIVAN,2,1,1
11701,3073720075,BK,2233 EAST 12 STREET,01,A1,"ZEITOUNE, ELIE",2,1,1
11702,3074160032,BK,2462 EAST 15 STREET,02,C0,"ALSALAHI, HAMOUD",2,1,1
11703,3074690064,BK,2629 EAST 24 STREET,01,A1,FRANK J DANZA,2,1,1
11704,3075670078,BK,952 EAST 22 STREET,01,B2,CHARLES & ESTHER PASKESZ,2,1,1
11705,3075690015,BK,871 EAST 23 STREET,01,A3,ENGEL CHANIE,2,1,1
11706,3075710017,BK,3001 BEDFORD AVENUE,01,B1,"FORSTER, SAM",2,1,1
11707,3075860026,BK,1025 EAST 22 STREET,01,A1,"NEUMAN, JUDAH",2,1,1
11708,3075900035,BK,923 EAST 26 STREET,01,B2,HERMAN RISA,2,1,1
11709,3075900074,BK,970 EAST 27 STREET,01,B1,SZPILZINGER FAMILY IRREVOCABLE GRANTOR T RUST,2,1,1
11710,3075910028,BK,941 EAST 27 STREET,01,B1,"HIRSCH, NACHAMA",2,1,1
11711,3076470023,BK,1253 EAST 29 STREET,01,A1,"SONNENSCHINE, HARRY",2,1,1
11712,3076670011,BK,1383 EAST 31 STREET,01,B2,"ZWEIG, MARC",2,1,1
11713,3076930023,BK,1551 EAST 31 STREET,01,B1,"ACKERMAN, FAIGI",2,1,1
11714,3077650075,BK,1114 EAST 40 STREET,11,V0,EAST 40 LLC,2,1,1
11715,3078910071,BK,2248 SCHENECTADY AVENUE,01,B2,"LITCHMORE, SONIA JOHN",2,1,1
11716,3078920031,BK,2209 SCHENECTADY AVENUE,01,B2,RICHARDS WILMA,2,1,1
11717,3079900023,BK,645 EAST 85 STREET,01,B2,"OGISTE , AUGUSTINE",2,1,1
11718,3082770040,BK,9304 KAUFMAN PLACE,01,A1,"REID, BARBARA",2,1,1
11719,3086760046,BK,624 OCEAN VIEW AVENUE,11,V0,"RINKOVSKY, SHIMON",2,1,1
11720,3087360057,BK,125 DOVER STREET,01,A1,HAIM ZARIF,2,1,1
11721,3087490292,BK,181 FALMOUTH STREET,01,B3,"THE EBERMAN FAMILY TRUST, DATED MAY 31,  2009",2,1,1
11722,3088830973,BK,18 GOTHAM AVENUE,01,A1,"MC DONOUGH, LINDA A",2,1,1
11723,3088910512,BK,29 HAZEL COURT,01,A1,"HJALTE, MICHAEL",2,1,1
11724,3089390080,BK,53 EBONY COURT,01,A1,"BOWSH, HELEN",2,1,1
11725,4001960012,QN,47-21 41 STREET,03,D1,SUNNYSIDE 47-21 LLC,2,1,1
11726,4003420016,QN,36-17 29 STREET,02,C0,"MANOS, PAULINE",2,1,1
11727,4003530018,QN,36-01 10 STREET,04,S2,"VERMA, KAMAL  P",2,1,1
11728,4005320040,QN,14-54 31 ROAD,08,M9,BKLYN & L I CH SOC ME,2,1,1
11729,4005500027,QN,21-22 30 ROAD,01,A1,"IDARRAGA, RODRIGO",2,1,1
11730,4006150066,QN,30-74 32 STREET,02,C1,30-74 32ND ST,2,1,1
11731,4007760150,QN, BERRIAN BOULEVARD,07,U9,NYC DEPARTMENT OF ENVIRONMENTAL PROTECTION,48,47,1
11732,4007860048,QN,43-11 20 ROAD,01,A1,FRANCESCO BRIGUGLIO,2,1,1
11733,4007960013,QN,21-51 41 STREET,01,B2,"HENTZI, GARY",2,1,1
11734,4008330022,QN,22-35 31 STREET,04,S3,"ARONIS, SPIRO",2,1,1
11735,4008750041,QN,23-06 23 AVENUE,01,A5,"NORMOYLE, EUGENE W",2,1,1
11736,4008790030,QN,23-04 21 AVENUE,02,C0,ZEQIRAJ MUSA,2,1,1
11737,4008910048,QN,22-32 21 STREET,01,B1,EVANGELOS DAMALAS,2,1,1
11738,4009650041,QN,49-11 DITMARS BOULEVARD,01,B1,MAFFEI GIUSEPPE,2,1,1
11739,4010740137,QN,99-03 23 AVENUE,01,B2,"LIN, YUN",2,1,1
11740,4011750021,QN,32-34 80 STREET,01,B1,"VILLALBA, LUIS",2,1,1
11741,4011920041,QN,51-30 NORTHERN BOULEVARD,05,G8,NEW YORK CITY SCHOOL CONSTRUCTION AUTHOR ITY,2,1,1
11742,4011950073,QN,34-36 57 STREET,01,A1,KENNETH FRAZIER,2,1,1
11743,4012150079,QN,37-44 61 STREET,02,C1,ANNADALE REALTY LLC,2,1,1
11744,4012840029,QN,37-11 73 STREET,04,C7,AMERICAN MILLENNIUMMANAGEMENT CORP,2,1,1
11745,4013520022,QN,70-51 QUEENS BOULEVARD,05,GU,"70-55 QUEENS BLVD., LLC",2,1,1
11746,4013660053,QN,26-28 93 STREET,01,B2,"DAVILA, ROSA",2,1,1
11747,4014030035,QN,31-39 91 STREET,01,B1,"SINGH , MUKHTIAR",2,1,1
11748,4014280029,QN,32-46 99 STREET,01,B1,JOHN H GARDNER,3,2,1
11749,4016090014,QN,100-02 SPRUCE AVENUE,01,B2,"ABREU, JOSE A",2,1,1
11750,4016380059,QN,23-33 101 STREET,01,A1,"QUIROZ, SILVIA R",2,1,1
11751,4017600031,QN,97-17 38 AVENUE,02,C1,97-17 38TH AVENUE REALTY LLC,2,1,1
11752,4018340014,QN,88-22 CORONA AVENUE,08,M1,KOREAN EVANGELICAL CH/IN,2,1,1
11753,4019300014,QN,102-40 ALSTYNE AVENUE,02,C3,"MONTUFAR, EDISON",2,1,1
11754,4019340064,QN,103-13 51 AVENUE,02,C1,MAX REALTY LLC,2,1,1
11755,4019810055,QN,102-17 47 AVENUE,02,C0,ELVIS ENRIQUE CRUZ,2,1,1
11756,4019890069,QN,104-29 46 AVENUE,01,B1,JOSE RIVERA,2,1,1
11757,4021090001,QN,62-69 99 STREET,04,S2,"AYLYAROV, IMANUIL",2,1,1
11758,4023250059,QN,44-40 65 STREET,02,C0,"LIU, DENNIS YU",2,1,1
11759,4024060030,QN,53-12 68 STREET,01,B2,"VEYVODA, ALICE LORRAINE",3,2,1
11760,4025010053,QN,54-38 69 LANE,10,G0,GIOVANNI LUPO,2,1,1
11761,4025380031,QN,54-72 46 STREET,02,C3,KOOK PROPERTIES LLC,2,1,1
11762,4026550007,QN,59-08 FLUSHING AVENUE,01,B2,RODRIGUEZ JOSE A,3,2,1
11763,4027460014,QN,60-17 61 STREET,01,A5,PEDRO MORALES,2,1,1
11764,4027580046,QN,62-91 60 DRIVE,01,A5,"BARROS, NORMA",2,1,1
11765,4027580071,QN,62-45 60 DRIVE,01,A5,EDWARD J TERRIBERRY,2,1,1
11766,4027590119,QN,64-35 60 AVENUE,01,A5,MEUERHOEFER HENRY M,2,1,1
11767,4027600032,QN,64-46 60 AVENUE,01,A5,"BACKES, JENNIFER",2,1,1
11768,4027620080,QN,64-17 ELIOT AVENUE,01,B2,"CONTORNO, GAYE ANN",2,1,1
11769,4027710034,QN,62-52 64 STREET,01,B2,BASIL SOLETTI,2,1,1
11770,4028550016,QN,89-10 QUEENS BOULEVARD,05,K1,QUEENSLAND ENTRPRIESINC,2,1,1
11771,4029060073,QN,54-61 82 STREET,01,B2,"CHEN, CHENG LI",2,1,1
11772,4029130052,QN,60-35 83 PLACE,01,B3,"WONG, YUK TUNG",2,1,1
11773,4030640019,QN,77-46 66 ROAD,01,B2,"O'KEEFE, KENNETH",2,1,1
11774,4030790057,QN,62-85 BOOTH STREET,01,A1,"HUANG, HELEN",2,1,1
11775,4033330024,QN,84-25 BEVERLY ROAD,01,A3,DANIEL SHALOM RAZ,3,2,1
11776,4034170105,QN,212 SENECA AVENUE,01,A5,"MEDINA, EDWARD  G",2,1,1
11777,4037110019,QN,72-24 MYRTLE AVENUE,08,M1,"ALBANIAN-AMERICAN ISLAMIC CENTER OF QUEE NS, INC",2,1,1
11778,4037980040,QN,69-58 79 STREET,10,G1,79TH STREET PARTNERS,2,1,1
11779,4038830065,QN,90-46 83 AVENUE,01,B1,VUKAN JONEL,2,1,1
11780,4039460012,QN,5-14 124 STREET,01,A2,EN LIANG HUANG,2,1,1
11781,4039710012,QN,7-12 127 STREET,01,B1,"ERIKA DEERY, AS TRUSTEE",2,1,1
11782,4040070047,QN,129-21 14 AVENUE,04,S1,"BARRETTA, BENI",2,1,1
11783,4042010013,QN,22-19 125 STREET,01,B1,"CHEN, WEI YONG",2,1,1
11784,4042930022,QN,26-11 COLLEGE POINT BLVD,06,E1,CIAMPA REALTY II LLC,2,1,1
11785,4044210011,QN,35 141 STREET,01,A9,"CHAN, CHRISTOPHER",2,1,1
11786,4044860057,QN,12-35 148 STREET,02,C0,"DIRICO, TRUSTEE, GISELLA",3,2,1
11787,4045050014,QN,149-12 12 ROAD,01,B2,"MASOTTI, JOAN",3,2,1
11788,4045740001,QN,6-01 161 STREET,01,A1,DECKER STEVEN,2,1,1
11789,4046300150,QN,145-53 20 AVENUE,01,B3,GUS KALAMOTOUSAKIS,2,1,1
11790,4048220023,QN,150-38 28 AVENUE,01,B1,"LIANG, ELLEN WEIWEN",2,1,1
11791,4052220022,QN,140-53 OAK AVENUE,01,B1,STANLEY RIDGE II LLC,2,1,1
11792,4052340040,QN,143-39 ROSE AVENUE,01,B1,"LOU, HENRY",2,1,1
11793,4052350024,QN,152-20 33 AVENUE,01,A5,"LU, WENYING",2,1,1
11794,4052990045,QN,35-28 172 STREET,01,A1,SHEK KAN LEUNG,2,1,1
11795,4053240022,QN,189-15 STATION ROAD,08,I7,PROFESSIONAL SRV CNTR /H,2,1,1
11796,4053360019,QN,41-04 163 STREET,04,K4,411 MANAGEMENT CORP.,2,1,1
11797,4053770003,QN,42-19 147 STREET,01,A1,TENRIKYO MISSION NEW YORK CENTER INC,2,1,1
11798,4053950022,QN,164-16 SANFORD AVENUE,07,G2,W & F REAL ESTATE INC,2,1,1
11799,4054290060,QN,43-22 AUBURNDALE LANE,01,B3,M MACKEY,2,1,1
11800,4054480054,QN,45-42 170 STREET,01,A1,"CIANO, CHRISTIAN",2,1,1
11801,4056930044,QN,58-47 189 STREET,01,A0,"CHEN, FRANKIE",2,1,1
11802,4057540016,QN,20-11 169 STREET,01,A0,MIKA RICHARD A,2,1,1
11803,4060370012,QN,32-16 205 STREET,01,A1,"RAMOS, ISRAEL",2,1,1
11804,4060750016,QN,33-22 200 STREET,01,A5,"PAN, YANG DONG",2,1,1
11805,4061700040,QN,36-35 211 STREET,01,A1,"LAI, LAI YING",2,1,1
11806,4061950029,QN,38-33 222 STREET,01,A1,"POLITIDIS, HELEN",2,1,1
11807,4062520041,QN,38-15 219 STREET,01,A1,"O'CONNOR, DANIEL V",2,1,1
11808,4063150056,QN,42-23 218 STREET,01,A1,"LAMBADARIOS, KONSTANTINOS",2,1,1
11809,4067180152,QN,150-50 COOLIDGE AVENUE,01,A5,"PETALUDIS, NICHOLAS",2,1,1
11810,4067180266,QN,150-57 HOOVER AVENUE,06,E9,"NAVARRETE, JUAN FRANCISCO",2,1,1
11811,4067220006,QN,57-02 156 STREET,01,A1,DONG MING LIU,2,1,1
11812,4068990042,QN,61-18 172 STREET,01,B1,"CHEN, JUN DA",2,1,1
11813,4069130012,QN,65-49 172 STREET,01,A2,"XIA , PEI HE",2,1,1
11814,4069440007,QN,171-16 69 AVENUE,01,A3,ELIOT TREISTER,2,1,1
11815,4070400026,QN,82-01 165 STREET,01,A5,CHIANG MEIING,2,1,1
11816,4070850003,QN,64-25 182 STREET,01,A1,HONG FENG FENG WU,2,1,1
11817,4072290056,QN,179-55 80 ROAD,01,A0,URSULA B BESCH,2,1,1
11818,4072320043,QN,182-37 TUDOR ROAD,01,A1,"AMINOV, NATELLA",2,1,1
11819,4074690022,QN,58-36 219 STREET,01,A0,"ZANG, KUN",3,2,1
11820,4082530110,QN,53-29 BROWVALE LANE,01,A2,CONSTANDINOS HANJIS,2,1,1
11821,4082620131,QN,254-04 PEMBROKE AVENUE,11,V0,WEIJUN ZHANG,2,1,1
11822,4083510016,QN,58-43 255 STREET,01,B2,SEN LIN,2,1,1
11823,4083940064,QN,58-11 260 STREET,01,A2,MING-TAK CHAO,2,1,1
11824,4087900034,QN,260-04 HILLSIDE AVENUE,05,K1,HILLSIDE COARD LLC,3,2,1
11825,4088010014,QN,85-01 258 STREET,08,W1,NYC DEPARTMENT OF EDUCATION,2,1,1
11826,4089170007,QN,80-28 87 ROAD,01,A1,LOPEZ CIRENIA,2,1,1
11827,4089520017,QN,92-14 78 STREET,01,B3,"GONZALEZ, JR., DANIEL L",2,1,1
11828,4089570003,QN,78-16 90 ROAD,01,B3,"ROGOWSKI, ZBIGNIEW",2,1,1
11829,4090020010,QN,94-10 78 STREET,01,B3,"PETERS, EILEEN",2,1,1
11830,4090020029,QN,77-03 95 AVENUE,01,A9,RAMOS FELIX,2,1,1
11831,4090820002,QN,102-15 81 STREET,01,A1,"ALAM, NUR",2,1,1
11832,4091680041,QN,97-19 109 AVENUE,01,B1,"PENA-INOA, FRANCIA J",2,1,1
11833,4091770040,QN,85-18 101 STREET,01,B2,"CAMACHO, RUTH",2,1,1
11834,4092450117,QN,84-110 AUSTIN STREET,01,A5,"MOCK, DAVID K",2,1,1
11835,4093370033,QN,87-54 130 STREET,10,G1,"KAMAL, LLC",2,1,1
11836,4094620008,QN,123-16 95 AVENUE,01,B3,"SINGH, SATINDERPREET",2,1,1
11837,4094750012,QN,95-18 132 STREET,01,A1,"HASHIM, ABDUL",2,1,1
11838,4094890062,QN,101-33 121 STREET,01,A1,HARVINDER SINGH,2,1,1
11839,4095170010,QN,112-20 103 AVENUE,01,B3,"SINGH, MOHINDER",3,2,1
11840,4095260069,QN,107-07 103 STREET,01,B3,MATADIN HIMADRI,3,2,1
11841,4095360080,QN,104-21 113 STREET,01,B2,"BISRAM, RAJKUMARIE",2,1,1
11842,4095750046,QN,121-03 107 AVENUE,01,A1,"AWAD , MOONIA",2,1,1
11843,4095810057,QN,127-07 107 AVENUE,01,A1,LUTCHMIDAT ANN K,2,1,1
11844,4095820015,QN,104-22 129 STREET,01,A1,"ROOPCHAN, RAJDAYE",2,1,1
11845,4096120064,QN,107-33 132 STREET,01,B2,"SMITH, TONY",3,2,1
11846,4098270025,QN,87-67 171 STREET,03,D1,171ST STREET LLC,2,1,1
11847,4098440061,QN,170-13 HILLSIDE AVENUE,05,O7,PCC 170 HILLSIDE LLC,2,1,1
11848,4098540004,QN,84-43 164 STREET,04,S2,NAYANA HEIN,2,1,1
11849,4098760062,QN,170-33 83 AVENUE,01,B1,"BASITH, MOHAMMED ABDUL",2,1,1
11850,4100100033,QN,138-01 101 AVENUE,04,S1,"CARRINGTON, TREVOR",2,1,1
11851,4100400009,QN,104-22 REMINGTON STREET,01,B2,SILVA DELEON,2,1,1
11852,4101200001,QN,106-55 150 STREET,04,S4,NAC PROPERTIES LLC,2,1,1
11853,4101490030,QN,108-03 160 STREET,01,A1,"HOSSAIN, MD JAHANGIR",2,1,1
11854,4101680008,QN,107-42 165 STREET,01,B2,"ALI, CYNTHIA",2,1,1
11855,4101730116,QN,164-11 108 DRIVE,02,C0,AHR REALTY LLC,2,1,1
11856,4101900014,QN,110-26 164 STREET,01,B3,"TORRES, RICHARD",2,1,1
11857,4102020041,QN,163-43 PHROANE AVENUE,01,B3,163-43 PHROANE AVENUE LLC,2,1,1
11858,4102070051,QN,111-42 170 STREET,01,A5,Marion Chaney Nieves,2,1,1
11859,4102840025,QN,174-04 111 AVENUE,01,A1,"FERNANDEZ, JUAN A",2,1,1
11860,4104360010,QN,187-24 HILBURN AVENUE,01,A9,"GEORGE, FAYLEY FRANCIS",2,1,1
11861,4104600073,QN,90-15 195 PLACE,01,A1,GANESS DORIS,2,1,1
11862,4104660029,QN,90-21 197 STREET,01,B3,"ANNAVY, MALAR",3,2,1
11863,4105220001,QN,85-05 193 STREET,01,A2,SIEWCHIN SOMMER,2,1,1
11864,4105830046,QN,88-33 208 STREET,01,A5,PERSAUD LATCHMAN,3,2,1
11865,4106570027,QN,89-06 215 STREET,01,A5,"VALENTIN, BRADFORD",2,1,1
11866,4107330031,QN,220-11 93 AVENUE,01,B2,CARLOS MANUEL P GOMES,2,1,1
11867,4108390027,QN,190-38 99 AVENUE,04,S2,"LAMPLEY, JOYCELYN",2,1,1
11868,4110800151,QN,116-23 207 STREET,01,A1,HUDSON LORENZO,2,1,1
11869,4113010142,QN,115-76 220 STREET,01,A0,LEROY  W MORGAN,2,1,1
11870,4115990054,QN,109-29 118 STREET,01,A1,"YOUGASHWAR, BHARTIE",2,1,1
11871,4116820001,QN,125-02 116 AVENUE,01,B1,"DEFREITAS, ANTHONY",2,1,1
11872,4116870020,QN,116-28 132 STREET,01,A5,"PERSAUD , DEVANAND",2,1,1
11873,4117470024,QN,117-43 125 STREET,01,A1,"LOVENCE, EMMA",2,1,1
11874,4118600001,QN,135-58 127 STREET,01,A2,FERDINAND GARVIN,2,1,1
11875,4119450142,QN,147-17 108 AVENUE,01,B1,"NOBLE, LLYNN",2,1,1
11876,4119540072,QN,111-50 139 STREET,01,A1,L PITTS,2,1,1
11877,4119650107,QN,148-19 112 AVENUE,01,B3,"WALKER,   JEAN   E.",2,1,1
11878,4120150068,QN,117-38 143 STREET,01,A5,BROWN LILLIE,2,1,1
11879,4120200043,QN,117-15 INWOOD STREET,01,A1,"CROSS, DONALD",2,1,1
11880,4120390043,QN,142-72 123 AVENUE,01,A1,"JAIKARAN, SANKAR",2,1,1
11881,4120710016,QN,128-11 INWOOD STREET,01,B3,"SINGH, DERRICK",2,1,1
11882,4120730440,QN,130-14 140 STREET,01,B1,"TORRES, PEDRO M",2,1,1
11883,4121890059,QN,150-25 115 DRIVE,01,B3,"CHARLES, EDNA",2,1,1
11884,4122040256,QN,154-15 118 AVENUE,01,A9,"ABREU, ANTHONY",2,1,1
11885,4122110016,QN,150-20 119 ROAD,01,B2,"KHATUN, TANIA",2,1,1
11886,4123510007,QN,169-07 FOCH BOULEVARD,01,A5,EARLINE E WOOD,2,1,1
11887,4123510114,QN,169-12 116 AVENUE,01,B3,"BRAMHADIN, DURJODHAN",2,1,1
11888,4123560009,QN,117-33 165 STREET,01,A2,GARY  LYNNE,2,1,1
11889,4123680052,QN,168-33 118 ROAD,01,B3,"SMALL, KISHAWN G",2,1,1
11890,4123680057,QN,168-21 118 ROAD,01,A2,SHERYL ROUNTREE,2,1,1
11891,4124480031,QN,117-36 FARMERS BOULEVARD,07,G4,YEHUDA LLC,2,1,1
11892,4124860091,QN,179-09 SELOVER ROAD,01,B3,"MARTIN, MICHAEL",2,1,1
11893,4125800028,QN,138-20 175 STREET,01,A2,"DAVY, ARNOLD",2,1,1
11894,4125920301,QN,140-09 174 STREET,01,B2,"YEARWOOD, FLOYD",2,1,1
11895,4126040065,QN,118-17 189 STREET,01,A1,DARRELL BIGGS,2,1,1
11896,4126200036,QN,117-13 199 STREET,01,B2,MEDFORD DOREEN A,2,1,1
11897,4126750008,QN,193-20 120 AVENUE,01,B1,"LANDI, MANUEL",2,1,1
11898,4127560016,QN,118-22 220 STREET,01,A2,"SINGLETON, KELLI M",2,1,1
11899,4129320053,QN,222-13 133 AVENUE,01,A1,"BUTLER, JON",2,1,1
11900,4129410062,QN,131-60 231 STREET,01,B3,PROBHERBS MERLE M,2,1,1
11901,4129530224,QN,244-33 131 ROAD,01,A1,"SPENCER, SURAYA",2,1,1
11902,4130370011,QN,139-09 SPRINGFIELD BLVD,01,B3,ELEANOR E. GUY TRUST DTD 05/29/19,2,1,1
11903,4133630006,QN,184-45 147 AVENUE,06,E9,WF INDUSTRIAL III LLC,2,1,1
11904,4134350047,QN,147-16 223 STREET,01,B2,PAULINE I HUTSON,2,1,1
11905,4134580024,QN,224-11 147 AVENUE,01,B2,LAURETTA GORDON,2,1,1
11906,4134670072,QN,145-86 220 STREET,01,A2,"ROSS, DENZIL",2,1,1
11907,4134870049,QN,230-18 145 AVENUE,01,A2,MAXEY SARAH,2,1,1
11908,4135410024,QN,146-44 HUXLEY STREET,01,B2,"ROGERS, EILEEN",2,1,1
11909,4135890042,QN,256-20 FRANCIS LEWIS BLVD,01,B3,"VERAMALLAY, VIGHTLIGUM",2,1,1
11910,4136110032,QN,139-14 249 STREET,01,B3,"CAMERON, NERON",2,1,1
11911,4136640001,QN,255-55 147 DRIVE,01,B2,BELLE VINCENT,2,1,1
11912,4136730006,QN,257-06 148 ROAD,01,B2,JOHNSON VALERIE,2,1,1
11913,4137400032,QN,241-19 147 ROAD,01,A2,CESAR CAROL,2,1,1
11914,4142521671,QN,99-64 164 DRIVE,01,A1,SAL LA BARBERA,2,1,1
11915,4153160042,QN,11-17 CROSS BAY BOULEVARD,01,A1,"DAVINO, DEBRA",2,1,1
11916,4154520015,QN,10 EAST 7 ROAD,01,A1,"HARNISHER, JAMES",2,1,1
11917,4157050140,QN,10-74 BEACH 22 STREET,05,H9,"BEACH 22, LLC",2,1,1
11918,4157350046,QN,25-18 CORNAGA AVENUE,01,A0,CAROLYN FRASIER,2,1,1
11919,4158350033,QN,340 BEACH 45 STREET,01,A2,"SINGH, ANROSE",2,1,1
11920,4159650140,QN,478 BEACH 44 STREET,01,B2,"VELIZ, ERWIN",2,1,1
11921,4161510036,QN,3-33 BEACH 95 STREET,06,E1,"MACHO, LLC",2,1,1
11922,4161660460,QN,115-05 BEACH CHANNEL DRIVE,07,G4,RIAN REALTY LTD,2,1,1
11923,4162620014,QN,451 BEACH 139 STREET,01,A1,"HEEGAN , GARY",2,1,1
11924,4162960041,QN,425 BEACH 145 STREET,01,A2,JOHN DONOHUE,2,1,1
11925,4163010021,QN,327 BEACH 144 STREET,01,A1,"CLEMENZA, ANTHONY JR",2,1,1
11926,5000400045,SI,51 HENDRICKS AVENUE,01,B3,POWELL DENICE,2,1,1
11927,5000700032,SI,2 CLINTON AVENUE,04,S2,RONALD WILLIAMS,2,1,1
11928,5001570065,SI,102 BEMENT AVENUE,01,B2,"ESPINAL, MIQUELLA ALTAGRACIA",2,1,1
11929,5002230080,SI,296 TAYLOR STREET,01,B3,HIRAM & BARBARA BROOKS,3,2,1
11930,5002300001,SI,135 RAYMOND PLACE,01,B3,"THOMSON, BRIAN D",2,1,1
11931,5002300101,SI,1009 FOREST AVENUE,01,B3,ECKSTEIN FRANK,2,1,1
11932,5002310001,SI,25 MANOR ROAD,04,O8,CJA MANOR LLC,3,2,1
11933,5002380107,SI,144 DUBOIS AVENUE,01,A1,"SILBERMAN, CHAD",2,1,1
11934,5002780029,SI,70 MATHEWS AVENUE,01,A2,EDWARD HICKS,2,1,1
11935,5002880026,SI,651 OAKLAND AVENUE,01,A3,ROBERT J NEUBERT,2,1,1
11936,5003660080,SI,35 KEIBER COURT,01,A0,ROBERT BRANDT,2,1,1
11937,5003690165,SI,157 WESTCOTT BOULEVARD,01,A0,SCOTT TROOST,2,1,1
11938,5003880066,SI,464 JEWETT AVENUE,01,A1,"BRUSCO , RITA",2,1,1
11939,5003880082,SI,496 JEWETT AVENUE,01,A1,496 JEWETT AVE LLC,2,1,1
11940,5003900043,SI,76 BURNSIDE AVENUE,01,A1,MARIE ARMENIA,2,1,1
11941,5004850023,SI,507 STEWART AVENUE,01,A1,"KIOTALLEVI, LAWRENCE",2,1,1
11942,5005440038,SI,641 VAN DUZER STREET,01,B2,GABRIEL FEQUIERE,2,1,1
11943,5005620051,SI,219 GORDON STREET,01,B2,"BANGURA, FRANK A",2,1,1
11944,5008350022,SI,57 SPRING STREET,01,A1,"CAMPAGNA, LAURA GRACE",2,1,1
11945,5010410016,SI,77 CATHERINE STREET,01,A1,ANGELA PIERCE,2,1,1
11946,5010580002,SI,25 ORANGE AVENUE,01,A1,"ALI, JEREMIAH",2,1,1
11947,5011650012,SI,169 SIMONSON AVENUE,01,A1,PORTER CHARLES Z,2,1,1
11948,5011650076,SI,168 LAKE AVENUE,02,C0,"KUKAJ, JETON",3,2,1
11949,5012490082,SI,356 HARBOR ROAD,01,B2,"MOHAMED, YUSUF",3,2,1
11950,5012787501,SI,,03,RD,HARGROVE KENNETH,97,96,1
11951,5014730026,SI,256 CRYSTAL AVENUE,01,A2,"HAFEY, RORY M",2,1,1
11952,5016850117,SI,2154 FOREST AVENUE,04,S2,YING YE REALTY CORP,2,1,1
11953,5026250158,SI,32 TEMPLE COURT,01,A5,"CHEN, QIAN QIAN",2,1,1
11954,5026250160,SI,36 TEMPLE COURT,01,A5,"CHEN , AI MING",2,1,1
11955,5028230010,SI,977 BAY STREET,05,K2,8TH AVENUE RE LLC,2,1,1
11956,5028290007,SI,1169 BAY STREET,04,K4,"1169 BAY STREET PROPERTIES, LLC",2,1,1
11957,5028390058,SI,241 TALBOT PLACE,01,B3,"PONOMAREV, MIKHAIL",2,1,1
11958,5028490143,SI,223 CLIFTON AVENUE,01,A5,"CHEN, LINA",2,1,1
11959,5028620025,SI,114 BELAIR ROAD,01,A5,"BARANOV, VYACHESLAV",2,1,1
11960,5029830101,SI,30 BELLAVISTA COURT,01,A5,ROCCO PERNA,2,1,1
11961,5030020048,SI,191 HOPE AVENUE,01,A1,SALVATORE GUERRICO JR.,2,1,1
11962,5030710074,SI,10 JUDITH COURT,01,A5,ELAINE H FAN,2,1,1
11963,5031130052,SI,30 JACKSON AVENUE,01,B2,"MOLIC, SEVEDA",2,1,1
11964,5031800017,SI,72 ROME AVENUE,01,A5,"LUO, ZI  ZHAO",2,1,1
11965,5031840016,SI,1125 TARGEE STREET,01,B2,"ALVAREZ, RICHARD",3,2,1
11966,5032770038,SI,444 MC CLEAN AVENUE,01,B2,KANE EDWARD,2,1,1
11967,5033260054,SI,1439 HYLAN BOULEVARD,04,K4,1439 HYLAN BLVD ASSOC.,3,2,1
11968,5034120009,SI,10 MC LAUGHLIN STREET,01,B2,"CZARNIAWSKI, TADEUSZ",2,1,1
11969,5034120096,SI,21 PEARSALL STREET,01,A5,"LIHIN, ANGELA",2,1,1
11970,5036560037,SI,348 NAUGHTON AVENUE,01,A9,MARY C. SACHELI IRREVOCABLE TRUST,2,1,1
11971,5037300046,SI,156 MORELAND STREET,01,A5,"ZHENG, RI ZHAN",2,1,1
11972,5037920020,SI,936 OLYMPIA BOULEVARD,01,A6,"THE NATURE CONSERVANCY, INC.",2,1,1
11973,5038560004,SI,845 QUINCY AVENUE,11,V0,MICHAEL LESIZZA,2,1,1
11974,5038860055,SI,391 FREEBORN STREET,01,A1,IANDOLO JOSEPH,2,1,1
11975,5042220050,SI,96 CODDINGTON AVENUE,01,B3,SABATINO DELMONACO,2,1,1
11976,5043110013,SI,16 EBONY STREET,01,A1,"IACOBELL, JAMES",2,1,1
11977,5045980012,SI,128 ELKHART STREET,01,A1,KEVIN ROURKE,2,1,1
11978,5047280003,SI,106 GRAYSON STREET,08,N2,EDEN II SCHOOL AUTISTIC CHILDREN,2,1,1
11979,5052760010,SI,32 RUSSELL STREET,01,B2,"HU, JIAYI",2,1,1
11980,5052790017,SI,138 DRIGGS STREET,01,B2,QIWEN.CHEN,2,1,1
11981,5053160069,SI,45 GROTON STREET,01,A3,"MARINO, NATALE",2,1,1
11982,5054387501,SI,260 KATAN AVENUE,02,R3,KATAN GARDENS CONDO,16,15,1
11983,5060480051,SI,30 ANACONDA STREET,01,A5,GIOVANNA CATALDO,2,1,1
11984,5062350025,SI,219 SHELDON AVENUE,01,A1,THOMAS P HALLIHAN,2,1,1
11985,5067950012,SI,173 SHARROTT AVENUE,01,A1,"PACIELLO, SCOTT",2,1,1
11986,5068050120,SI,10 TIFFANY COURT,01,A5,MCGINN DAWN G,2,1,1
11987,5075340111,SI,110 STATION AVENUE,01,A1,"UNGER, KEITH R",2,1,1
11988,5077100095,SI,507 RICHARD AVENUE,01,A9,ANDY & TONY LLC,2,1,1
11989,5078120128,SI,226 BEDELL AVENUE,01,A2,HICKEY HELEN,2,1,1
11990,5078500017,SI,14 TRUMAN STREET,01,B2,"MENDEZ, DENISE",2,1,1
11991,5080480021,SI,229 BUTLER AVENUE,01,A1,"SIMONCHYK, MARYIA",2,1,1
11992,5080480056,SI,41 BENTLEY LANE,01,B2,"RUSSO , JOHN",2,1,1
11993,5080500072,SI,536 CRAIG AVENUE,01,A1,JOSEPH R GLORIA,2,1,1
11994,1002550012,MN,230 CHERRY STREET,07,U2,CONS EDISON CO OF NY,7,6,1
11995,1004920042,MN,7 SPRING STREET,04,C7,"PLC SEVEN SPRINGS, LLC",2,1,1
11996,1006510105,MN,20 BLOOMFIELD STREET,07,T2,NYS DEPARTMENT OF TRANSPORTATION,2,1,1
11997,1006890017,MN,501 WEST 17 STREET,04,D6,76 ELEVENTH AVENUE PROPERTY OWNER LLC,3,2,1
11998,1009100046,MN,226 EAST 30 STREET,04,D6,230 EAST 30TH LLC,2,1,1
11999,1010550064,MN,644 10 AVENUE,04,C7,"SPI MAUI, LLC",2,1,1
12000,1010760060,MN,554 WEST 48 STREET,05,K2,B E M ATMTC TRNSMSSN,2,1,1
12001,1011240003,MN,67 WEST 71 STREET,04,C7,71ST REALTY ASSOCIATES LLC,5,4,1
12002,1011460104,MN,163 WEST 74 STREET,04,O8,"BRUSCO, MARIA",2,1,1
12003,1012800001,MN,77 EAST 42 STREET,07,U6,MIDTOWN TRACKAGE VENTURES LLC,2,1,1
12004,2022770078,BX,102 BRUCKNER BOULEVARD,07,G4,102 BRUCKNER BOULEVARD. REALTY,2,1,1
12005,2023680002,BX,481 EAST 163 STREET,07,G5,WASHINGTON/163RD ST.,2,1,1
12006,2024210055,BX,287 EAST 161 STREET,04,S2,287 E161ST LLC,2,1,1
12007,2025260012,BX,1088 SUMMIT AVENUE,04,K4,UNAVAILABLE OWNER,2,1,1
12008,2025620019,BX,692 EAST 134 STREET,01,B2,ROSA SIMOES,2,1,1
12009,2026000131,BX,490 SOUTHERN BOULEVARD,02,C6,MOTT HAVEN VICTORY HOUSING DEVELOPMENT,2,1,1
12010,2027810306,BX, HUNTS POINT AVENUE,07,Y6,NYC DEPARTMENT OF SANITATION,2,1,1
12011,2029550051,BX,779 FAIRMOUNT PLACE,01,B2,SADF HOLDINGS LLC,2,1,1
12012,2029900022,BX,940 EAST 174 STREET,04,C7,9 FORTY CORP.,2,1,1
12013,2030610080,BX,4350 3 AVENUE,07,U2,CON EDISON,13,12,1
12014,2030660036,BX,2458 HOFFMAN STREET,02,C2,2458 HOFFMAN LLC,2,1,1
12015,2030700008,BX,2116 ARTHUR AVENUE,03,D1,CUCS HOUSING DEVELOPMENT FUND CORPORATIO N III,2,1,1
12016,2031030008,BX,2310 BEAUMONT AVENUE,01,B2,"HODZA , ARBEN",2,1,1
12017,2031140005,BX,2308 PROSPECT AVENUE,01,B3,EUFEMIO BAERGA,3,2,1
12018,2031270026,BX,931 EAST 178 STREET,02,C9,TREMONT-VYSE III HDFC,17,16,1
12019,2032540057,BX,3131 SEDGWICK AVENUE,01,B2,"ROSARIO, ALBET",2,1,1
12020,2032770126,BX,390 EAST 195 STREET,02,C0,390 E 195 LLC,2,1,1
12021,2033370056,BX,3307 ROCHAMBEAU AVENUE,01,B1,3307 ROCHAMBEA ASSOCIATES LLC,2,1,1
12022,2033870036,BX,338 EAST 239 STREET,01,A1,"WAGNER, JOHN",2,1,1
12023,2033910035,BX,437 EAST 237 STREET,01,B3,"DWYER, MICHAEL",2,1,1
12024,2034560040,BX,264 SOUNDVIEW AVENUE,04,S1,ABEL GONZALEZ,2,1,1
12025,2034760034,BX,346 NEWMAN AVENUE,10,G0,HERIBERTO MALDONADO,2,1,1
12026,2034780002,BX, LACOMBE AVENUE,09,Q1,NYC DEPARTMENT OF PARKS AND RECREATION,2,1,1
12027,2036330001,BX,857 LAFAYETTE AVENUE,02,C9,NYC HOUSING AUTHORITY,31,30,1
12028,2037560161,BX,1143 LELAND AVENUE,02,C0,"ORTIZ, JULIO",2,1,1
12029,2038140046,BX,1267 CASTLE HILL AVENUE,04,K4,JOVA REALTY L.L.C.,7,6,1
12030,2038620014,BX,1316 WHEELER AVENUE,02,C0,"GARCIA, JUAN P",2,1,1
12031,2039320145,BX,2006 MCGRAW AVENUE,01,B1,"CRUZ, BUENAVENTURA",2,1,1
12032,2039340170,BX,1325 PURDY STREET,02,C1,1325 PURDY STREET LLC,2,1,1
12033,2039370022,BX,1550 WHITE PLAINS ROAD,10,G1,GREENDEV CORP,2,1,1
12034,2039660026,BX,2157 GLEBE AVENUE,02,C0,"TOUSSAINT, EDDY",2,1,1
12035,2040320031,BX,1720 VICTOR STREET,02,C0,JOCARL REALTY VIII LLC,2,1,1
12036,2042940043,BX,2011 MULINER AVENUE,01,A1,ANGELO BOVE,2,1,1
12037,2043330001,BX,1129 EAST 180 STREET,09,Q1,NYC DEPARTMENT OF PARKS AND RECREATION,39,38,1
12038,2044300045,BX,2437 BOSTON ROAD,02,C0,"NIEVES, JUAN",3,2,1
12039,2044510013,BX,2516 HONE AVENUE,01,B3,HECTOR L RIVERA,2,1,1
12040,2044730044,BX,2437 FENTON AVENUE,01,B3,"AYELE, NEBI",2,1,1
12041,2044810113,BX,1534 ALLERTON AVENUE,01,B9,"AVANZATO , ANTHONY",2,1,1
12042,2045130006,BX,2712 BARNES AVENUE,02,C0,B&H BARNES LLC,2,1,1
12043,2046620053,BX,758 EAST 215 STREET,,Z9,"926 LAKE BISCAYNE WAY, LLC",2,1,1
12044,2046640016,BX,763 EAST 216 STREET,01,A1,ARTHUR YELLIN,2,1,1
12045,2046730015,BX,849 EAST 214 STREET,01,B3,MARJORIE & E LIVINGSTON,2,1,1
12046,2046850019,BX,929 EAST 214 STREET,01,B3,"BROWN, FRANCES",2,1,1
12047,2046920034,BX,915 EAST 221 STREET,01,B3,MARGARET WINFIELD,2,1,1
12048,2047500022,BX,3331 GUNTHER AVENUE,01,A5,MYRTIS ROSE ROLLINS,2,1,1
12049,2047680051,BX,3026 KINGSLAND AVENUE,01,A1,"WARREN , MARLA N",2,1,1
12050,2048300022,BX,643 EAST 227 STREET,01,B2,"ADAMES, LUIS B",2,1,1
12051,2048340060,BX,636 EAST 232 STREET,01,B2,"BROWN, SHIRLEY",2,1,1
12052,2048710028,BX,1011 EAST 224 STREET,01,B2,TAMARA HOWARD,3,2,1
12053,2048790065,BX,1050 EAST 233 STREET,01,B2,ANGELA MASON,2,1,1
12054,2048870082,BX,3422 EDSON AVENUE,01,B1,"BARTLEY, PATRICK A",2,1,1
12055,2049450099,BX,2111 GARRETT PLACE,01,A1,"JOHN, MARGO",2,1,1
12056,2050220016,BX,4138 WILDER AVENUE,01,A5,"MAUL, GARNET MORRIS",2,1,1
12057,2050300043,BX,4234 HILL AVENUE,01,B1,JARRETT  JOY,2,1,1
12058,2050370049,BX,4338 CARPENTER AVENUE,02,C0,"LEWIS, GERTRUDE E.",2,1,1
12059,2051190004,BX,885 EAST 242 STREET,01,B1,"LAWRENCE , MARCIA",2,1,1
12060,2053370043,BX,2947 PAINE STREET,02,C0,"CEKAJ, KELMEND",2,1,1
12061,2053730051,BX,2833 CODDINGTON AVENUE,01,A1,"MERCORA, EMILIA",3,2,1
12062,2054110233,BX,1553 DWIGHT PLACE,01,A2,"TOALA, JAVIER",2,1,1
12063,2054280022,BX,840 EDISON AVENUE,01,B2,MAHER GERARD T,2,1,1
12064,2054510051,BX,2967 HARDING AVENUE,01,B1,"LEONARD, MICHAEL   J",2,1,1
12065,2054810056,BX,714 CLARENCE AVENUE,01,A1,"GONZALEZ, DAVID",3,2,1
12066,2055270075,BX,3239 TIERNEY PLACE,01,A2,PARISI JAMES,2,1,1
12067,2056070011,BX,207 HOSMER AVENUE,02,C0,"CRUZDO, THOMAS A.",2,1,1
12068,2056290253,BX,81 CAROLL STREET,11,V0,"RADER, JOHN D",2,1,1
12069,2059290059,BX,4669 PALISADE AVENUE,01,A3,MARJORIE GRUDER,2,1,1
12070,2059570410,BX,6041 RIVERDALE AVENUE,01,A1,RONAN PATRICK,2,1,1
12071,3004330027,BK,584 SACKETT STREET,01,B9,CAMILLE LEONE,2,1,1
12072,3005120035,BK,360 COLUMBIA STREET,02,C0,"RED HOOK ENTERPRISES, INC.",2,1,1
12073,3006490021,BK,206 23 STREET,01,B9,"KREVER, THOMAS",2,1,1
12074,3008790073,BK,263 19 STREET,01,B9,BALTHASAR CAPITAL PARTNERS LLC,2,1,1
12075,3008950027,BK,578 20 STREET,01,B2,"COSTELLO, AS TRUSTEE, CHRISTINA L",2,1,1
12076,3010420065,BK,243 15 STREET,01,A9,DDALS. LLC,2,1,1
12077,3011120076,BK,403 PROSPECT AVENUE,11,V0,"BETANCOURT, VANESSA",2,1,1
12078,3012790022,BK,1468 UNION STREET,01,B9,LEVI Y. GARELIK,2,1,1
12079,3012840024,BK,1298 PRESIDENT STREET,01,A4,GERSHON  LERMAN,2,1,1
12080,3012910042,BK,1322 CARROLL STREET,01,A4,HARPER CATHERINE,3,2,1
12081,3012950002,BK,1665 BEDFORD AVENUE,04,C7,CROWN HEIGHTS REALTY,2,1,1
12082,3013310048,BK,479 EAST NEW YORK AVENUE,01,B9,"LUI, AMY",2,1,1
12083,3013910015,BK, LINCOLN PLACE,11,V0,NORMAN SMELLIE,2,1,1
12084,3014060016,BK,1498 PRESIDENT STREET,01,A9,LEVI PIEKARSKI,2,1,1
12085,3014130073,BK,657 CROWN STREET,01,B1,DEITSCH ABRAHAM,2,1,1
12086,3014180016,BK,658 CROWN STREET,01,B1,"GOLDMAN, ELCHONON",2,1,1
12087,3014240029,BK,974 MONTGOMERY STREET,02,C3,BROWN  BEVERLY,2,1,1
12088,3014800014,BK,1004 GATES AVENUE,03,D3,1004-06 GATES AVENUE LLC,2,1,1
12089,3016470054,BK,857 PUTNAM AVENUE,01,B1,OWEN JOHNSON  2014 IRRE TRST 50%,2,1,1
12090,3017090036,BK,1797 ATLANTIC AVENUE,10,G1,1795 ATLANTIC AVE LLC,2,1,1
12091,3017860062,BK,723 LAFAYETTE AVENUE,01,B2,723 LAFAYETTE LLC,2,1,1
12092,3018130041,BK,800 MARCY AVENUE,08,M1,ST GEORGE'S EPISCOPAL CHURCH,2,1,1
12093,3018270002,BK,1177 BEDFORD AVENUE,04,C7,BEDFORD HEIGHTS OWNER LLC,3,2,1
12094,3018890001,BK,143 WAVERLY AVENUE,08,W9,WAVERLY CORP,2,1,1
12095,3018960006,BK,189A CLASSON AVENUE,01,B3,MIREILLE B. BRISSON,2,1,1
12096,3019940001,BK,547 CLASSON AVENUE,05,HR,PRINCE BM CLASSON LLC,2,1,1
12097,3022140021,BK,440 BROADWAY,06,E1,TAAREH INC.,3,2,1
12098,3022880024,BK,75 NORTH 11 STREET,05,HB,WYTHEHOTEL LLC,2,1,1
12099,3023500026,BK,103 NORTH 3 STREET,03,D5,LENY BERRY HOLDINGS LLC,7,6,1
12100,3024440021,BK,158 SOUTH 4 STREET,02,C3,NYC HOUSING PRESERVATION AND DEVELOPMENT,2,1,1
12101,3024500101,BK,324 KEAP STREET,01,B2,REINIER ACOSTA,2,1,1
12102,3025310027,BK,163 FRANKLIN STREET,02,C1,PROMENADE ASSOCIATES,3,2,1
12103,3025690023,BK,122 NOBLE STREET,02,C0,"GRECZEL, ANDREW",3,2,1
12104,3027280007,BK,16 RUSSELL STREET,02,C3,USZYNSKI DANUTA,3,2,1
12105,3027470011,BK,64 JACKSON STREET,02,C0,"PLASCOFF, LARRY",2,1,1
12106,3027700022,BK,156 DEVOE STREET,02,C0,156 DEVOE STREET LLC,2,1,1
12107,3027730030,BK,517 LORIMER STREET,01,B9,RYAN ROBBINS,2,1,1
12108,3027790008,BK,18 POWERS STREET,01,B9,"ROBINSON, VICTORIA",2,1,1
12109,3029300128,BK,1283 GRAND STREET,06,F5,CHARLES J KING INC,5,4,1
12110,3032430074,BK,51 STOCKHOLM STREET,01,B2,JESUS TORRES,2,1,1
12111,3032490129,BK,126 ST NICHOLAS AVENUE,02,C0,HILDA SHEN,2,1,1
12112,3032530014,BK,14A STOCKHOLM STREET,01,B3,"VIA , JUSTIN",2,1,1
12113,3033900135,BK,1296 JEFFERSON AVENUE,01,B2,"REYES, RUTH E",2,1,1
12114,3034210057,BK,63 SCHAEFER STREET,08,N2,CAOLITION FOR HISPANIC FAMILY SERVICES,2,1,1
12115,3034360029,BK,1306 DECATUR STREET,02,C2,ALBERT CHARLESTON,2,1,1
12116,3034360039,BK,241 COOPER STREET,02,C0,CARLOS PEREZ,2,1,1
12117,3037230009,BK,271 VERMONT STREET,01,B2,"STEPHENS, PATRICK",2,1,1
12118,3038650021,BK,719 VAN SINDEREN AVENUE,07,G9,719 VAN SINDEREN CORP.,2,1,1
12119,3038740056,BK,347 DE WITT AVENUE,01,B2,"MARSHALL, HORACE",2,1,1
12120,3039710004,BK,355 LINWOOD STREET,01,B2,KAMILIA & KATHERINE LLC,2,1,1
12121,3040140029,BK,653 BELMONT AVENUE,01,B1,"GIRARD, FRANCIS",2,1,1
12122,3041110082,BK,74 GRANT AVENUE,01,B2,"ORREGO, ANGEL JAIME",2,1,1
12123,3041120087,BK,90 ELDERT LANE,01,B1,YAN FANG ZHANG,2,1,1
12124,3041270058,BK,3229 FULTON STREET,04,S9,JUPITER 1 LLC,2,1,1
12125,3043150052,BK,799 LINWOOD STREET,01,B2,SANYA FARQUHARSON,2,1,1
12126,3043160073,BK,673 ESSEX STREET,01,B1,"ELLIOTT, CRAIG",2,1,1
12127,3044100029,BK,12049 FLATLANDS AVENUE,,Z9,12049 FLATLANDS AVE. CORP.,2,1,1
12128,3044490001,BK,1065 ELTON STREET,08,W1,NYC DEPARTMENT OF EDUCATION,2,1,1
12129,3045030044,BK,591 MILFORD STREET,01,A1,"DANIEL, ELSIE B",2,1,1
12130,3045190006,BK,1458 LORING AVENUE,01,B3,JEROMAK PROPERTIES INC,2,1,1
12131,3046530023,BK,322 EAST 48 STREET,01,B1,BAPTISTE MAGNA,2,1,1
12132,3047930031,BK,580 EAST NEW YORK AVENUE,08,N1,"HASC CENTER, INC.",2,1,1
12133,3048790051,BK,143 EAST 42 STREET,02,C0,HALLEY CLEMENT,2,1,1
12134,3049540031,BK,540 EAST 38 STREET,01,B3,540 E 38TH STREET LLC,2,1,1
12135,3049570014,BK,1234 ALBANY AVENUE,01,B2,ROBINSON RUPERT R,2,1,1
12136,3052140068,BK,1267 ROGERS AVENUE,02,C0,GRENNETH DIXON,2,1,1
12137,3052660051,BK,407 VANDERBILT STREET,01,B1,ADAM LAZARO,2,1,1
12138,3052870012,BK,303 SHERMAN STREET,01,A1,MCGLOIN ROGER,2,1,1
12139,3053200064,BK,40 CATON PLACE,01,B2,"HOOTA, NATALYA",2,1,1
12140,3053610043,BK,905 AVENUE C,10,G7,642 CONEY ISLAND LLC,2,1,1
12141,3053880067,BK,615 EAST 4 STREET,02,C0,"RAHMAN, MOHAMMAD",2,1,1
12142,3053930045,BK,842 CONEY ISLAND AVENUE,07,G4,"DITMAS LINDEN, LLC",2,1,1
12143,3054010066,BK,693 EAST 7 STREET,01,B2,ALEX LANDY,2,1,1
12144,3054470051,BK,1559 49 STREET,04,S2,ARON AUSCH,2,1,1
12145,3054600034,BK,1764 50 STREET,02,C0,HATZLUCHA PROPERTY MANAGEMENT LLC,2,1,1
12146,3054600049,BK,1749 51 STREET,04,S1,TALMUD TORAH TIFERETH JONAH,2,1,1
12147,3054670071,BK,1719 52 STREET,01,A1,"PACCIONE, TRUSTEE, STEVEN",2,1,1
12148,3054690030,BK,1964 51 STREET,01,A5,DREYFUSS BLIMA,2,1,1
12149,3054730069,BK,1723 53 STREET,01,B1,"PINTER, ISAAC",2,1,1
12150,3054870049,BK,1877 55 STREET,01,B2,YEHUDA ARYEH SEGAL,2,1,1
12151,3055340067,BK,1929 63 STREET,02,C0,"KLEIN, JOEL",2,1,1
12152,3055980068,BK,1219 43 STREET,01,B1,"ROTH, BASHY",2,1,1
12153,3056210034,BK,1158 46 STREET,02,C0,LEAH GOBIOFF,2,1,1
12154,3056740037,BK,5416 11 AVENUE,01,A9,"STEINMETZ, DAVID",2,1,1
12155,3056817502,BK,1056 55 STREET,02,R6,UNAVAILABLE OWNER,2,1,1
12156,3057030046,BK,1163 59 STREET,01,B1,"GROSSBERG, JOEL",2,1,1
12157,3057200015,BK,1422 60 STREET,02,C0,60 REALTY LLC,2,1,1
12158,3057300020,BK,1032 62 STREET,02,C0,"CHEN, CYNNI PEI YU",2,1,1
12159,3058510059,BK,455 SENATOR STREET,01,B3,"SHAMI, MUSSED",2,1,1
12160,3059110081,BK,603 73 STREET,01,B1,"CHEN, JUHUI",2,1,1
12161,3059700032,BK,460 78 STREET,02,C0,"ANTONELLI, JOAN",2,1,1
12162,3060860080,BK,327 92 STREET,01,B2,"WU, JIN HUI",2,1,1
12163,3062040045,BK,7312 18 AVENUE,04,S2,"7312 ASSOCIATES, LLC",2,1,1
12164,3063170044,BK,8210 21 AVENUE,01,B1,"HERSKOWITZ, MOSHE",2,1,1
12165,3063640002,BK,1649 BENSON AVENUE,01,A5,THE SIX OF US LLC,2,1,1
12166,3065300059,BK,1065 EAST 9 STREET,01,A1,"JOSEPH S. SUTTON, TRUSTEE",2,1,1
12167,3065330008,BK,722 AVENUE K,01,A1,VICTOR COHEN,2,1,1
12168,3065420013,BK,1298 EAST 7 STREET,01,B3,"HIDARY, STEVEN J",2,1,1
12169,3065430085,BK,1305 EAST 7 STREET,01,B2,"ANTEBY, ADAM BILLY",2,1,1
12170,3065680085,BK,1407 EAST 5 STREET,01,B1,MESHULEM Z AUERBACH,2,1,1
12171,3065740001,BK,7021 BAY PARKWAY,07,G4,"BOLLA EM REALTY, LLC",2,1,1
12172,3065850036,BK,1552 EAST 4 STREET,01,B3,JACK S COHEN,2,1,1
12173,3065860023,BK,1520 EAST 5 STREET,01,A1,"HABERT, JOSEPH",2,1,1
12174,3065860024,BK,1522 EAST 5 STREET,01,A9,"DWECK, CARA",2,1,1
12175,3066130041,BK,1662 EAST 7 STREET,01,B1,"CHWEKEH, ISAAC",2,1,1
12176,3066150042,BK,1586 EAST 9 STREET,01,B2,ZEVI TRENK,2,1,1
12177,3066150082,BK,1535 EAST 8 STREET,01,B2,"HARARI-RAFUL, EZRA",2,1,1
12178,3066150088,BK,1523 EAST 8 STREET,01,B2,SHAINDLE SCHUSTAL,2,1,1
12179,3066350060,BK,1739 EAST 3 STREET,01,B1,JOSEPH DAYAN AS TRUSTEE OF THE,2,1,1
12180,3066390021,BK,1630 EAST 8 STREET,01,A9,CELIA SALEM,2,1,1
12181,3066420064,BK,1635 EAST 10 STREET,01,B2,ADELMAN MICHAEL,2,1,1
12182,3066430070,BK,1749 STILLWELL AVENUE,02,C2,TAHIRAJ SHEREMET,2,1,1
12183,3066600015,BK,1800 EAST 4 STREET,01,A3,"FRANCO, DAVID J",2,1,1
12184,3066600023,BK,1816 EAST 4 STREET,01,A3,SHALAM  DAVID,2,1,1
12185,3066640067,BK,1772 EAST 8 STREET,01,A3,COHEN LEE,2,1,1
12186,3066820019,BK,1892 EAST 7 STREET,01,A1,"BRUCK , IRVING",2,1,1
12187,3066850068,BK,901 AVENUE S,01,A5,AVENUE S LLC,2,1,1
12188,3067420026,BK,1350 EAST 14 STREET,01,B2,"SACCAVINO, ANTHONY",2,1,1
12189,3067680017,BK,1582 EAST 22 STREET,02,C1,1582 OWNER LLC,2,1,1
12190,3067900032,BK,2717 QUENTIN ROAD,01,A1,"ZOLTAN, EDWARD",2,1,1
12191,3067920069,BK,1613 EAST 29 STREET,01,B2,"POOL, NATALIE",2,1,1
12192,3068080074,BK,3845 BEDFORD AVENUE,01,A3,"ZIKRY, ELI",2,1,1
12193,3068250081,BK,1825 EAST 19 STREET,01,B3,COHEN DAVID M,2,1,1
12194,3069240105,BK,2557 WEST 17 STREET,10,G0,C SHAW,2,1,1
12195,3069610067,BK,2697 WEST 37 STREET,01,A5,"RODRIGUEZ, JOSE",2,1,1
12196,3070820075,BK,1929 WEST 7 STREET,01,B2,CHI WAH LEUNG,2,1,1
12197,3070830018,BK,1928 WEST 5 STREET,01,A9,"BUTERA, DONNA DEMASO",2,1,1
12198,3071040340,BK,338 AVENUE T,01,A5,"SULTAN, DANIEL",2,1,1
12199,3071040389,BK,2048 EAST 1 STREET,01,B3,"JEMAL, MUGUETTE",2,1,1
12200,3071300029,BK,2210 EAST 4 STREET,01,A1,RINA GREGO,2,1,1
12201,3071300056,BK,2217 EAST 3 STREET,01,A9,RICHARD CHERA,2,1,1
12202,3071340034,BK,2180 EAST 8 STREET,02,C3,DIMAGGIO GIOVANNI,2,1,1
12203,3071340066,BK,2187 EAST 7 STREET,01,B1,"HALFON, BECKY",2,1,1
12204,3071560047,BK,443 AVENUE W,01,A5,"KATTAN, ELLIOTT",2,1,1
12205,3071580058,BK,2285 OCEAN PARKWAY,01,A1,EDMOND GUINDI,2,1,1
12206,3071830027,BK,2317 OCEAN PARKWAY,01,B1,"SALAMA, LISI",2,1,1
12207,3073000050,BK,2105 AVENUE T,01,A1,J DOUGAR,2,1,1
12208,3073010044,BK,2223 AVENUE T,01,A1,"ESCAVA, HELENE KAY",2,1,1
12209,3073240053,BK,1901 AVENUE U,04,K4,"AVENUE U, LLC",2,1,1
12210,3073240059,BK,2065 EAST 19 STREET,02,C0,GEORGE DOUSMANIS,2,1,1
12211,3073250027,BK,2132 EAST 21 STREET,01,A1,"KABANI, SOLLY",2,1,1
12212,3073450031,BK,2160 EAST 13 STREET,01,A1,"MALEH, SALIM",2,1,1
12213,3074430006,BK,2548 EAST 28 STREET,01,B2,DJ INFINITI TRUST,2,1,1
12214,3074590102,BK,1600 SHEEPSHEAD BAY ROAD,04,K4,"1560 ASSOCIATES, LLC",4,3,1
12215,3075730002,BK,2719 AVENUE I,01,B3,"REINHOLD, ESTHER",2,1,1
12216,3075900072,BK,964 EAST 27 STREET,01,B1,"MORRIS FELDBRAND, AS TRUSTEE",2,1,1
12217,3075910031,BK,935 EAST 27 STREET,01,A1,FREIFRED BRANCHIE,2,1,1
12218,3076160003,BK,3417 AVENUE K,01,B2,ELI LIFCHETZ,2,1,1
12219,3076270066,BK,1150 EAST 28 STREET,01,B2,"ROGOSNITZKY JR, JACOB",2,1,1
12220,3076390025,BK,1371 EAST 21 STREET,01,A1,WIESNER MICHAELA,2,1,1
12221,3076390031,BK,1355 EAST 21 STREET,02,C0,"RUSS, SAMUEL",2,1,1
12222,3076660059,BK,1336 EAST 31 STREET,01,A1,GLEIBERMAN JOSEPH,2,1,1
12223,3076660068,BK,1368 EAST 31 STREET,01,A1,"ROTHENBERG, YAKOV",2,1,1
12224,3078130047,BK,4025 HUBBARD PLACE,01,A5,"SERGEANT, SECEAL",2,1,1
12225,3078560008,BK,5805 AVENUE M,01,A1,"ALIE, ALFRED",2,1,1
12226,3078960061,BK,1698 EAST 52 STREET,02,C0,"JEAN PIERRE, VITA",2,1,1
12227,3079020080,BK,1512 EAST 58 STREET,01,A9,"PETERS, ADRIAN",2,1,1
12228,3079050022,BK,399 EAST 57 STREET,01,A5,WARREN HAZEL,2,1,1
12229,3082590023,BK,1447 EAST 94 STREET,01,B2,BROOKLYN LAND MGT. & SCV. LLC.,2,1,1
12230,3082980045,BK,9512 AVENUE N,01,A1,"WILLIAMS, JOSEPH",2,1,1
12231,3084080026,BK,1550 EAST 66 STREET,01,A9,"SHEIKEN, MARDIE",2,1,1
12232,3084701165,BK,2134 MILL AVENUE,07,U2,CON EDISON,2,1,1
12233,3084720061,BK,1850 MADISON PLACE,01,A9,ROBERT LAMONTE,2,1,1
12234,3086650527,BK,2945 BRIGHTON 5 STREET,11,V0,2955 BRIGHTON 5 STREET LLC,2,1,1
12235,3087530045,BK,126 KENSINGTON STREET,01,A2,RACHAF SIMONE,2,1,1
12236,3087940006,BK,2948 VOORHIES AVENUE,01,A9,"OO, PHONE NAING",2,1,1
12237,4000320049,QN,49-04 VERNON BOULEVARD,04,S5,"49-04 VERNON BOULEVARD, LLC",2,1,1
12238,4005190030,QN,12-16 31 DRIVE,02,C0,SIMONE P,2,1,1
12239,4005770014,QN,30-61 CRESCENT STREET,02,C3,JAE IK SONG,2,1,1
12240,4005840032,QN,34-08 29 STREET,01,A1,MICHAEL KELLY,2,1,1
12241,4006140006,QN,32-09 BROADWAY,04,K4,"CGS PROPERTIES, LLC",2,1,1
12242,4007010063,QN,25-52 43 STREET,02,C0,P PESALE,2,1,1
12243,4008320076,QN,22-52 35 STREET,01,B1,"KARANTONIS, ANNA",2,1,1
12244,4008420067,QN,29-10 23 AVENUE,04,S2,D'ERASMO  ORIELLA,2,1,1
12245,4011550072,QN,32-17 53 PLACE,01,A5,RAMNARINE SEEPAUL,2,1,1
12246,4013080003,QN,41-43 68 STREET,02,C0,HSEH CHANG WU,2,1,1
12247,4015430012,QN,83-29 CORNISH AVENUE,02,C0,"SHI, GUANGJUN",3,2,1
12248,4015930018,QN,95-09 40 ROAD,02,C2,"LAM, ISAAC M",2,1,1
12249,4016170037,QN,99-01 43 AVENUE,01,A1,"KIPGEN, ALFRED J.",2,1,1
12250,4017190006,QN,104-14 NORTHERN BOULEVARD,05,K2,LEE ESTATE ONE,2,1,1
12251,4018560019,QN,90-34 54 AVENUE,02,C0,DINA CHOQUE,2,1,1
12252,4018820064,QN,47-21 98 PLACE,01,B3,"GIAHN, ISHAK",2,1,1
12253,4019340009,QN,50-35 103 STREET,01,B3,"LU, LIYUN",2,1,1
12254,4019500066,QN,57-52 GRANGER STREET,02,C0,"XU, YONG  G",2,1,1
12255,4020080052,QN,108-55 53 AVENUE,02,C0,"HA, SI HEUNG",2,1,1
12256,4023820044,QN,65-46 52 AVENUE,02,C0,"BAGLIONE, FRANK",3,2,1
12257,4023990046,QN,66-47 JAY AVENUE,01,A5,"COMIA, MIKHAIL BRENT V",2,1,1
12258,4024310033,QN,67-02 QUEENS BOULEVARD,05,G8,ANJAY MANAGEMENT CORP,2,1,1
12259,4025000041,QN,55-20 69 PLACE,01,B2,"ASAD, MD MAHBOOB",2,1,1
12260,4026300014,QN,59-08 56 STREET,06,F1,"AM ATLANTIC ASSOCIATES, LLC",2,1,1
12261,4027960002,QN,69-56 GRAND AVENUE,04,S2,69-56 GRAND AVENUE LLC,2,1,1
12262,4028910023,QN,84-52 GRAND AVENUE,04,S2,SAGOR REALTY LLC,2,1,1
12263,4029420042,QN,61-31 82 PLACE,01,A1,MARY SHANNON,2,1,1
12264,4030250020,QN,63-08 69 PLACE,05,K1,"SCIMECA, AS TRUSTEE, ANTHONY",2,1,1
12265,4030290154,QN,64-15 71 STREET,01,B3,"CAMUS, STEVEN",2,1,1
12266,4030577502,QN,72-35 METROPOLITAN AVENUE,02,R3,UNAVAILABLE OWNER,2,1,1
12267,4030640028,QN,77-23 66 DRIVE,01,B2,VINCENT C LAROCCHIA,2,1,1
12268,4032790040,QN,101-31 75 ROAD,01,A5,"WESTHALL, KEVIN M",2,1,1
12269,4034040046,QN,486 WOODWARD AVENUE,01,B3,"MONEGRO, TANIA",2,1,1
12270,4034300052,QN,1815 HARMAN STREET,02,C3,1815 HARMAN ST LLC,2,1,1
12271,4035510075,QN,1665 GEORGE STREET,01,B2,"MATA, SYLVIA",2,1,1
12272,4035680027,QN,1720A DECATUR STREET,10,G1,GOCOOL PARASRAM,2,1,1
12273,4035690057,QN,58-37 78 AVENUE,10,G0,"HORATIO MANAGEMENT, LLC",2,1,1
12274,4036600047,QN,70-22 70 STREET,01,B2,PAWEL HOGENDORF,2,1,1
12275,4036670356,QN,72-60 METROPOLITAN AVENUE,05,K2,7260 METRO CORP.,2,1,1
12276,4036940035,QN,72-23 72 STREET,01,A5,"MATZEL, JOAN M",2,1,1
12277,4037020053,QN,67-39 COOPER AVENUE,01,A9,JOSEPH DEFELICE,2,1,1
12278,4037720012,QN,73-16 67 DRIVE,10,G0,GREGORIO LORINO,2,1,1
12279,4037900011,QN,69-54 74 STREET,01,B1,LUKASZ GOGOLEWSKI,2,1,1
12280,4038100332,QN,81-31 77 AVENUE,01,A5,"CZERECH, GREGORY",2,1,1
12281,4038230022,QN,78-19 73 PLACE,01,A1,"SAMAYOA, BYRON",2,1,1
12282,4038540068,QN,88-18 RUTLEDGE AVENUE,01,A5,CHOJECKA URSZULA,2,1,1
12283,4040040028,QN,13-07 127 STREET,01,B1,"YEUNG, WAI",2,1,1
12284,4041340018,QN,18-07 128 STREET,01,B2,"BAZANT, RICHARD B",2,1,1
12285,4041660028,QN,20-02 123 STREET,02,C3,"ZHENG, YI ZHEN",2,1,1
12286,4043200001,QN,123-05 30 AVENUE,10,G1,12305 30 AVE. LLC,2,1,1
12287,4043770027,QN,121-16 31 AVENUE,06,F9,COLLEGE POINT ASSOCIATES LLC,4,3,1
12288,4044080019,QN,31-19 FARRINGTON STREET,06,F5,MOTIF REALTY LLC,2,1,1
12289,4044200028,QN,7-32 POINT CRESCENT,01,A3,"MIHALIOS, NICK",2,1,1
12290,4045390086,QN,152-39 11 AVENUE,01,A5,"MCCLOSKEY, JAMES T.",2,1,1
12291,4045960048,QN,14-52 163 STREET,01,A1,MUSTO JOSEPH,2,1,1
12292,4046640023,QN,149-47 16 ROAD,01,A5,"LI, KWONG TAT",2,1,1
12293,4049070009,QN,165-20 27 AVENUE,01,A2,"MOY, ARTHUR T",2,1,1
12294,4049080017,QN,29-22 164 STREET,01,B1,"CHAN, OI CHING",2,1,1
12295,4050397501,QN,132-59 41 ROAD,04,RM,PALACE DEVELOPMENT CORP,2,1,1
12296,4051930039,QN,43-24 ROBINSON STREET,03,D1,ROBINSON TWELVE LLC,2,1,1
12297,4052330011,QN,143-24 POPLAR AVENUE,01,B2,"HUANG, CHEN TUN",2,1,1
12298,4052600033,QN,34-52 192 STREET,02,C0,JPM MANAGEMENT INC.,3,2,1
12299,4054580031,QN,159-20 46 AVENUE,01,A9,"YU, DEN-YEE",2,1,1
12300,4055550033,QN,197-05 47 AVENUE,01,B9,"LAU, FANNIE NG",2,1,1
12301,4057520026,QN,166-44 20 ROAD,01,A1,"ZHENG, WEN XIANG",2,1,1
12302,4060310047,QN,32-37 201 STREET,01,A5,"ZHENG, FENGQIN",2,1,1
12303,4061450021,QN,36-32 201 STREET,01,A1,"VARVARIGOS, CHANENA",2,1,1
12304,4061980039,QN,200-63 39 AVENUE,01,A2,"FEELY, MARTIN J.",2,1,1
12305,4065010105,QN,138-16 64 AVENUE,01,A5,"FERRARA, KATHERINE L",2,1,1
12306,4066340034,QN,141-50 UNION TURNPIKE,07,G4,RNA TURNPIKE REALTY LLC,2,1,1
12307,4067220012,QN,57-14 156 STREET,01,B3,"LIU, CHEN WAH",2,1,1
12308,4067570017,QN,61-27 161 STREET,01,B1,"LI , XIAO FEI",2,1,1
12309,4068240018,QN,158-28 75 ROAD,01,A1,HELARD MENDOZA,3,2,1
12310,4068870024,QN,59-25 FRESH MEADOW LANE,07,G2,S&J REAL ESTATE,2,1,1
12311,4070720025,QN,61-40 184 STREET,01,B3,"PAPPAS AS TRUSTEE, MILDRED",2,1,1
12312,4073650056,QN,48-25 206 STREET,01,B3,Carol Mann,2,1,1
12313,4074240005,QN,53-14 BELL BOULEVARD,01,A0,C SEELIG,2,1,1
12314,4074660061,QN,58-11 215 STREET,01,A0,KOON PING CHAN,2,1,1
12315,4078230006,QN,212-35 86 ROAD,01,A1,"RAHMAN, MUHAMMAD K",2,1,1
12316,4080410052,QN,111 ARLEIGH ROAD,01,A3,"DIMEO, SALVATORE",2,1,1
12317,4081400116,QN,41-73 GLENWOOD STREET,01,A1,"FREUDENBERG-HUA, YUN",2,1,1
12318,4083050085,QN,246-13 63 AVENUE,01,B1,"ZHANG, XUEMEI",2,1,1
12319,4085900006,QN,83-55 247 STREET,04,S1,KUNNEL CYRIAC V,2,1,1
12320,4088900022,QN,83-16 94 STREET,01,A9,HIRSCH  KRZYSZTOF,2,1,1
12321,4089910185,QN,93-18 93 AVENUE,01,B2,MARIN GABRIEL,2,1,1
12322,4090880038,QN,86-03 102 ROAD,01,B2,EURIKA RAMDAS,2,1,1
12323,4091840020,QN,102-34 85 ROAD,01,A1,"GONZALEZ, GINER CIRO REYES",2,1,1
12324,4092340027,QN,84-44 LEFFERTS BOULEVARD,02,C3,NORTH CONDUIT AVENUE CORP.,2,1,1
12325,4092410538,QN,273 BREVOORT STREET,01,A1,"ISKHAKOVA, TRUSTEE, YELENA",2,1,1
12326,4092880138,QN,102-11 89 AVENUE,01,B2,"ALVAREZ, EVANGELINA",2,1,1
12327,4093750037,QN,89-37 121 STREET,01,B3,NAUTH ANGELA,2,1,1
12328,4093750058,QN, ATLANTIC AVENUE,07,U7,LIRR,36,35,1
12329,4093820016,QN,95-18 103 STREET,01,A1,JAGDEO RAJ,2,1,1
12330,4094670024,QN,126-09 97 AVENUE,01,B2,PINTO AGOSTINHO DA S,2,1,1
12331,4094980005,QN,130-18 101 AVENUE,04,K4,"HOSEIN & BEHARRY, INC.",2,1,1
12332,4095080067,QN,103-39 104 STREET,01,A1,"PINDIPROLU, VENKATA S",2,1,1
12333,4095940021,QN,105-44 135 STREET,01,B3,ALBERT E WOOLCOCK,3,2,1
12334,4096010078,QN,107-23 121 STREET,01,A5,KRISHAN VERMA,2,1,1
12335,4097120144,QN,141-20 84 DRIVE,01,B3,SALINAS  RAFAEL,2,1,1
12336,4097160116,QN,84-19 LANDER STREET,02,C1,LANDERS STREET LLC,2,1,1
12337,4098950070,QN,90-38 179 PLACE,01,A5,"SINGH, MARILYN",2,1,1
12338,4099070060,QN,90-47 185 STREET,01,B2,RAJPAUL JAILALL,2,1,1
12339,4099310022,QN,88-17 184 STREET,01,B2,"NADIRA UDIT, AS TRUSTEE",2,1,1
12340,4100520026,QN,146-01 105 AVENUE,01,B1,HENRIQUE GONCALVES,2,1,1
12341,4100720003,QN,143-06 107 AVENUE,01,A1,WILLIAMS ELISHA,2,1,1
12342,4101230003,QN,155-08 TUSKEGEE AIRMEN WAY,08,M1,THE REDEEMED CHRISTIAN CHURCH OF GO,2,1,1
12343,4101280006,QN,160-10 TUSKEGEE AIRMEN WAY,08,M1,UNAVAILABLE OWNER,2,1,1
12344,4102000104,QN,169-20 110 ROAD,01,A1,"PILGRIM, KERWIN",2,1,1
12345,4102150017,QN,92-26 176 STREET,01,B3,"ESARDAI, RAMESH",2,1,1
12346,4103120066,QN,11484 178 PLACE,01,A1,"WONG, JENNESA",2,1,1
12347,4103730007,QN,104-17 187 STREET,01,A1,"STEWART PARKINSON, NICOLETTE R",2,1,1
12348,4103810045,QN,188-20 DUNKIRK DRIVE,01,A1,LYNCIA GOMEZ-HAYLING,2,1,1
12349,4104380018,QN,111-02A FARMERS BOULEVARD,04,S1,EIA  & HD REALTY LLC,2,1,1
12350,4104660061,QN,90-48 198 STREET,02,C0,"RAHMAN, AYESHA",2,1,1
12351,4105040028,QN,86-32 PALO ALTO STREET,01,B3,BASSIRI-TEHRANI FARHAD,2,1,1
12352,4105580051,QN,90-22 209 STREET,01,A1,"GONZALES, MIRIAM M",2,1,1
12353,4105590029,QN,90-15 209 STREET,01,A1,ALVIN A PENN,2,1,1
12354,4106310029,QN,92-60 215 PLACE,01,A5,"SPLEEN, MARSHA",2,1,1
12355,4106640093,QN,89-74 SPRINGFIELD BLVD,01,A1,"CHENG, MEI HUNG WENDY",2,1,1
12356,4108130005,QN,222-22 JAMAICA AVENUE,08,W1,NYC DEPARTMENT OF EDUCATION,2,1,1
12357,4109130018,QN,109-28 207 STREET,01,B3,JOAN BATTS,2,1,1
12358,4109840003,QN,112-41 207 STREET,01,B3,"LEWIS , GAVIN",2,1,1
12359,4110150069,QN,114-13 198 STREET,01,A5,"MORGAN, ADRIAN",2,1,1
12360,4110280236,QN,114-44 210 STREET,01,B3,"ALLEN, SHERON R",2,1,1
12361,4110990060,QN,106-08 215 STREET,01,A1,"VELEZ, ADRIAN",2,1,1
12362,4111290028,QN,110-26 216 STREET,01,A1,NYC HOUSING AUTHORITY,2,1,1
12363,4112210064,QN,223-19 112 ROAD,01,B3,FERNANDE HYPPOLITE,2,1,1
12364,4112350048,QN,219-34 MURDOCK AVENUE,01,A5,"NTEKUDZI, EBO ANTOBAM",2,1,1
12365,4114060016,QN,90-38 PITKIN AVENUE,01,A5,"EYSSALLENNE, AMBIORIS",2,1,1
12366,4116330033,QN,111-54 130 STREET,01,A1,"PERSAUD, SUNDER",2,1,1
12367,4116910056,QN,116-19 135 STREET,01,A1,LUTHER BRYANT JR,2,1,1
12368,4117480082,QN,117-66 127 STREET,01,A1,"KUMAR GOVINDU , PRAVEEN",2,1,1
12369,4119350005,QN,143-10 FERNDALE AVENUE,01,A1,JHAGROO TARAMATTIE R,3,2,1
12370,4119510010,QN,147-33 110 ROAD,01,B3,"WAITHE, ALMA",3,2,1
12371,4119630036,QN,11156 LIVERPOOL STREET,01,A1,"JACOBS, LILLIE",2,1,1
12372,4119650187,QN,148-12 111 AVENUE,01,B3,"JOSOPERSAUD, SABRINA",2,1,1
12373,4119750053,QN,114-33 145 STREET,01,A5,"ZENG, PEIYU",2,1,1
12374,4120400126,QN,142-55 122 AVENUE,01,B2,"BLACKMAN, AMELIA",2,1,1
12375,4120680120,QN,144-05 129 AVENUE,01,B2,"WALTHRUS, CHARMAIN PAGE",2,1,1
12376,4120930034,QN,135-30 140 STREET,05,H2,"JFK HOTEL OWNER, LLC",2,1,1
12377,4121140016,QN,133-35A 147 STREET,01,A1,"DEAN, RICKY",2,1,1
12378,4121620001,QN,158-07 111 AVENUE,01,A1,"EVANS, ROCHELLE",2,1,1
12379,4121840050,QN,150-43 114 ROAD,01,A1,NOZAKS PROPERTIES LLC,2,1,1
12380,4121870005,QN,114-45 155 STREET,01,B3,MRS M WASHINGTON,2,1,1
12381,4122190018,QN,123-22 153 STREET,01,B3,"LEWIN, JASON",2,1,1
12382,4123170052,QN,140-36A LATHAM LANE,01,A1,"JNBAPTISTE, MARSHA",2,1,1
12383,4123690006,QN,168-12 118 ROAD,01,A2,"CLARKE, DEBORAH",2,1,1
12384,4125790175,QN,137-40 174 STREET,01,A2,KOLAWOLE ONIFADE,2,1,1
12385,4126740079,QN,121-50 193 STREET,01,A1,"HOLM, ARLENE",2,1,1
12386,4127150027,QN,123-12 BENTON STREET,01,B2,"URGILES ARCE, ALFONSO T",2,1,1
12387,4128220002,QN,237-11 121 AVENUE,01,A1,"NATIONSTAR HECM ACQUISTION TRUST 2018-3,",2,1,1
12388,4130340010,QN,217-31 138 ROAD,01,B3,"MCCULLEY, ALLEN K",2,1,1
12389,4131000026,QN,221-18 MERRICK BOULEVARD,06,E1,"221-06 MERRICK BLVD. ASSOCIATES, LLC",3,2,1
12390,4131610057,QN,134-46 234 STREET,01,B3,"HODGE, NORRIS",3,2,1
12391,4131960111,QN,232-02 MENTONE AVENUE,01,B3,"TONY DWAYNE ALLEN, TRUSTEE",3,2,1
12392,4134560026,QN,146-21 222 STREET,01,A2,"OLAYOKUN, OLAGOKE",2,1,1
12393,4134730004,QN,145-95 225 STREET,01,A5,"GADSBY, MERIDITH MIRANDA",2,1,1
12394,4134820022,QN,225-20 145 AVENUE,01,A2,STEPHENS MARCIA Y,2,1,1
12395,4135150023,QN,142-28 231 STREET,01,A5,HUGH B JONES,2,1,1
12396,4135410020,QN,146-50 HUXLEY STREET,01,B3,"DIAZ, DENISE",2,1,1
12397,4135600044,QN,240-32 MEMPHIS AVENUE,01,A1,"SINGH, MONICA",2,1,1
12398,4154570010,QN,611 WEST ROAD,01,A2,"LARKIN, KERRY A",2,1,1
12399,4155260022,QN,21-25 NAMEOKE AVENUE,08,M1,FAR RCKWAY CHURCH/CHRIST,2,1,1
12400,4155270001,QN,13-46 BEACH CHANNEL DRIVE,07,G3,RODELEVEN SARVICE STATIONS INC,2,1,1
12401,4155540064,QN,10-31 BEACH 9 STREET,01,B1,SHAINDEL BLUMENKRANTZ FAMILY TRUST,2,1,1
12402,4156290065,QN,15-01 NEW HAVEN AVENUE,01,B2,CLAIRE KONIGSBERG,2,1,1
12403,4158380061,QN,311 BEACH 46 STREET,02,C0,"HOLBROOK , CHRISTOPHER",2,1,1
12404,4161530021,QN,310 BEACH 98 STREET,02,C0,"O'TOOLE, MICHAEL III",3,2,1
12405,4161550082,QN,225 BEACH 99 STREET,01,B2,GILL HAROLD,2,1,1
12406,4161670099,QN,100-00 BEACH CHANNEL DRIVE,08,W1,NYC DEPARTMENT OF EDUCATION,2,1,1
12407,4162170016,QN,237 BEACH 121 STREET,01,B2,"MC CAFFREY, BRIAN",3,2,1
12408,4162250063,QN,246 BEACH 130 STREET,01,B2,"CASPI, CYNTHIA E",2,1,1
12409,4162310055,QN,134 BEACH 122 STREET,02,C2,"SIELAW, MARIA CHIARAPPA",2,1,1
12410,4163210016,QN,177 BEACH 147 STREET,01,A1,"TOMASSETTI, DINO",2,1,1
12411,5000490082,SI,182 BEECHWOOD AVENUE,01,B2,SAUSE CHARLES S,2,1,1
12412,5001090039,SI,534 JERSEY STREET,01,B2,SHIRLEY EDWARDS,2,1,1
12413,5001150040,SI,46 OXFORD PLACE,01,B2,"KELLY, JOAN A",2,1,1
12414,5001250077,SI,328 STANLEY AVENUE,01,A2,"LEWIS, LINDA",2,1,1
12415,5001430045,SI,15 DEKAY STREET,01,A2,CHRISTOPHER G GULBIN,2,1,1
12416,5001490266,SI,199 PELTON AVENUE,01,B2,"LARGO, ANGELA",2,1,1
12417,5001570113,SI,106 BEMENT AVENUE,01,B2,"SEMINARIO, WILSON",2,1,1
12418,5001780014,SI,54 BRITTON STREET,01,B2,FIUME II LLC,2,1,1
12419,5002220041,SI,279 TAYLOR STREET,01,A1,"REMACHE, ELVIA",2,1,1
12420,5003180083,SI,27 ALPINE COURT,01,A2,THE MARY SHEA REVOCABLE TRUST BY MARY SH EA,2,1,1
12421,5003440039,SI,17 ELLSWORTH PLACE,01,A1,DENISE MC KLUSKY,2,1,1
12422,5003700006,SI,20 RAYMOND AVENUE,01,A1,JAMES D OSTROWSKI,2,1,1
12423,5003880074,SI,484 JEWETT AVENUE,01,B2,"CHIU, KAWING",2,1,1
12424,5004560025,SI,283 WOOLLEY AVENUE,01,A1,JOANNE RUBANO,2,1,1
12425,5004980018,SI,67 VAN DUZER STREET,02,C0,BAY ESTATE 194 LLC,2,1,1
12426,5005120059,SI,84 SANDS STREET,01,B2,"ROACH, DENISE",2,1,1
12427,5005410051,SI,16 HUDSON STREET,10,G0,JULIO BAEZ,2,1,1
12428,5005430037,SI,88 GORDON STREET,02,C0,V.D PROPERTY MANAGEMENT CORP,2,1,1
12429,5005660001,SI,3 CHESTNUT STREET,01,A1,"LOUIS, BERTHONY",2,1,1
12430,5006070001,SI,136 VAN CORTLANDT AVENUE,01,A1,"ROGAN, LELAND",2,1,1
12431,5007120005,SI,36 GARDEN STREET,01,B3,"AMATO, SHARON C",3,2,1
12432,5008690585,SI,53 ROCHELLE STREET,01,A2,CARMINE V MANNA,2,1,1
12433,5008710105,SI,143 FOUR CORNERS ROAD,01,A3,MICHAEL CARIDI,2,1,1
12434,5010390254,SI,27 DERBY COURT,01,A5,"CHANCE NEGRI, TRUSTEE",2,1,1
12435,5011690060,SI,334 PULASKI AVENUE,01,A5,GLENROY CLARKE,2,1,1
12436,5012360076,SI,52 HARBOR ROAD,01,B2,SI PROPERTY HOLDINGS LLC,2,1,1
12437,5012370080,SI,20 LOCKMAN AVENUE,01,B2,"BARNES, JESSIE",2,1,1
12438,5012540131,SI,58 GRANDVIEW AVENUE,01,B2,"MARTINO, GILBERTO",2,1,1
12439,5014670017,SI,237 WILLOWBROOK ROAD,01,A2,JOAN CRISSON,2,1,1
12440,5014780495,SI,105 HOUSTON STREET,01,B2,CITICORP MORTGAGE,2,1,1
12441,5020300001,SI,1949 RICHMOND AVENUE,05,K1,"WALDMAN DEVELOPMENT OF NY, LLC",2,1,1
12442,5021130129,SI,62 FREEDOM AVENUE,01,B2,"BOSCO, JAMES C",2,1,1
12443,5021560095,SI,26 TIMOTHY COURT,01,A5,"WEISS, ROSEMARIE",2,1,1
12444,5022310304,SI,51 BERGLUND AVENUE,01,B2,"GIOVANNUCCI, MICHAEL H",2,1,1
12445,5022800007,SI,251 MACE STREET,01,A1,"FOUNDOULAKIS, ARGIRO",2,1,1
12446,5024007501,SI,80 RICHMOND HILL ROAD,03,R4,GORANI FAMILY LLC,3,2,1
12447,5028220001,SI,951 BAY STREET,07,G5,HESS RETAIL STORES LLC,2,1,1
12448,5028650019,SI,9 EGBERT PLACE,01,A5,"GAWLEY, KRISTEN K",2,1,1
12449,5029980065,SI,21 KANSAS AVENUE,01,A5,KALPNESH RAMSES,2,1,1
12450,5031690009,SI,534 ODER AVENUE,01,A5,YENK CHING LAM,2,1,1
12451,5032540009,SI,226 KENSINGTON AVENUE,01,A2,"SCHUMACHER, FRANK",2,1,1
12452,5032930019,SI,26 ATLANTIC AVENUE,01,B2,"MB ATLANTIC, LLC",2,1,1
12453,5035530018,SI,33 HULL AVENUE,01,A2,PALEMINE CATHERINE A,2,1,1
12454,5035540015,SI,41 ADAMS AVENUE,01,A5,"TRAFIDLO, JOLANTA",2,1,1
12455,5035570017,SI,123 HULL AVENUE,01,A1,JOHN HERBERT,2,1,1
12456,5035870001,SI,183 COLFAX AVENUE,01,A5,THE ROMAN GUREVICH 2007 REVOCABLE LIVING TRUST,2,1,1
12457,5035910032,SI,20 GRANT PLACE,01,A2,W WALZ,2,1,1
12458,5036200019,SI,32 OTIS AVENUE,01,A1,"JENNIFER CALABRESE, AS TRUSTEE",2,1,1
12459,5036200088,SI,9 LOCUST AVENUE,01,A1,RICHARD REUTER,2,1,1
12460,5038840006,SI,579 GREELEY AVENUE,01,A2,BRONISLAVA VINER,2,1,1
12461,5040580175,SI,310 WEED AVENUE,01,A2,"HOGAN, MICHAEL",2,1,1
12462,5042740125,SI,154 PETER AVENUE,01,A1,JAMES O'NEILL,2,1,1
12463,5052760048,SI,4081 HYLAN BOULEVARD,05,K1,"KELLY NELLY, INC.",2,1,1
12464,5054440088,SI,330 GIFFORDS LANE,01,B3,"SPARAGNA, LOUISE",3,2,1
12465,5056150097,SI,35 VAN BRUNT STREET,01,A1,GIRALDI PATRICK A,2,1,1
12466,5062300025,SI,650 DRUMGOOLE ROAD EAST,01,B3,GOUDIE FAMILY TRUST,2,1,1
12467,5067050086,SI,82 HANOVER AVENUE,01,A1,STEPHEN RISPOLI,2,1,1
12468,5067750200,SI,391 SHARROTT AVENUE,01,A2,OWNER,2,1,1
12469,5070670096,SI,29 ST LUKES AVENUE,01,A1,"LIEBMAN, ESQ, RAYMOND L",2,1,1
12470,5073280081,SI,442 SHARROTTS ROAD,06,E2,SHARROTTS CORP,2,1,1
12471,5075330083,SI,108 PLEASANT PLAINS AVE,01,A1,"CORREA, PEDRO",2,1,1
12472,5075900005,SI,82 ANDROVETTE STREET,01,B2,"G & L VENTURE, LLC",2,1,1
12473,5078670134,SI,369 SLEIGHT AVENUE,01,A1,MARY B DEROSA,2,1,1
12474,5078840024,SI,376 MANHATTAN STREET,01,B2,"DELGANDIO, DENNIS",2,1,1
12475,5079650032,SI,43 WARDS POINT AVENUE,01,A3,KAREN SANTOPIETRO,2,1,1
12476,5080220006,SI,173 WOOD AVENUE,01,B3,KEVIN LINANE,2,1,1
12477,5080340016,SI,7091 AMBOY ROAD,01,B2,"ROBBINS, STACEY  L",2,1,1
12478,5080450067,SI,212 LEE AVENUE,01,A1,J JENNINGS,2,1,1
12479,1001420025,MN,310 GREENWICH STREET,04,D6,IP MORTGAGE BORROWER LLC,10,9,1
12480,1006130012,MN,246 WEST 11 STREET,02,C3,AVERY ELLISON HOLDINGS LLC,2,1,1
12481,1006800001,MN,360 WEST STREET,08,P9,NEW YORK CONVENTION CENTER,4,3,1
12482,1008040026,MN,117 WEST 28 STREET,05,K9,117 WEST 28TH STREET REALITY LLC,2,1,1
12483,1009040029,MN,411 2 AVENUE,02,C6,415 SECOND OWNERS CORP,5,4,1
12484,1011070021,MN,555 12 AVENUE,07,T2,NYC DEPARTMENT OF PARKS AND RECREATION,3,2,1
12485,1015310022,MN,1643 2 AVENUE,04,S5,JFK CORP,2,1,1
12486,1018287503,MN,2072 FREDRICK DOUGLASS BL,04,RM,UNAVAILABLE OWNER,2,1,1
12487,1019020059,MN,158 WEST 118 STREET,01,B2,"GIULINI, LAURA",2,1,1
12488,2026030192,BX,671 TIMPSON PLACE,06,F5,671 TIMPSON RLTY CO,2,1,1
12489,2028420023,BX,41 ELLIOT PLACE,04,C7,ELLIOT PLACE ESTATES LLC,2,1,1
12490,2029920071,BX,1905 VYSE AVENUE,01,B2,"LLENZA, ENRIQUE",2,1,1
12491,2030370011,BX,4402 PARK AVENUE,01,B2,HORACIO R. CACERES,3,2,1
12492,2030910073,BX,696 EAST FORDHAM ROAD,05,O2,TRIANGLE EQUITIES 696 FORDHAM ROAD L.L.C .,2,1,1
12493,2032160002,BX,1930 ANDREWS AVENUE SOUTH,08,W1,NYC DEPARTMENT OF EDUCATION,2,1,1
12494,2032850057,BX,2963 DECATUR AVENUE,01,A1,MOHAMMAD JAN,2,1,1
12495,2032890020,BX,2802 POND PLACE,01,A1,"ARNOLD, NEELA",2,1,1
12496,2032990006,BX,3010 BAINBRIDGE AVENUE,01,A1,"KUFFUOR-BERKO, KWAME",2,1,1
12497,2033350184,BX,261 EAST 206 STREET,08,M9,"NORTH BRONX ISLAMICCENTER, INC.",2,1,1
12498,2033860034,BX,346 EAST 238 STREET,01,A1,"MATHEWS, NATHAN WILLIAMS",2,1,1
12499,2033890004,BX,310 EAST 241 STREET,01,A1,"ROONEY, KERRY DILLON",2,1,1
12500,2034560005,BX,200 SOUNDVIEW AVENUE,05,K1,210 SV REALTY LLC,3,2,1
12501,2035000068,BX,431 WHITE PLAINS ROAD,02,C0,"BRIGLALL, INDIRA",2,1,1
12502,2035990017,BX,724 TAYLOR AVENUE,01,B1,"HAQUE, AZMAL",2,1,1
12503,2036880078,BX,2113 QUIMBY AVENUE,01,B2,"SEWDIAL, MAUREEN",2,1,1
12504,2037660025,BX,1238 THIERIOT AVENUE,02,C0,"HUSSAIN, MD ANOWAR",2,1,1
12505,2037700083,BX,1441 WESTCHESTER AVENUE,07,G4,LEEMILTS PETROLEUM INC,2,1,1
12506,2037710072,BX,1215 WHEELER AVENUE,02,C1,"HU, HONG-JI T",2,1,1
12507,2038840031,BX,1363 WHITE PLAINS ROAD,01,A1,TRIGO MANUEL,2,1,1
12508,2039180003,BX,1506 COMMONWEALTH AVENUE,01,B2,COLLIN MANNING,2,1,1
12509,2039260010,BX,1581 LELAND AVENUE,01,A1,"DIXON, HARRY",2,1,1
12510,2039480047,BX,2181 STARLING AVENUE,03,D4,2181 STARLING AVE OWNERS CORP,2,1,1
12511,2039790032,BX,2431 GLEBE AVENUE,02,C0,"FLORES, MARIA ARCELI",2,1,1
12512,2040650021,BX,1557 LURTING AVENUE,01,B2,"FAZIO, MARIA",2,1,1
12513,2041320034,BX,1805 WILLIAMSBRIDGE ROAD,05,K2,"ERMIONI 1801 REALTY, LLC",5,4,1
12514,2044790012,BX,2410 WOODHULL AVENUE,01,A1,"NGUYEN , THANH  C",2,1,1
12515,2045120050,BX,2729 BARNES AVENUE,01,B1,"GASQUET, MARIA D",2,1,1
12516,2046550072,BX,659 EAST 220 STREET,01,B2,"TRONCOSO, MARY T",2,1,1
12517,2046900020,BX,925 EAST 219 STREET,01,B1,"WATSON, MARLENE M",2,1,1
12518,2047180053,BX,1429 NEEDHAM AVENUE,01,B9,HUNTER DONALD,2,1,1
12519,2047480012,BX,3233 KINGSLAND AVENUE,02,C0,"BROWN, MARCIA",2,1,1
12520,2047940004,BX,1806 ARNOW AVENUE,01,A2,"MERILUOTO, ROY STEVEN",3,2,1
12521,2048690063,BX,1048 EAST 223 STREET,02,C0,"GREEN, NOEL",2,1,1
12522,2049990038,BX,727 EAST 235 STREET,01,B2,"SEEAMBAR, JEEWAN",2,1,1
12523,2050480008,BX,4381 BARNES AVENUE,02,C2,4381 BARNES LLC,3,2,1
12524,2050920017,BX,4420 ELY AVENUE,01,A1,"SINGH, LUCILLE",2,1,1
12525,2051210021,BX,4633 MURDOCK AVENUE,01,B2,"COOBLALL, SASHA",2,1,1
12526,2054060077,BX,3157 WATERBURY AVENUE,01,B1,"LOMBARDI, EMILY M",2,1,1
12527,2054090543,BX,3300 SPENCER DRIVE,01,A2,GERALD F BREEN,2,1,1
12528,2054400024,BX,550 EDISON AVENUE,01,A2,"MAHON, JAMES E JR",2,1,1
12529,2054630020,BX,989 WILCOX AVENUE,01,B2,PAGANO JOHN,3,2,1
12530,2055420001,BX,941 HUTCHINSON RVR PKWY,08,W2,ARCHBISHOPRIC OF NEW YORK,13,12,1
12531,2056060123,BX,224 BUTTRICK AVENUE,04,C7,"ROBERT STANLEY,",7,6,1
12532,2056320057,BX,11 BAY STREET,01,B2,"DELANEY, JEANETTE",2,1,1
12533,2056320108,BX,74 TIER STREET,01,B3,"MUNAFO, SCOTT",2,1,1
12534,2056320158,BX,99 BAY STREET,01,B2,"MANKIEWICZ, PAUL  S",3,2,1
12535,2056470096,BX,560 MINNIEFORD AVENUE,01,A1,C.I. PHOENIX LLC,2,1,1
12536,2057260666,BX,2782 JOHNSON AVENUE,08,N9,"UNITED CEREBRAL PALSY OF NEW YORK CITY,  INC.",2,1,1
12537,2057560230,BX,250 WEST 234 STREET,10,G1,DAISY ALVERIO,3,2,1
12538,3001470001,BK,369 JAY STREET,05,O5,WENDY REALTY INC,2,1,1
12539,3001740001,BK,362 SCHERMERHORN STREET,08,W1,NEW YORK CITY EDUCATIONAL CONSTRUCTION F UND,2,1,1
12540,3002990006,BK,69 COLUMBIA STREET,04,S5,69 COLUMBIA ST REALTY LLC,2,1,1
12541,3004080015,BK,18 BUTLER STREET,02,C3,HYATT REALTY LLC,2,1,1
12542,3004110014,BK, BUTLER STREET,07,U2,NYC DEPARTMENT OF ENVIRONMENTAL PROTECTION,4,3,1
12543,3004210034,BK,356 DEGRAW STREET,04,S5,MAYO MICHAEL,2,1,1
12544,3005130017,BK,22 COLES STREET,10,G7,THOMAS J RUSSO,2,1,1
12545,3005860036,BK,140 COFFEY STREET,01,B3,"WIRTH, THOMAS",2,1,1
12546,3006340013,BK,182 18 STREET,01,B1,RANDY KARR,2,1,1
12547,3006760025,BK,144 31 STREET,01,B9,"VALDEZ, JAMES",2,1,1
12548,3007780008,BK,4805 8 AVENUE,04,S2,WALLACE YU,2,1,1
12549,3008550035,BK,472 58 STREET,04,S2,"GIL DE RUBIO TRUSTEE, WALTER",2,1,1
12550,3010140063,BK,135 11 STREET,06,F9,"ROSENZWEIG PROPERTIES, INC.",3,2,1
12551,3011220047,BK,895 PACIFIC STREET,02,C1,PACIFIC ASSOCIATES LLC,2,1,1
12552,3011400020,BK,810 DEAN STREET,01,B1,"SCHELL, ELSPETH",3,2,1
12553,3011430058,BK,578 CARLTON AVENUE,01,A4,"LIN, FRED Y",2,1,1
12554,3011590056,BK,144 UNDERHILL AVENUE,01,B3,"ERTAN, KUTLU",3,2,1
12555,3012900058,BK,323 CROWN STREET,01,B9,SKOBLO LEIB,2,1,1
12556,3013000036,BK,554 CROWN STREET,01,A4,"WOMEN'S LEAGUE COMMUNITY RESIDENCE, INC.",2,1,1
12557,3013690019,BK,1582 PROSPECT PLACE,02,C1,SY PROSPECT LLC,2,1,1
12558,3014570028,BK,1430 ST MARKS AVENUE,01,B1,"ALEXANDER, LEMREY C",2,1,1
12559,3014620132,BK,1698 PROSPECT PLACE,01,B2,DICKSON A ONODIANA,2,1,1
12560,3015720029,BK,90 SACKMAN STREET,01,B9,"WKS INVESTORS, INC",2,1,1
12561,3017800033,BK,212 TOMPKINS AVENUE,08,M1,MT. PISGAH BAPTIST CHURCH,3,2,1
12562,3018260030,BK,466 MADISON STREET,02,C1,BEDFORD STUY NSA IIREDV,2,1,1
12563,3018660023,BK,1225 ATLANTIC AVENUE,05,H3,ATLANTIC AVENUE PROPERTIES I LLC,2,1,1
12564,3019040008,BK,217 WASHINGTON AVENUE,01,A1,"SEROTA, STEPHEN H",2,1,1
12565,3019700052,BK,85 QUINCY STREET,01,B1,CALVIN WRIGHT,2,1,1
12566,3019770029,BK,927 FULTON STREET,04,S3,927 FULTON STREET LLC,2,1,1
12567,3022180013,BK,126 PENN STREET,02,C0,"126-P, LLC",2,1,1
12568,3024200028,BK,164 HAVEMEYER STREET,04,C7,NYSANDY14 WILLIAMSBURG 2 LLC,2,1,1
12569,3024470035,BK,277 SOUTH 5 STREET,04,D7,HAVEMEYER OWNER LLC,5,4,1
12570,3025120046,BK,1031 MANHATTAN AVENUE,02,C6,P F H MANHATTAN AVE H D F C,2,1,1
12571,3026520039,BK,84 DIAMOND STREET,01,B9,"GARDOCKI, MIROSLAW",2,1,1
12572,3028780016,BK,400 WITHERS STREET,06,F4,JOELOWE REALTY LLC,2,1,1
12573,3029170019,BK,297 DEVOE STREET,02,C0,"LUU, VICTOR",2,1,1
12574,3029420005,BK,246 MORGAN AVENUE,06,E9,MWK REALTY CORP.,2,1,1
12575,3031060019,BK,106 MOORE STREET,04,S9,106 MOORE LLC.,2,1,1
12576,3031320011,BK,14 FAYETTE STREET,01,B2,JOSE MEDINA,2,1,1
12577,3032340040,BK,1383 DEKALB AVENUE,02,C0,"SAWYACK, KOWSILIA",2,1,1
12578,3032450027,BK,1376 DEKALB AVENUE,02,C0,DEKALB INNOVATION REALTY LLC,2,1,1
12579,3032720036,BK,421 HIMROD STREET,02,C0,"QUACH, JIMMY",2,1,1
12580,3032900011,BK,364 HARMAN STREET,03,D1,364 HARMAN LLC,2,1,1
12581,3034390001,BK,1411 BUSHWICK AVENUE,02,C1,1411 BUSHWICK AVENUE DEVELOPMENT LLC,2,1,1
12582,3035730015,BK,729 THOMAS S BOYLAND ST,01,B1,SANDERS MARY,2,1,1
12583,3036640052,BK,2741 FULTON STREET,11,V1,2741 FULTON LLC,2,1,1
12584,3037200016,BK,183 SHEFFIELD AVENUE,01,A1,SANTIAGO YOLANDA,2,1,1
12585,3037590024,BK,504 BELMONT AVENUE,01,B2,"ESQUILIN, VICTOR",2,1,1
12586,3037750125,BK,372 BRADFORD STREET,01,A5,SHUTTER PROPERTIES LLC,2,1,1
12587,3039600065,BK,3141 ATLANTIC AVENUE,07,G2,3141 ATLANTIC AVENUE LLC,2,1,1
12588,3039850033,BK,703 GLENMORE AVENUE,02,C0,"NARANJO, COLBY",2,1,1
12589,3040100001,BK,335 VAN SICLEN AVENUE,09,Q9,NYC HOUSING PRESERVATION AND DEVELOPMENT,2,1,1
12590,3040950001,BK,775 JAMAICA AVENUE,09,Z8,SALEM FIELDS CEMETERY,3,2,1
12591,3041060106,BK,3 CYPRESS COURT,01,B2,"VELAZQUEZ, FLORA",2,1,1
12592,3041640037,BK,374 CRESCENT STREET,01,A5,"RAMNARAIN, RISHI",2,1,1
12593,3041650018,BK,90 MC KINLEY AVENUE,02,C0,"MAHMUD, MD",2,1,1
12594,3043160034,BK,732 SHEPHERD AVENUE,02,C0,"DUNN, CHERYL",2,1,1
12595,3044000020,BK,908 JEROME STREET,02,C0,ARETHA YOUNG WILLIAMS,2,1,1
12596,3046810059,BK,199 EAST 55 STREET,01,B3,SALOMON MARLENE,2,1,1
12597,3046830024,BK,86 EAST 58 STREET,01,B1,NICOLE NATASHA JAMES,2,1,1
12598,3047120050,BK,554 EAST 92 STREET,02,C0,ROSE G GREGOIRE,2,1,1
12599,3047790051,BK,871 EAST 48 STREET,01,A1,"FARRELL, TIFFANY",2,1,1
12600,3048710019,BK,134 EAST 35 STREET,01,A1,"MENDOZA DOMINGUEZ, GRACIELA",2,1,1
12601,3048860025,BK,960 NEW YORK AVENUE,08,W3,"SMITH, CHARMAINE BECKFORD",2,1,1
12602,3049350057,BK,419 EAST 35 STREET,01,B9,FRANKLIN  BRIAN,2,1,1
12603,3049720062,BK,631 EAST 38 STREET,01,B3,HARRINGTON PAULA,2,1,1
12604,3050840082,BK,135 LINDEN BOULEVARD,08,I6,NEW YORK CONGREGATIONAL NURSING CENTER,3,2,1
12605,3051040056,BK,2544 CHURCH AVENUE,08,M1,HOLY CROSS R C CHURCH,11,10,1
12606,3051130029,BK,519 CONEY ISLAND AVENUE,05,O2,ETTEUGUI ISSAC,2,1,1
12607,3052730001,BK,402 VANDERBILT STREET,01,B2,"KAYATA, JOANNA",2,1,1
12608,3053020055,BK,20 CHESTER AVENUE,01,B1,"ELKARI, ADIL",2,1,1
12609,3053590032,BK,326 EAST 8 STREET,01,A1,HUGUES JEANNOT,2,1,1
12610,3053740063,BK,543 EAST 5 STREET,01,A1,"GALINSKY, DAVID",2,1,1
12611,3054750049,BK,1965 53 STREET,01,B3,"SCHER, JOEL",2,1,1
12612,3055020068,BK,1523 59 STREET,02,C0,59 EQUITIES LLC,2,1,1
12613,3055120056,BK,1847 60 STREET,08,M9,"CONG. DARKEI CHAIM, INC.",2,1,1
12614,3056520030,BK,954 51 STREET,01,A9,KATZ JACOB,2,1,1
12615,3056790032,BK,862 55 STREET,04,S1,"MO, PETER",2,1,1
12616,3056890079,BK,1105 57 STREET,02,C0,GREENFELD JACOB,2,1,1
12617,3057127501,BK,1342 59 STREET,02,R3,UNAVAILABLE OWNER,2,1,1
12618,3057400037,BK,1372 63 STREET,10,G0,JR EVERGRANDE INC,2,1,1
12619,3058500020,BK,322 67 STREET,02,C3,"LEUNG, LILA NG",2,1,1
12620,3059540064,BK,971 77 STREET,01,A5,GIUGLIANO ANTHONY,2,1,1
12621,3059760010,BK,50 79 STREET,01,A1,"AU, HOK DOON JOHN",2,1,1
12622,3060170031,BK,360 83 STREET,01,B1,"KORONIAN, HRATCH",2,1,1
12623,3061040036,BK,56 MARINE AVENUE,01,B3,"SMITH, ANDREW",3,2,1
12624,3062430010,BK,1212 77 STREET,01,A5,YAN QIN LIN,2,1,1
12625,3063197501,BK,2214 82 STREET,02,R1,UNAVAILABLE OWNER,3,2,1
12626,3063330061,BK,1939 85 STREET,02,C0,M75 LLC,2,1,1
12627,3063710087,BK,8682 19 AVENUE,02,C0,"IBRAHIM, ISMAIL",2,1,1
12628,3063760016,BK,59 BAY 25 STREET,02,C0,"ANATOLI PROPERTY ASSOCIATES, LLC",2,1,1
12629,3065030119,BK,310 WALSH COURT,01,A3,310 WALSH COURT LLC,2,1,1
12630,3065250003,BK,208 AVENUE J,01,B2,SHAIN MORDECAI,2,1,1
12631,3065320035,BK,1254 EAST 7 STREET,01,A9,"CHARLES A. HADDAD, TRUSTEE",2,1,1
12632,3065330073,BK,1235 EAST 7 STREET,01,A4,"DABAH, ELLIOT",2,1,1
12633,3065690013,BK,630 AVENUE M,01,B2,630 AVENUE M TRUST,2,1,1
12634,3065690060,BK,1377 OCEAN PARKWAY,01,B1,MOSHE METZGER,2,1,1
12635,3065860005,BK,412 AVENUE N,01,B1,"CHALOUH, JACK",2,1,1
12636,3065860031,BK,1544 EAST 5 STREET,01,A9,TAWIL EZRA,2,1,1
12637,3065870079,BK,1545 EAST 5 STREET,01,B1,ISAAC MANSOUR,2,1,1
12638,3065890058,BK,709 AVENUE O,01,A3,"ZAMI, ABRAHAM ET UX",2,1,1
12639,3066020065,BK,1565 WEST 5 STREET,01,A9,"KLEYTMAN, ALLA",2,1,1
12640,3066150038,BK,1576 EAST 9 STREET,01,B2,DONALD A. HAMBURG AS TRUSTEE,2,1,1
12641,3066170079,BK,1531 EAST 10 STREET,01,A1,VERA FAHAM  C/O,2,1,1
12642,3066590006,BK,402 QUENTIN ROAD,01,A5,"AZAR, ABE CHARLES",2,1,1
12643,3066590070,BK,1803 EAST 2 STREET,01,A9,"MIZRAHI, JOSEPH E",2,1,1
12644,3066590078,BK,1797 EAST 2 STREET,01,A9,SEFARADI ELIEZER,2,1,1
12645,3066610020,BK,1806 EAST 5 STREET,01,A1,"1806 ARA, LLC",2,1,1
12646,3066810339,BK,1948 EAST 5 STREET,01,A1,RAYMOND BETESH,2,1,1
12647,3066820071,BK,1859 OCEAN PARKWAY,01,A1,"YEDID, RACHELLE",2,1,1
12648,3066840005,BK,812 AVENUE R,01,A1,"HAKIM, MICHELE",2,1,1
12649,3066850017,BK,940 AVENUE R,01,A1,"SMOUHA, DAVID",2,1,1
12650,3066920030,BK,777 EAST 17 STREET,01,A1,"RAMOS, NYDIA",2,1,1
12651,3067430036,BK,1372 EAST 15 STREET,01,B2,KENNETH SHAMAH,2,1,1
12652,3067570045,BK,1966 OCEAN AVENUE,08,M1,TOMCHEI TORAH OF NEW YORK,2,1,1
12653,3067750016,BK,1624 EAST 13 STREET,08,M3,CONGREGATION ETZ CHAIM,2,1,1
12654,3067820032,BK,2136 OCEAN AVENUE,04,O8,"JODAN CENTER, LLC",2,1,1
12655,3068060076,BK,1737 EAST 23 STREET,01,A3,1737 E 23 LLC,2,1,1
12656,3068060086,BK,1713 EAST 23 STREET,01,B3,"SALAMA , JOSEPH",2,1,1
12657,3068530065,BK,2329 84 STREET,02,C0,"CHAN, YU CHARM",2,1,1
12658,3069950078,BK,2716 WEST 16 STREET,02,C0,"BENNETT, MIHALIS",2,1,1
12659,3069960031,BK,2725 WEST 16 STREET,,Z9,MAVICA HOLDIONG CORP,2,1,1
12660,3070820080,BK,1913 WEST 7 STREET,08,M1,IGLESIAS DE EVANGELIZACION MISIONERA JOV ENES,2,1,1
12661,3070950049,BK,61 AVENUE U,05,K1,"AMOASHIY, MICHAEL",2,1,1
12662,3071040255,BK,2074 WEST STREET,01,A1,DOUECK JACK,2,1,1
12663,3071110037,BK,2076 EAST 9 STREET,01,A1,"POLIKAR, NIVA",2,1,1
12664,3071290035,BK,2228 EAST 3 STREET,01,B3,MADEB LILY,2,1,1
12665,3071300053,BK,2225 EAST 3 STREET,01,A9,"DAVID J. BEYDA, AS TRUSTEE",2,1,1
12666,3071340028,BK,2162 EAST 8 STREET,01,B1,ALBERT KHADEIDA,2,1,1
12667,3071350063,BK,2141 EAST 8 STREET,01,B1,"SERKO, KABI",2,1,1
12668,3071570008,BK,2210 OCEAN PARKWAY,02,C0,"MANN, JACK",2,1,1
12669,3071590004,BK,710 AVENUE V,01,A3,"HARA, JACK",2,1,1
12670,3071700025,BK,2484 MCDONALD AVENUE,06,E1,LOPOPOLO CARLO,2,1,1
12671,3071840075,BK,72 LANCASTER AVENUE,01,B1,CHAMAA CHALOUH,2,1,1
12672,3072160063,BK,2537 WEST STREET,02,C0,SIGAL AGMON KASSAB,2,1,1
12673,3072240033,BK,733 GERALD COURT,01,B2,ALLEN WILLIAM T,2,1,1
12674,3072737501,BK,486 NEPTUNE AVENUE,05,RC,UNAVAILABLE OWNER,4,3,1
12675,3073010009,BK,2224 AVENUE S,01,A1,"RIBAK, KFIR",2,1,1
12676,3073120056,BK,1967 BATCHELDER STREET,01,A1,FATTORE FAMILY TRUST,2,1,1
12677,3073240072,BK,2029 EAST 19 STREET,01,A1,"BISSOU, LISA",2,1,1
12678,3073300075,BK,4119 BEDFORD AVENUE,02,C0,"VOLNY, HENRY",2,1,1
12679,3074410321,BK,2542 EAST 22 STREET,01,A1,"KACHANOVSKIY, ALEX",2,1,1
12680,3074410454,BK,2555 EAST 22 STREET,01,B2,"DI STEFANO, MARIA",2,1,1
12681,3075780049,BK,825 EAST 32 STREET,05,K1,"FRANCIS, ROBERT",2,1,1
12682,3075910024,BK,951 EAST 27 STREET,01,B1,"LEW, ALVIN",2,1,1
12683,3076050073,BK,1070 EAST 24 STREET,01,A1,ZWICK YAACOV & GOLDIE,2,1,1
12684,3076120076,BK,1078 EAST 31 STREET,01,A1,"TVERSKY, SAMUEL",2,1,1
12685,3076240064,BK,3270 BEDFORD AVENUE,01,B2,JUDITH RUTTENBERG,2,1,1
12686,3076370025,BK,1315 EAST 37 STREET,01,B2,PERKOWSKI ABRAHAM,2,1,1
12687,3076440069,BK,1258 EAST 27 STREET,01,B2,SCHMULOVICH JOVA,2,1,1
12688,3076460064,BK,1246 EAST 29 STREET,01,A1,ELI YEGER DEBBY YEGER,2,1,1
12689,3076540002,BK,3621 AVENUE M,01,B1,"SADIO, EDMUND",2,1,1
12690,3076790071,BK,1442 EAST 26 STREET,01,A1,ABRAHAM GUTMAN,2,1,1
12691,3076800073,BK,1446 EAST 27 STREET,01,A1,"ROSENBERG, ZEHAVA",2,1,1
12692,3077060028,BK,1625 EAST 33 STREET,01,A5,"KAPETAS, ABRAHAM",2,1,1
12693,3077280035,BK,1539 TROY AVENUE,09,P6,GLENTROY LLC,2,1,1
12694,3077480007,BK,4409 AVENUE I,01,B3,"JEAN, EDOUARD",2,1,1
12695,3077700026,BK,1771 TROY AVENUE,01,A9,"HEADLEY, CLARISA",3,2,1
12696,3077940013,BK,1425 EAST 46 STREET,01,A1,"JONES, ZITA",2,1,1
12697,3078990068,BK,1586 EAST 55 STREET,01,B1,"FARADAY, ANDREW",2,1,1
12698,3079030078,BK,1480 EAST 59 STREET,01,A9,"HAMILTON, HELEN",2,1,1
12699,3081830054,BK,1102 EAST 96 STREET,01,B3,"AUGUSTIN, MARGUERITE G",2,1,1
12700,3082750115,BK,8 MATTHEWS PLACE,01,A2,"BRYAN, MADGE C",2,1,1
12701,3083160001,BK,1728 SKIDMORE AVENUE,08,W2,ROMAN CATHOLIC CHURCH,3,2,1
12702,3083860016,BK,1455 EAST 64 STREET,01,A9,"SCHWARTZ, BINYAMIN",2,1,1
12703,3084120028,BK,2029 EAST 71 STREET,01,A9,"MUKHAMMADIYEV, ABRIK B",2,1,1
12704,3087330067,BK,154 BEAUMONT STREET,01,A5,REICH RAYMOND,2,1,1
12705,3087510416,BK,124 IRWIN STREET,01,A1,"PALANKER, STEVE",2,1,1
12706,3088390053,BK,2727 KNAPP STREET,06,E7,"KNAPP STORAGE SPE, LLC",2,1,1
12707,3089140422,BK,108 DARE COURT,01,A1,TETYANA CHEPETS,2,1,1
12708,4002750035,QN,30-02 SKILLMAN AVENUE,05,G8,"ACCEL MOTORS, INC",2,1,1
12709,4005790068,QN,31-22 29 STREET,11,V0,31-22 ASTORIA LLC,2,1,1
12710,4005980048,QN,25-56 31 STREET,05,O5,THE GASPARRE HOLDINGS LIMITED PARTN,2,1,1
12711,4008490001,QN,28-01 21 AVENUE,02,C0,"28-01 21ST AVENUE, LLC",2,1,1
12712,4008670059,QN,22-70 CRESCENT STREET,02,C0,GENESEE LLC,2,1,1
12713,4010090027,QN,22-40 78 STREET,02,C0,REINHARD OERLERKING,2,1,1
12714,4010690003,QN,92-08 DITMARS BOULEVARD,01,A5,"BRISSETT, COURTNEY",2,1,1
12715,4010750060,QN,22-29 98 STREET,01,A2,CADOGAN STEFANIE E,2,1,1
12716,4012990040,QN,40-18 68 STREET,02,C1,QUEENSWAY REALTY LLC,2,1,1
12717,4013010042,QN,40-22 70 STREET,02,C0,LIN YI HU,2,1,1
12718,4013070048,QN,67-13 WOODSIDE AVENUE,01,B1,"ALATIEF, MELLYANA",2,1,1
12719,4013300018,QN,43-01 57 STREET,01,B1,PLISAK PETER,2,1,1
12720,4014140015,QN,32-20 85 STREET,01,A5,ROMINA SEPULVEDA,2,1,1
12721,4014810053,QN,37-59 93 STREET,01,B2,"MARTINEZ, DAVID O",2,1,1
12722,4015860064,QN,46-03 90 STREET,01,B1,"CASTANO, JOHN JAIRO",2,1,1
12723,4016300011,QN,101-26 45 AVENUE,01,B1,"POLANCO, CARMEN I",2,1,1
12724,4017230040,QN,33-23 108 STREET,01,B9,JORGE CANDO R,4,3,1
12725,4017600019,QN,37-34 98 STREET,01,B2,"TERESA, RAMIREZ",2,1,1
12726,4020010041,QN,45-10 111 STREET,02,C1,KNK 111 LLC,2,1,1
12727,4021250060,QN,102-02 63 ROAD,01,B3,"KIMYAGAROV, MARK",2,1,1
12728,4022290025,QN,110-42 69 AVENUE,01,A1,"ELISHAKASHVILI, GABRIEL",2,1,1
12729,4022290032,QN,110-56 69 AVENUE,01,A7,"YUSUPOV, EDUARD",2,1,1
12730,4024040007,QN,67-10 53 ROAD,01,B2,"ORDONEZ, JHONNY G",2,1,1
12731,4024080010,QN,66-22 52 DRIVE,01,B2,ZORAIDA SANCHEZ,2,1,1
12732,4024720108,QN,51-31 MANILLA STREET,02,C0,CHU WILLIAM,3,2,1
12733,4024917501,QN,73-35 GRAND AVENUE,04,RM,UNAVAILABLE OWNER,2,1,1
12734,4025440001,QN,53-19 46 STREET,06,E1,54TH AVENUE REALTY LLC,2,1,1
12735,4026480013,QN,60-13 55 STREET,01,A9,"PETILLO, PHYLLIS",2,1,1
12736,4026750030,QN,58-84 57 ROAD,02,C3,AMICI PROPERTIES,3,2,1
12737,4026760028,QN,57-65 58 STREET,01,B1,"LEI, RONG LIANG",2,1,1
12738,4027280005,QN,59-15 60 STREET,01,A5,"REYES, CARLOS A",2,1,1
12739,4027570062,QN,62-51 60 ROAD,01,B2,CORNELIUS O'KANE,2,1,1
12740,4027620078,QN,64-21 ELIOT AVENUE,01,B2,KASPARIAN KAREKINE,2,1,1
12741,4028310011,QN,59-12 69 LANE,01,B3,KRAMER TERESA,2,1,1
12742,4028480046,QN,60-45 77 PLACE,01,B1,"GRILLI, MARK",2,1,1
12743,4029070033,QN,54-68 82 STREET,02,C0,JOANNE WONG,2,1,1
12744,4029870044,QN,63-71 77 STREET,01,B1,"KALPAXIS, ARION A",2,1,1
12745,4032050040,QN,68-19 CLYDE STREET,01,B1,"QUI, LAURENCE Y",2,1,1
12746,4032460039,QN,71-55 INGRAM STREET,01,A1,WESTON MICHAEL H,2,1,1
12747,4033780001,QN,323 WOODWARD AVENUE,09,Z8,LINDEN HILL UN METH C,4,3,1
12748,4034920007,QN,62-89 FOREST AVENUE,08,W1,NYC DEPARTMENT OF EDUCATION,2,1,1
12749,4036000123,QN,72-33 CYPRESS HILLS STREET,01,B2,"WIRSCHING, JOSEF",3,2,1
12750,4036500009,QN,69-08 67 PLACE,01,A9,"BADIA, DAMADI",2,1,1
12751,4036960075,QN,72-25 73 STREET,01,B2,"CARUANA, GERALDINE",2,1,1
12752,4037830009,QN,68-03 79 STREET,01,B1,"PEREZ, FELICIA",2,1,1
12753,4037980038,QN,69-44 79 STREET,01,B2,"DOLPHIN, JOHN J",2,1,1
12754,4038000069,QN,79-37 69 ROAD,01,A5,"PAGE, RICHARD",2,1,1
12755,4038140035,QN,77-52 78 STREET,01,B2,"SCALZO, ROSARY RITA",2,1,1
12756,4038330003,QN,82-13 MYRTLE AVENUE,02,C0,CONCETTA ANCONA,2,1,1
12757,4038410020,QN,77-26 86 STREET,01,A5,"ULLMAN, HARRY M.",3,2,1
12758,4039540026,QN,5-17 127 STREET,01,A9,"BAUER, LOUIS B",2,1,1
12759,4040410001,QN,120-02 12 AVENUE,01,A1,"KELLY, TRICIA B",2,1,1
12760,4041340016,QN,18-13 128 STREET,06,E9,AMBRO PROPERTIES LLC,2,1,1
12761,4042010117,QN,22-03 125 STREET,02,C2,ANDREW J BATIRA,2,1,1
12762,4042490047,QN,143-30 22 ROAD,02,C0,SAU CHU SUSANNA HA,2,1,1
12763,4042820100,QN,25-70 WHITESTONE EP SR W,06,F2,NYT COLLEGE POINT LLC,3,2,1
12764,4044400004,QN,144-20 BOULEVARD,01,A1,DOMENICO SCIALFA,3,2,1
12765,4045020051,QN,149-09 11 AVENUE,01,A1,"COUTO, PAUL",2,1,1
12766,4045980014,QN,14-70 165 STREET,01,A3,FRANCESCO GIAMBRONE,2,1,1
12767,4046180027,QN,166-06 14 ROAD,01,A1,JOHN SIDERIS,2,1,1
12768,4046270060,QN,145-07 17 ROAD,01,A1,"DRAZEVIC, IVE",2,1,1
12769,4047880070,QN,144-49 32 AVENUE,01,A1,HAN MA UM ZEN CENTEROF N.Y. INC,2,1,1
12770,4048930042,QN,29-14 163 STREET,01,A5,JIRINA BUBNIK,2,1,1
12771,4053790024,QN,42-66 149 STREET,08,M9,AFGHAN IMMIGRANTS ISLAMIC CTR/MASJID SAY ED JAMAUL,3,2,1
12772,4054150054,QN,43-40 158 STREET,02,C0,"LIN, YUN XIA",2,1,1
12773,4054180055,QN,43-40 161 STREET,01,B3,"HUANG, XIAOLONG",2,1,1
12774,4055840055,QN,171-27 COURTNEY AVENUE,01,A1,"NA, LINLING",2,1,1
12775,4057470001,QN,163-03 20 AVENUE,01,A1,"BANIS, PARIS",2,1,1
12776,4057470035,QN,163-60 19 AVENUE,01,A0,"SHIM, EDWARD",2,1,1
12777,4060250017,QN,32-34 JORDAN STREET,01,A5,"PERANIO, LAURA JEAN",2,1,1
12778,4060780074,QN,34-11 JORDAN STREET,01,A1,"OTTOSON, MAUREEN",2,1,1
12779,4060930029,QN,208-11 34 AVENUE,01,A1,YANG ZHAN,2,1,1
12780,4060960020,QN,34-30 208 STREET,01,A1,"SKENDERIS, STAVROS",2,1,1
12781,4063530027,QN,130-37 58 ROAD,01,B1,"LIN, CHENG DIAN",2,1,1
12782,4068470022,QN,76-08 164 STREET,01,A1,"WANG, YOULIN",2,1,1
12783,4068990041,QN,61-16 172 STREET,01,B1,"ZHUO, YOU LI",2,1,1
12784,4069000020,QN,61-27 172 STREET,01,B1,PUI HA CHENG,2,1,1
12785,4069010056,QN,61-44 FRESH MEADOW LANE,07,G2,173-12 OPERATING COINC,2,1,1
12786,4069070001,QN,166-21 67 AVENUE,01,A3,"RUBINOV, RONI",2,1,1
12787,4069270022,QN,67-10 FRESH MEADOW LANE,08,W1,NYC DEPARTMENT OF PARKS AND RECREATION,3,2,1
12788,4069710046,QN,164-30 77 ROAD,01,A1,CHRISS K COMBIS,2,1,1
12789,4070200003,QN,169-08 UNION TURNPIKE,01,A3,"KUMAR, BINAY",2,1,1
12790,4072300059,QN,180-23 80 DRIVE,01,A1,"TABIBOVA, YULIYA",2,1,1
12791,4072480004,QN,80-15 KENT STREET,08,M1,CONGREGATION A/S/JAM/EST,2,1,1
12792,4072700024,QN,81-40 189 STREET,01,A1,"ISHAKOV, TATIANA",2,1,1
12793,4081160086,QN,42-08 247 STREET,01,A5,THOMAS CONFORTI,2,1,1
12794,4081960006,QN,46-04 245 STREET,02,C2,"PARKER GREENFIELD, LLC",3,2,1
12795,4081970145,QN,245-05 RUSHMORE AVENUE,01,A1,33 DEVELOPMENT INC.,2,1,1
12796,4082270026,QN,251-12 NORTHERN BOULEVARD,04,S9,WRIGHT COOPER CORP,5,4,1
12797,4082560085,QN,54-18 LITTLE NECK PARKWAY,01,A1,"KIM, YOUNG I.",2,1,1
12798,4086390071,QN,248-65 88 ROAD,01,A1,"DUNI, MICHAEL A",2,1,1
12799,4086510072,QN,244-11 88 DRIVE,01,A1,MARIA RUFFO,2,1,1
12800,4089340040,QN,87-62 94 STREET,01,B3,"DEMARTINO, MARY-ANN",2,1,1
12801,4092790110,QN,86-19 125 STREET,01,A1,"SINGH, CHANDROWTIE",2,1,1
12802,4092810026,QN,86-18 130 STREET,01,A1,"HABIBULLA, AZAMUDEEN K",2,1,1
12803,4092880082,QN,87-17 102 STREET,02,C1,87-17 102 STREET RIC,2,1,1
12804,4092960045,QN,104-33 91 AVENUE,01,A1,MARTIN ARIAS,2,1,1
12805,4093090012,QN,92-06 104 STREET,01,B2,"CHEN, XIAOYAN",2,1,1
12806,4093280032,QN,87-58 LEFFERTS BOULEVARD,01,B2,"87-58 LEFFERTS BOULEVARD, LLC",2,1,1
12807,4093290052,QN,119-05 89 AVENUE,01,B3,"MARTELL, VERA",3,2,1
12808,4094820050,QN,95-21 134 STREET,01,A1,JAIRAM LILAMATI,3,2,1
12809,4094890029,QN,101-50 123 STREET,01,B2,"TEJIRAM, RAMCHAND",2,1,1
12810,4095310062,QN,104-37 108 STREET,01,B2,"RAMGOBIN, TAVINDRA",2,1,1
12811,4095420006,QN,104-12 107 AVENUE,01,B2,"BUDHU, MAHENDRA",2,1,1
12812,4095920103,QN,104-18 133 STREET,01,B2,"PERSAUD , SHAWN, R, A",2,1,1
12813,4096110037,QN,131-11 109 AVENUE,01,B2,"RAGOO, LOCHAN P",3,2,1
12814,4096760054,QN,89-31 146 STREET,01,B3,KULDIP GOBIN,2,1,1
12815,4096880025,QN,88-33 146 STREET,04,S1,AINA HOLDINGS III LLC,2,1,1
12816,4097760025,QN,159-44 NORMAL ROAD,02,C0,"KHONDKER, SIRAJ",2,1,1
12817,4099040011,QN,90-05 182 PLACE,01,A1,"MEHEARWAN LALL, SHERRY",2,1,1
12818,4099330029,QN,185-20 HILLSIDE AVENUE,04,K4,AL B SHARIFF,2,1,1
12819,4099680074,QN,85-63 CHEVY CHASE STREET,01,A1,"REID, ROBERT",2,1,1
12820,4100470006,QN,145-14 105 AVENUE,01,B2,"RAMROOP, MUNESHWAR",2,1,1
12821,4100570125,QN,146-45 TUSKEGEE AIRMEN WAY,01,B2,"HOWLADER, MD MOSHARRAF H",2,1,1
12822,4101070142,QN,150-35 LIBERTY AVENUE,07,G9,"YARKIN, EDWARD",3,2,1
12823,4101400009,QN,107-20 GUY R BREWER BLVD,04,S3,"VINCENT-GRAHAM, JENELLE",2,1,1
12824,4101810018,QN,109-32 164 STREET,01,A1,"LENNARD, ROSEY",3,2,1
12825,4102560039,QN,108-33 172 STREET,01,A1,"JAMES, DENELLY",2,1,1
12826,4105010055,QN,188-11 PALO ALTO AVENUE,01,A1,"MALIK, RAHILA",3,2,1
12827,4105140018,QN,86-59 CLIO STREET,01,A3,"OKORONKWO, KANU D",2,1,1
12828,4107140019,QN,221-19 92 AVENUE,01,A1,MARCO MENDOZA,3,2,1
12829,4107580024,QN,224-15 92 AVENUE,01,A1,ANTHONY T CABAHUG,2,1,1
12830,4108120091,QN,222-34 96 AVENUE,06,F4,"PEABODY REAL ESTATE CO., INC",2,1,1
12831,4108200016,QN,91-31 191 STREET,08,M1,FIRST UNITED METHODIST CHURCH OF HOLLIS,2,1,1
12832,4109170011,QN,109-12 208 STREET,01,B3,MATOS LUIS R,2,1,1
12833,4109430216,QN,109-74 204 STREET,01,A1,"BLACKSTOCK, ANTOINETTE",2,1,1
12834,4109480098,QN,110-44 208 STREET,01,A1,FEDERAL NATIONAL MORTGAGE ASSOCIATION,2,1,1
12835,4109890113,QN,194-39 113 ROAD,01,A1,"RIVAS, MILKA A",2,1,1
12836,4110890030,QN,99-08 216 STREET,01,A1,"VERGARA, ALFONSO",2,1,1
12837,4111020013,QN,104-01 216 STREET,01,A1,"AJOKU, CHIJIOKE",2,1,1
12838,4111910078,QN,225-18 107 AVENUE,01,A1,"NOBLE, WILLA",2,1,1
12839,4112440001,QN,225-02 MURDOCK AVENUE,01,B9,"SINCLAIR, MERLENE",2,1,1
12840,4112940047,QN,115-20 231 STREET,01,A2,RAYMOND CLAUDIUS E,2,1,1
12841,4115440010,QN,149-05 CROSS BAY BOULEVARD,01,A1,"DEAN, KAREN",2,1,1
12842,4115970003,QN,116-08 109 AVENUE,01,B2,"ZHENG, YUN YING",2,1,1
12843,4116080063,QN,109-11 127 STREET,01,B2,E KRAKOWER,2,1,1
12844,4116560019,QN,114-34 131 STREET,01,A1,Catherine Watts Coleman,2,1,1
12845,4116870023,QN,116-32 LINCOLN STREET,01,B1,2344 NATIONAL LLC,2,1,1
12846,4117090008,QN,116-05 SUTTER AVENUE,01,A1,"SEEPERSAD, AMAR CHRIS",2,1,1
12847,4117850045,QN,133-20 127 STREET,01,B2,SINGH BALBIR,2,1,1
12848,4119350035,QN,143-33 GLASSBORO AVENUE,01,A5,"RAMUDIT, NADIRA",2,1,1
12849,4119380012,QN,145-24 LAKEWOOD AVENUE,01,B3,"NAVINS HOLDINGS, INC",2,1,1
12850,4119540006,QN,138-12 111 AVENUE,01,A1,MARYLAND TONEY,2,1,1
12851,4119600038,QN,111-02 145 STREET,01,A5,"CHAMBLE-BRIGGS, LORINE",2,1,1
12852,4119710039,QN,141-11 115 AVENUE,01,B2,"SINGH, JILLENE CHAMPA",2,1,1
12853,4119750029,QN,114-48 INWOOD STREET,01,A1,NYC HOUSING PRESERVATION AND DEVELOPMENT,2,1,1
12854,4120260050,QN,119-01 INWOOD STREET,01,A1,"PERSAUD, PRAMPATTIE",2,1,1
12855,4120280071,QN,119-37 147 STREET,01,A2,SUMINTRA BATCHOO,2,1,1
12856,4120630128,QN,126-13 145 STREET,01,B3,ROLAND MOHAMMED,2,1,1
12857,4121850025,QN,150-26 114 ROAD,01,A1,"DUARTE, MARIA",2,1,1
12858,4122130057,QN,154-12 119 AVENUE,01,A1,"LYSIUS, JACQUES",2,1,1
12859,4122160041,QN,150-39 122 STREET,01,A1,"RAMJANAM, SUNIEL",2,1,1
12860,4122590058,QN,129-40 155 STREET,01,B2,"GREEN, BERKELY",2,1,1
12861,4122830028,QN,132-48 159 STREET,01,B3,KATRINA BELVIN,2,1,1
12862,4122970001,QN,158-02 134 AVENUE,01,B3,"DUNSON, TAMIKO",2,1,1
12863,4123230025,QN,167-19 LINDEN BOULEVARD,01,A1,THEODORE PHILLIPS,2,1,1
12864,4123680056,QN,168-25 118 ROAD,01,A2,RACH 26 LLC,2,1,1
12865,4125170052,QN,172-57 126 AVENUE,01,B2,"JARRIN BERNAL, SEGUNDO ORLANDO",2,1,1
12866,4126040017,QN,118-24 190 STREET,01,B3,"MOORE, LINNETH",2,1,1
12867,4129490021,QN,241-07 132 AVENUE,01,A2,MOHAMED A. INSHANALLY,2,1,1
12868,4130300030,QN,216-02 137 AVENUE,08,M1,FIRST PRES CH OF SP G,2,1,1
12869,4130320014,QN,137-15 218 STREET,01,A9,"DHARRY, LEON",2,1,1
12870,4130530073,QN,141-54 184 STREET,01,B2,"ST LEWIS, ANN MARIE",2,1,1
12871,4131600055,QN,134-44 233 STREET,10,G0,"MACK, JR, RONALD",2,1,1
12872,4131670038,QN,135-08 233 STREET,01,A1,VERNAL HOLDER,2,1,1
12873,4132860016,QN,167-22 145 ROAD,01,B3,"KIIENAU, RONNIE",2,1,1
12874,4133120089,QN,177-21 145 ROAD,01,B2,"MCDONALD-EDWARDS, ANNETTE",2,1,1
12875,4134940040,QN,224-09 145 AVENUE,01,B3,"ORR, NICHOLAS ANTHONY",2,1,1
12876,4136780032,QN,149-29 257 STREET,01,B2,EDWARD CHMIELEWSKI,2,1,1
12877,4136890046,QN,259-77 149 AVENUE,01,B2,MAX CAPITAL INC,2,1,1
12878,4140060065,QN,85-12 159 AVENUE,01,A2,"CHICCOLA, NICHOLAS",2,1,1
12879,4155700021,QN,7-42 CORNAGA COURT,01,A1,"MANDELBAUM, ARON",2,1,1
12880,4158390001,QN,312 BEACH 48 STREET,01,B2,VISHNUDATT GOPAUL,3,2,1
12881,4160270034,QN,625 BEACH 66 STREET,01,A2,"JIMINEZ, BRODY",2,1,1
12882,4162310077,QN,176 BEACH 122 STREET,01,A1,"ELLIS, NOREEN",2,1,1
12883,4162700073,QN,2-46 BEACH 137 STREET,01,A1,"GOLDSTEIN, DAVID J",2,1,1
12884,4162960029,QN,447 BEACH 145 STREET,01,A1,"PICA, MELISSA",2,1,1
12885,5000230027,SI,80 CORSON AVENUE,01,B2,"80 CORSON AVENUE, LLC",2,1,1
12886,5000470012,SI,406 JERSEY STREET,08,M1,GOOD HOPE MISSIONARY CHURCH,2,1,1
12887,5000490084,SI,186 BEECHWOOD AVENUE,01,B2,SAUSE CHARLES S,2,1,1
12888,5000600123,SI,15 EADIE PLACE,01,A1,DENTON T MITCHELL,2,1,1
12889,5001150036,SI,52 OXFORD PLACE,01,B2,"PASIUK, LINDA J",2,1,1
12890,5002080014,SI,509 CARY AVENUE,01,B2,OSIVWERHO OKUMA,2,1,1
12891,5003470060,SI,218 FAIRVIEW AVENUE,01,A1,"KEENAN, SHAUN",2,1,1
12892,5004530019,SI,250 LIVERMORE AVENUE,01,A1,ANGELA RUSCIGNO,2,1,1
12893,5005190105,SI,42 SMITH TERRACE,01,A1,CHERYL ADOLPH GOBIN,2,1,1
12894,5005780016,SI,81 CEBRA AVENUE,01,A2,"SAMARASINGHE, NALEEN",2,1,1
12895,5005780026,SI,61 CEBRA AVENUE,01,A1,FAYE YU,2,1,1
12896,5005800161,SI,27 NATALIE COURT,01,B2,ADEBAMBO D. OLAJITAN,2,1,1
12897,5006000007,SI,109 GRAND AVENUE,01,A1,"BARQUERO, MARISOL",2,1,1
12898,5006180003,SI,842 VAN DUZER STREET,01,B2,CAVALLERI FRANK,2,1,1
12899,5006540045,SI,55 SCHOHARIE STREET,01,A1,"WANG, CHEAN CHUNG",2,1,1
12900,5007130025,SI,111 MOUNTAINVIEW AVENUE,01,A1,"BILOTTO, VIRGINIA M",2,1,1
12901,5007140139,SI,27 MELBA STREET,01,B2,J GILSHEN,2,1,1
12902,5007420037,SI,541 WOOLLEY AVENUE,01,A5,YIN TAT HO,2,1,1
12903,5007790032,SI,194 WARWICK AVENUE,01,B2,PATRICIA A DRISCOLL IRREVOCABLE TRUST,2,1,1
12904,5008150011,SI,184 LIVINGSTON AVENUE,01,A5,GIORDANO GREGORIO,2,1,1
12905,5010410061,SI,110 CORTLANDT STREET,01,A1,SANDRA NEVINS,2,1,1
12906,5010940017,SI,115 BLACKFORD AVENUE,01,B3,RICHARD EICOFFF AND T,2,1,1
12907,5011550170,SI,226 PULASKI AVENUE,04,S2,"FERRERI, JOSEPH",2,1,1
12908,5012150067,SI,144 VAN PELT AVENUE,01,B3,"SALAZAR, JAMES R",2,1,1
12909,5012237501,SI,367 UNION AVENUE,02,R3,MAPLE PARKWAY CONDOMINIUM,56,55,1
12910,5012260057,SI,130 UNION AVENUE,06,E9,"647-649 WASHINGTON AVE., LLC",3,2,1
12911,5012630079,SI,18 SOUTH AVENUE,01,B3,ARTHUR ULRICH,2,1,1
12912,5012770263,SI,100 MACORMAC PLACE,01,B3,"OUYANG, HUI",2,1,1
12913,5014370023,SI,95 RIEGELMANN STREET,01,A1,"SCHIANO, MICHAEL",2,1,1
12914,5015600015,SI,1641 RICHMOND AVENUE,08,M1,HOLY TINITY ST. NICHO,3,2,1
12915,5015800136,SI,32 JARDINE AVENUE,01,B9,FLORIO THOMAS,2,1,1
12916,5016960033,SI,444 VAN NAME AVENUE,01,A5,MANOJ AHUJA,2,1,1
12917,5019920061,SI,26 GREENWAY AVENUE,01,A1,"CHEUNG, ALEX KWAI HONG",2,1,1
12918,5027740022,SI,118 CANNON AVENUE,01,A2,"EDKINS, REGINA",2,1,1
12919,5028310033,SI,66 MARYLAND AVENUE,01,B2,RICHARD J HARKER,2,1,1
12920,5028390135,SI,49 TOWNSEND AVENUE,01,A1,"ZHOU, HUOYONG",2,1,1
12921,5028460257,SI,115 ST MARYS AVENUE,02,C0,MONZON ELIZABETH,3,2,1
12922,5028580103,SI,233 ANDERSON STREET,01,A5,"HUANG, HUANG SEN",2,1,1
12923,5028790095,SI,600 TARGEE STREET,01,B3,"CHANG , CHEN JU",2,1,1
12924,5028990021,SI,295 STEUBEN STREET,01,A1,CHRISTOPHER E GORDON,2,1,1
12925,5029080011,SI,436 HANOVER AVENUE,01,B2,CREEDMOOR STATE HOSPITAL,2,1,1
12926,5031010066,SI,40 HASTINGS STREET,01,A1,40 HASTINGS LLC.,2,1,1
12927,5031690003,SI,987 TARGEE STREET,01,A2,"LEE, TONY",2,1,1
12928,5031910148,SI,7 WILSON STREET,01,A2,THOMAS E GITTO,2,1,1
12929,5032540022,SI,260 KENSINGTON AVENUE,01,A5,"CIOFFI, PASQUALE",2,1,1
12930,5032720073,SI,326 MC CLEAN AVENUE,02,C3,ROBERT CHAMPI,2,1,1
12931,5033150066,SI,149 RARITAN AVENUE,01,A5,DONNA DEMARINIS,2,1,1
12932,5033950078,SI,38 APPLEBY AVENUE,01,B2,ROBERT LOBASCO,2,1,1
12933,5036510102,SI,309 DONGAN HILLS AVENUE,01,A1,"NELSON RAMOS, JR.",3,2,1
12934,5040410093,SI,32 WEED AVENUE,01,A5,WALTER JOSEPH BARNES,2,1,1
12935,5044210014,SI,315 AMBER STREET,01,A1,ZBIGNIEW KRYSIAK,2,1,1
12936,5045870001,SI,53 ELKHART STREET,01,A9,"CHI, YI MEI",2,1,1
12937,5046090040,SI,73 NAHANT STREET,01,A2,BARBARA LEPCZYNSKI,2,1,1
12938,5046457501,SI,50 TIMBER RIDGE DRIVE,02,R3,EVERGREEN PARK CONDO ASSN CORP,138,137,1
12939,5051410047,SI,275 HILLSIDE TERRACE,01,B2,UNAVAILABLE OWNER,2,1,1
12940,5052260118,SI,4218 AMBOY ROAD,04,O8,AMBOY ASSETS LLC,2,1,1
12941,5053100063,SI,102 GLOVER STREET,01,B2,DJTTSD INC,2,1,1
12942,5053150086,SI,67 ROBINSON AVENUE,01,B9,HAI BO WANG,2,1,1
12943,5053670016,SI,263 WOODS OF ARDEN ROAD,01,A1,"STELLATO, LISA",2,1,1
12944,5053780095,SI,4499 HYLAN BOULEVARD,01,A1,VICENTE A ABANILLA,2,1,1
12945,5053820020,SI,8 NOEL STREET,01,A2,"KNESKI, JENNIFER",2,1,1
12946,5056590044,SI,85 WOLCOTT AVENUE,01,A5,MICHELLE LOSCALZO,2,1,1
12947,5056680017,SI,267 SHOTWELL AVENUE,01,B9,MAURI JOHN,2,1,1
12948,5057350001,SI,419 WOODROW ROAD,08,M4,PRESENTATION SISTERS OF STATEN ISLAND,2,1,1
12949,5057760001,SI,375 ARDEN AVENUE,01,A1,"CHABAD OF THE SOUTH OF STATEN ISLAND, IN C.",2,1,1
12950,5061580030,SI,194 ALVERSON AVENUE,01,A1,"BARBIERI, THOMAS",2,1,1
12951,5062120063,SI,77 LORRAINE AVENUE,01,A1,ROBERT VOLPE,2,1,1
12952,5063610107,SI,95 RAVENNA STREET,01,A3,WEIBURG JANET I,2,1,1
12953,5065590136,SI,226 BILLIOU STREET,01,A2,CANEPA NICHOLAS,2,1,1
12954,5065830039,SI,1000 HUGUENOT AVENUE,01,B2,DALIP KARPUZI,2,1,1
12955,5068720062,SI,1760 CARLTON AVENUE,01,A1,"PAPRANIKU, BEKIM",2,1,1
12956,5069760024,SI,51 GOFF AVENUE,01,A1,Robert Black,2,1,1
12957,5070920061,SI,15 CRABTREE LANE,01,A5,DEBRA LUSTING,2,1,1
12958,5077860023,SI,223 BEDELL AVENUE,01,B2,CHRISTINA VITALE,2,1,1
12959,5078650011,SI,538 ROCKAWAY STREET,01,B2,"IPPOLITO, SARAH",2,1,1
12960,5078950025,SI,354 SLEIGHT AVENUE,01,A1,MISS L S EDELMAN,2,1,1
12961,5080030022,SI,5451 ARTHUR KILL ROAD,01,A1,"CONDOR, LUIS A",2,1,1
12962,1001500025,MN,104 DUANE STREET,08,Y1,FIRE DEPARTMENT OF NEW YORK,2,1,1
12963,1001937512,MN,66 WHITE STREET,05,RC,UNAVAILABLE OWNER,2,1,1
12964,1002240030,MN,458 GREENWICH STREET,04,S4,THE MOSKOWITZ CHILDREN IRREVOCABLE TRUST,2,1,1
12965,1004950029,MN,243 MULBERRY STREET,02,C6,243F MULBERRY ST HDFC,2,1,1
12966,1006080035,MN,106 WEST 13 STREET,04,C7,106 WEST 13TH STREET LLC,2,1,1
12967,1006090040,MN,523 AVENUE OF THE AMER,04,K4,100-106,2,1,1
12968,1006960020,MN,513 WEST 24 STREET,04,K4,513 WEST 24TH ASSOCIATES,2,1,1
12969,1008060006,MN,151 WEST 30 STREET,05,O6,"151 WEST 30TH STREET,",2,1,1
12970,1008920037,MN,163 EAST 36 STREET,04,D6,36 AND 37 REALTY LLC,4,3,1
12971,1008940047,MN,592 3 AVENUE,04,C7,592-594,2,1,1
12972,1010420062,MN,776 9 AVENUE,02,C4,"LAGS REALTY, LLC",2,1,1
12973,1011090005,MN,WEST 54 STREET,07,T2,NYC DEPARTMENT OF SMALL BUSINESS SERVICES,2,1,1
12974,1013990064,MN,120 EAST 65 STREET,01,B3,ERAIBA MONA,2,1,1
12975,1014697501,MN,401 EAST 74 STREET,04,RM,401 EAST 74TH ST OWNERS CORP,2,1,1
12976,1015440051,MN,1572 2 AVENUE,04,C7,KIMCO 1572 CORP.,2,1,1
12977,1015790015,MN,525 EAST 82 STREET,03,D4,525 EAST 82 OWNERS CORP,2,1,1
12978,1017340001,MN,522 LENOX AVENUE,08,I1,NYC HEALTH AND HOSPITALS CORPORATION,6,5,1
12979,1019010051,MN,138 WEST 117 ST,02,C4,NYC HOUSING PRESERVATION AND DEVELOPMENT,2,1,1
12980,1021060003,MN,2927 8 AVENUE,04,D7,NYC HOUSING AUTHORITY,9,8,1
12981,2025650069,BX,737 EAST 136 STREET,04,S1,737 EAST 136TH STREET LLC,2,1,1
12982,2026200029,BX,925 EAGLE AVENUE,02,C1,UNAVAILABLE OWNER,2,1,1
12983,2026680028,BX,794 EAST 163 STREET,04,S2,CHEONG DU REALTY LLC,2,1,1
12984,2027390015,BX,1201 LAFAYETTE AVENUE,05,O2,1201-31 LAFAYETTE GROUND OWNER LLC,3,2,1
12985,2029230014,BX,1840 BATHGATE AVENUE,02,C2,"VILOMAR, RAMON",3,2,1
12986,2031260008,BX,929 EAST TREMONT AVENUE,05,K1,KESHIA REALTY CORP,3,2,1
12987,2031440050,BX,2180 VALENTINE AVENUE,02,C0,SAMUEL L HAY,2,1,1
12988,2031990007,BX,2392 GRAND AVENUE,02,C1,2392 GRAND LLC,2,1,1
12989,2032570135,BX,3049 KINGSBRIDGE TERRACE,01,A1,"PUMA, MANUEL",2,1,1
12990,2032610026,BX,3110 BAILEY AVENUE,02,C1,G JT HOLDING CORP,2,1,1
12991,2032830032,BX,2742 MARION AVENUE,04,S1,"ARATO, LLC",3,2,1
12992,2033320030,BX,3080 HULL AVENUE,03,D1,K & H REALTY CORP.,2,1,1
12993,2033370052,BX,3311 ROCHAMBEAU AVENUE,05,O7,MONTEFIORE MEDICAL CENTER,2,1,1
12994,2033630023,BX,4200 VAN CORTLANDT PARK E,07,G5,VALCORTLANDT REALTY INC,2,1,1
12995,2033820032,BX,340 EAST 234 STREET,01,B3,PATRICK J FALVEY,2,1,1
12996,2033890005,BX,312 EAST 241 STREET,01,A1,EUGENE CLARKE,2,1,1
12997,2034690005,BX,1808 PATTERSON AVENUE,01,A5,"MATTHEWS, JOSE",2,1,1
12998,2036530022,BX,940 BOYNTON AVENUE,01,B3,ARNAU ENRIQUE,2,1,1
12999,2038290017,BX,2320 GLEASON AVENUE,01,B2,"CASUCCI, MICHAEL SR",2,1,1
13000,2039430205,BX,2000 EAST TREMONT AVENUE,10,G1,PARKCHESTER MANAGEMENT CORP,2,1,1
13001,2039990056,BX,1705 ST PETERS AVENUE,02,C0,D'ERASMO LOUIS,2,1,1
13002,2040680003,BX,1516 HONE AVENUE,01,B2,"ABREU, ANDRES R",2,1,1
13003,2041970025,BX,1815 PARKVIEW AVENUE,02,C0,"DE BARTOLO, HARRIET",2,1,1
13004,2042580046,BX,1947 HUNT AVENUE,01,B1,"THABET , OMAR",2,1,1
13005,2044780055,BX,2429 WOODHULL AVENUE,02,C0,"DANGELO, GIUSEPPE",2,1,1
13006,2046510012,BX,3728 WILLETT AVENUE,02,C0,"DEJESUS, GLORIA MRS.",2,1,1
13007,2046510085,BX,3719 WHITE PLAINS ROAD,01,B1,"CARBY, ANGELA",3,2,1
13008,2048250034,BX,649 EAST 223 STREET,02,C0,"GALLOWAY, JAMES",2,1,1
13009,2049700010,BX,4010 DYRE AVENUE,08,W9,CHILDREN'S FUND/ASTOR HM,2,1,1
13010,2049850182,BX,4011 HILL AVENUE,01,B1,UNAVAILABLE OWNER,2,1,1
13011,2051190040,BX,853 EAST 242 STREET,02,C0,GEORGE DAVIS,2,1,1
13012,2051340073,BX,2305 BOLLER AVENUE,01,B3,"OCASIO, ANTONIO",3,2,1
13013,2052630261,BX,2141 REEDS MILL LANE,01,A1,UNIQUE LIFE VENTURES LLC,2,1,1
13014,2053060072,BX,1121 REVERE AVENUE,01,B2,"ESPIRITUSANTO, GERVACIO",2,1,1
13015,2055150060,BX,3100 SAMPSON AVENUE,07,G9,EDGEWATER PARK OWNRSETC,7,6,1
13016,2055290447,BX,3087 ALAN PLACE,01,B3,W PERRETTI,2,1,1
13017,2057810992,BX,3901 FIELDSTON ROAD,08,W1,ETHICAL CULTURE FIELDSTON SCHOOLS,12,11,1
13018,2058441921,BX,248 WEST 256 STREET,01,A1,"ARDACHEV, OLEG",2,1,1
13019,2058700587,BX,5956 DELAFIELD AVENUE,01,B1,BABETTE FRIEDMAN LIVING TRUST,2,1,1
13020,2059200270,BX,710 WEST 246 STREET,01,A3,"SALZHAUER, MICHAEL",2,1,1
13021,3003490029,BK,552 HENRY STREET,04,S5,GARDENHILL REALTY LLC,2,1,1
13022,3005970007,BK,205 CONOVER STREET,02,C2,CONOVER CAPTAINS LLC,5,4,1
13023,3006810015,BK,182A 32 STREET,01,A5,"CHACKERIAN, MARK  P",2,1,1
13024,3007070012,BK,218 39 STREET,06,E1,QUALITY 62 REALTY INC.,2,1,1
13025,3007080011,BK,314 39 STREET,04,S3,"TAPIA , ELIES-ADRIAN",2,1,1
13026,3007860039,BK,4904 8 AVENUE,05,K1,"VJHC HOLDINGS, LLC",2,1,1
13027,3010030041,BK,237 9 STREET,04,S2,237 NINTH STREET LLC,2,1,1
13028,3012000072,BK,1231 PACIFIC STREET,08,M3,THE TRUSTEES OF THE ESTATE BELONGING TO  THE,2,1,1
13029,3012270067,BK,825 PROSPECT PLACE,01,A4,825 PROSPECT PL LLC,2,1,1
13030,3013000055,BK,741 MONTGOMERY STREET,01,B1,"741 MONTGOMERY , LLC",2,1,1
13031,3013480070,BK,1555 BERGEN STREET,10,G1,HOLLY NORTH ENTERPR/INC,2,1,1
13032,3014120016,BK,1494 CARROLL STREET,01,A5,YISROEL BONGART,2,1,1
13033,3015430058,BK,83 TRUXTON STREET,01,B3,"IDROVO, NESTOR B",2,1,1
13034,3017160059,BK,537 PARK AVENUE,04,K4,537 PARK LLC,3,2,1
13035,3019010019,BK,174 CLINTON AVENUE,02,C0,CLINTON 174 REALTY LLC,2,1,1
13036,3019030059,BK,123 WILLOUGHBY AVENUE,02,C2,KEATTS WINIFRED S,2,1,1
13037,3019300022,BK,287 CLINTON AVENUE,02,C2,LORI-LAINE ENTERPRISES LLC,2,1,1
13038,3019660008,BK,222 GREENE AVENUE,04,S2,222/2226 GREENE AVENUE REALTY LLC,2,1,1
13039,3023200019,BK,530 DRIGGS AVENUE,04,S4,"NORTHSIDE STUDIOS, I",3,2,1
13040,3023780021,BK,296 WYTHE,06,F5,WYTHE HOLDINGS LLC,2,1,1
13041,3024427501,BK,338 BERRY STREET,03,R4,UNAVAILABLE OWNER,2,1,1
13042,3025117501,BK,61 GREEN STREET,04,RM,WEST GREENPOINT LOFTS CONDOMINIUM,2,1,1
13043,3027250118,BK,457 GRAHAM AVENUE,02,C4,JULIA 455 LLC,3,2,1
13044,3027530037,BK,101 CONSELYEA STREET,02,C0,"DEFALCO, SABATO",2,1,1
13045,3029070006,BK,28 MASPETH AVENUE,01,B2,MARILYN TIRADO,2,1,1
13046,3030540009,BK,196 MESEROLE STREET,01,B9,JUAN CRUZ,2,1,1
13047,3031960149,BK,1059 WILLOUGHBY AVENUE,08,M9,"IGLESIA AMOR DE DIOS,",2,1,1
13048,3034340054,BK,113 COOPER STREET,01,B2,BARNES KURT,2,1,1
13049,3034880013,BK,35 SUNNYSIDE AVENUE,01,B1,"BRYAN, ABRAM",3,2,1
13050,3035100026,BK,2015 UNION STREET,01,B1,CARRIE GOODINE,2,1,1
13051,3035680022,BK,253 LEGION STREET,01,B1,MIGNON FRANCIS,2,1,1
13052,3035680049,BK,760 SARATOGA AVENUE,01,B1,"FAGAN, DENNIS",2,1,1
13053,3035980037,BK,412 AMBOY STREET,02,C0,KEVIN BAPTISTE,2,1,1
13054,3036230034,BK,102 LOTT AVENUE,02,C3,"ALLWOOD FAMILY TRUST BY MARJORIE ALLWOOD , TRUSTEE",2,1,1
13055,3038200032,BK,504 GEORGIA AVENUE,01,B1,"ISLAM, HEDAYET",2,1,1
13056,3038310038,BK,538 JUNIUS STREET,06,F5,HATOV 513 LLC,3,2,1
13057,3038370019,BK,551 ALABAMA AVENUE,01,B1,"MCPHERSON, NORVAL MR.",2,1,1
13058,3039160003,BK,33 HALE AVENUE,11,V0,QUEENSWAY BUILDERS LLC,2,1,1
13059,3040100026,BK,384 HENDRIX STREET,02,C0,"RODRIGUEZ, JUAN",2,1,1
13060,3040830145,BK,646 ESSEX STREET,01,A5,O BALY& A ROMERO,2,1,1
13061,3041370043,BK,244 LOGAN STREET,10,G1,233 NORWOOD AVE INC,2,1,1
13062,3041450023,BK,257R EUCLID AVENUE,06,E7,SP HHF SUB B LLC,2,1,1
13063,3041650040,BK,41 HILL STREET,01,A9,"MURILLO, SANTIAGO",2,1,1
13064,3041810025,BK,405 LINCOLN AVENUE,01,B3,"DOODNAUTH, TARAMATTIE",2,1,1
13065,3042440020,BK,2970 PITKIN AVENUE,01,B2,MOHAMMED UDDIN,3,2,1
13066,3042690011,BK,667 HEMLOCK STREET,02,C0,"DAVIS, ANTHONY",2,1,1
13067,3042940120,BK,657 WILLIAMS AVENUE,01,A5,"BRISTOL, BERNADETTE",2,1,1
13068,3044530072,BK,687 SHEPHERD AVENUE,01,B2,"BENJAMIN, DENNY",2,1,1
13069,3047320015,BK,582 EAST 48 STREET,01,A1,LINDA J. TURNER,2,1,1
13070,3047820118,BK,918 EAST 48 STREET,01,B3,"MERRIN, KEITH",2,1,1
13071,3047860005,BK,4718 FARRAGUT ROAD,08,W3,DAVCO REALTY LLC,3,2,1
13072,3048900003,BK,3610 CHURCH AVENUE,10,G0,"CASTILLO, MARIE",2,1,1
13073,3049510017,BK,498 EAST 35 STREET,04,S1,"EVANS, DANE",2,1,1
13074,3052730070,BK,13 EAST 4 STREET,01,A9,"RUZAL, HAL M",2,1,1
13075,3053310015,BK,396 CONEY ISLAND AVENUE,07,G3,"BLUE HILLS FUELS, LLC",2,1,1
13076,3054020054,BK,601 EAST 8 STREET,01,A1,"RUSSEN, COLETTE",2,1,1
13077,3054030051,BK,547 EAST 9 STREET,01,B2,"AKHTER, MOHAMMAD J",2,1,1
13078,3054440049,BK,1757 48 STREET,01,A9,KOVALENKO LEON,2,1,1
13079,3054450053,BK,1865 48 STREET,01,B1,"LEFKOWITZ, ARON",2,1,1
13080,3054540014,BK,1610 49 STREET,01,B2,"WELDLER, HANNAH",2,1,1
13081,3054780024,BK,1634 53 STREET,01,B2,"WERCZBERGER, BEN S",2,1,1
13082,3054930006,BK,5607 17 AVENUE,01,B1,"OUTEIRAL, ANTHONY R",2,1,1
13083,3054940036,BK,1818 55 STREET,02,C0,"MAYTELES, BENJAMIN",2,1,1
13084,3054980067,BK,1737 58 STREET,01,B1,GOLDNER HANNAH,2,1,1
13085,3055070032,BK,2066 58 STREET,01,B3,"KRAUSZ, CHANY",2,1,1
13086,3056380058,BK,949 50 STREET,01,B3,SCHWARTZ JOSEPH,2,1,1
13087,3056440015,BK,820 50 STREET,02,C0,"LIU, AS TRUSTEE, KRIS",2,1,1
13088,3056610064,BK,1123 53 STREET,01,B1,"GREENFELD, SHIE W",2,1,1
13089,3056770011,BK,1312 54 STREET,02,C0,ELEVEN ROSES CORP,2,1,1
13090,3056810019,BK,1044 55 STREET,02,C0,"FISH, ABRAHAM",2,1,1
13091,3056970005,BK,5713 12 AVENUE,08,M9,CONGREGATION PANIM MEIROTH,2,1,1
13092,3057110058,BK,1241 60 STREET,01,B1,"CHARNOVESKY, MARYELLEN",3,2,1
13093,3057620006,BK,6611 14 AVENUE,02,C0,"FU, CHAK SUM",2,1,1
13094,3057660072,BK,1133 68 STREET,02,C0,HOK TAK WONG,2,1,1
13095,3058560083,BK,511 SENATOR STREET,01,A5,"ZHU, YAN YUN",2,1,1
13096,3058990072,BK,631 72 STREET,01,B2,"CAI, YI MIN",2,1,1
13097,3059630028,BK,654 77 STREET,01,A5,"CAO, YI GENG",2,1,1
13098,3060390036,BK,1072 85 STREET,01,B1,BRIAN FRANCIS MCMURRER,2,1,1
13099,3060440074,BK,311 87 STREET,02,C3,KAPNISAKIS JOHN,2,1,1
13100,3060500019,BK,436 87 STREET,04,K4,C21 BK HOME LLC,2,1,1
13101,3060810016,BK,326 90 STREET,01,B2,"PANDEL, GUS",2,1,1
13102,3061150052,BK,119 95 STREET,01,A1,MARYANNE RUGGIERO-DELITURRI,3,2,1
13103,3061430001,BK,9216 7 AVENUE,08,W3,POLY PREP CTRY DAY SC,10,9,1
13104,3061620001,BK,6919 19 AVENUE,01,B2,"BRAUNSTEIN, JACOB",3,2,1
13105,3062460046,BK,1573 78 STREET,01,B3,"LI, TIM BOCHAO",2,1,1
13106,3062530021,BK,1626 STILLWELL AVENUE,07,G5,"SUKHI REALTY, LLC",2,1,1
13107,3062840073,BK,1725 81 STREET,01,B2,"MA, HAI HUI",2,1,1
13108,3064110001,BK,2061 BATH AVENUE,07,G5,IONICA MOTORS REAL ESTATE CORP,2,1,1
13109,3065110024,BK,842 EAST 9 STREET,01,A1,HH REALTY EQUITIES LLC,2,1,1
13110,3065110057,BK,893 EAST 8 STREET,01,A3,ADES ESTHER,2,1,1
13111,3065140039,BK,1074 EAST 2 STREET,01,A1,"GRUBERGER, NAFTALI",2,1,1
13112,3065210037,BK,976 EAST 9 STREET,01,A3,SARAH C MIZRAHI,2,1,1
13113,3065340063,BK,1171 EAST 8 STREET,01,B2,"PENNA, JASON",2,1,1
13114,3065460070,BK,1239 EAST 10 STREET,01,A1,"SCHREIBER, YOSSIE",2,1,1
13115,3065650048,BK,217 AVENUE N,01,B2,CHALOUH  SALIM,2,1,1
13116,3065700022,BK,1338 EAST 8 STREET,01,B2,"COHEN, DORON",2,1,1
13117,3065700024,BK,1344 EAST 8 STREET,01,B1,"CALVO, AUDREY",2,1,1
13118,3065710050,BK,807 AVENUE N,01,B2,ABRAHAM CHURBA,2,1,1
13119,3065880008,BK,618 AVENUE N,01,B2,"BETESH, MORRIS",2,1,1
13120,3065880028,BK,1532 EAST 7 STREET,01,A3,FRIJA FAMILY TRUST,2,1,1
13121,3065890022,BK,1432 EAST 8 STREET,01,A1,EZRA ERANI,2,1,1
13122,3066017502,BK,140 AVENUE O,02,R3,UNAVAILABLE OWNER,2,1,1
13123,3066080041,BK,1646 EAST 2 STREET,02,C3,VICKY WING KEI LEE AS TRUSTEE,2,1,1
13124,3066090075,BK,1611 EAST 2 STREET,01,B1,"1611 ASSOCIATES, LLC",2,1,1
13125,3066100078,BK,1639 EAST 3 STREET,01,B2,"SULTAN, MARC",2,1,1
13126,3066120013,BK,1524 OCEAN PARKWAY,01,B1,"COHEN, DAVID",2,1,1
13127,3066130045,BK,1670 EAST 7 STREET,01,B1,MARGARET TAWIL,2,1,1
13128,3066150040,BK,1580 EAST 9 STREET,01,B2,"GADEH, MARK",2,1,1
13129,3066620055,BK,1809 EAST 5 STREET,01,A3,1809 E 5 LLC,2,1,1
13130,3066960032,BK,862 EAST 13 STREET,01,A1,"LANDMAN, JOSHUA H",2,1,1
13131,3067210033,BK,1053 EAST 19 STREET,01,A1,"BROWN, ESTHER",2,1,1
13132,3067420045,BK,1317 AVENUE N,01,B2,"CHURBA, RAHAMIN",2,1,1
13133,3067590001,BK,1202 AVENUE O,08,M1,ST BRENDANS R C CHURCH,3,2,1
13134,3068290050,BK,2301 AVENUE S,01,A1,"HABER , JACK",2,1,1
13135,3068860018,BK,25 BAY 46 STREET,01,B1,"LEE, KAI WAH",2,1,1
13136,3069600013,BK,3844 MAPLE AVENUE,01,B3,SAMUEL ISAAC,2,1,1
13137,3069750018,BK,3908 LAUREL AVENUE,02,C0,BERKOVITS RACHEL,2,1,1
13138,3070030047,BK,3717 NAUTILUS AVENUE,01,A1,"BYVALETS, OLENA",2,1,1
13139,3071050065,BK,430 AVENUE T,01,A3,430 AVE T LLC,2,1,1
13140,3071330022,BK,2190 EAST 7 STREET,01,B2,"KASSAB, NISSIM",2,1,1
13141,3071520047,BK,351 AVENUE W,01,B1,"SAKKAL , CHILA",2,1,1
13142,3072930062,BK,1961 EAST 14 STREET,01,B2,ALLEN SAKA,2,1,1
13143,3073070011,BK,1914 EAST 29 STREET,01,A1,"LIN, IRENE",2,1,1
13144,3073540055,BK,2229 EAST 21 STREET,01,A1,"CHONG, ALVIN",2,1,1
13145,3073660030,BK,2158 FORD STREET,01,A5,"HO, SIU WA",2,1,1
13146,3073810166,BK,2295 EAST 21 STREET,01,B3,SIMAKHOV ERNST,2,1,1
13147,3074160067,BK,2435 EAST 14 STREET,02,C0,"HARRIGAN, CAROL",2,1,1
13148,3074447501,BK,2526 EAST 29 STREET,02,R3,UNAVAILABLE OWNER,2,1,1
13149,3074600096,BK,2619 EAST 16 STREET,08,W8,ELIJAH REALTY LLC,2,1,1
13150,3075660003,BK,2015 AVENUE I,08,W2,MASORES BAIS YAAKOV,2,1,1
13151,3075680072,BK,858 EAST 23 STREET,01,B2,GRONER  AARON,2,1,1
13152,3075900039,BK,913 EAST 26 STREET,01,B2,FRIEDMAN GOLDIE,2,1,1
13153,3075950015,BK,969 EAST 31 STREET,01,A9,"COHEN, MOSHE",2,1,1
13154,3076090019,BK,1065 EAST 27 STREET,01,A3,"ROSENFELD, CHAIM Y",2,1,1
13155,3076090046,BK,2716 AVENUE J,01,A1,ZILBERBERG MARTIN,2,1,1
13156,3076260046,BK,2616 AVENUE K,01,A1,"SAYEGH, SOLOMON",2,1,1
13157,3076270021,BK,1157 EAST 27 STREET,01,A1,EGERT YECHESKEL,2,1,1
13158,3076470014,BK,1275 EAST 29 STREET,01,A1,"GLATTER, ATARA",2,1,1
13159,3076880026,BK,1543 EAST 27 STREET,01,A1,"KOPOLOVICH, ABE",2,1,1
13160,3077040057,BK,1644 EAST 32 STREET,01,B1,"ELKUS, BENJAMIN B",2,1,1
13161,3077120053,BK,1762 MARINE PARKWAY,01,A1,JOHN S DAVIS,3,2,1
13162,3077710071,BK,4558 KINGS HIGHWAY,01,A1,"BRYAN, LEONIE FRANCIS",2,1,1
13163,3077970052,BK, UTICA AVENUE,07,U4,FCF REALTY HOLDING CO,2,1,1
13164,3078640008,BK,4005 QUENTIN ROAD,01,A1,"AUFRICHTIG, JONATHAN",2,1,1
13165,3079010076,BK,1474 EAST 57 STREET,01,A2,VICTOR LUGO,2,1,1
13166,3080240024,BK,941 EAST 87 STREET,01,B3,"ACEVEDO, JAMES",2,1,1
13167,3080680060,BK,1516 REMSEN AVENUE,01,B2,"DIOP, LORICE JOAN",2,1,1
13168,3081270083,BK,911 EAST 94 STREET,01,A1,"CHEVRY, RICHARD",2,1,1
13169,3084040038,BK,6106 AVENUE T,01,A1,"GABER, HANY",2,1,1
13170,3084740019,BK,1843 MARINE PARKWAY,01,A1,"RUGGIERO, FRANK",2,1,1
13171,3085370074,BK,2176 EAST 38 STREET,01,B2,"YUEN, WENDY WAI PING",3,2,1
13172,3086670728,BK,2966 BRIGHTON 8 STREET,01,B1,RAMESHWAR ALGOO,2,1,1
13173,3086690089,BK,2995 OCEAN PARKWAY,04,O8,RICH OCEAN LLC,2,1,1
13174,3087240202,BK,265 CORBIN PLACE,01,B1,"CHERNYAKHOVSKY, BIANA",2,1,1
13175,3087360018,BK,172 EXETER STREET,01,A1,"SIROCHINSKY, YAROSLAV",2,1,1
13176,3087410022,BK,250 DOVER STREET,01,A1,ZALCMAN IRA,2,1,1
13177,4002010049,QN,48-28 42 STREET,01,A5,"CHAYASUB, SUKANYA",2,1,1
13178,4003870037,QN,25-11 39 AVENUE,01,B9,V ANSIVELLI,2,1,1
13179,4003970028,QN,39-30 28 STREET,01,B9,DUTCH KILLS FARM LLC,2,1,1
13180,4005320022,QN,31-27 14 STREET,01,B1,31-27 14 STREET REALTY LLC,2,1,1
13181,4005700048,QN,30-80 CRESCENT STREET,01,B3,"ANTON, HARICLIA",2,1,1
13182,4005830017,QN,34-27 CRESCENT STREET,01,B3,"OSMANAJ, ANJETA",2,1,1
13183,4006390041,QN,35-40 36 STREET,05,O2,DAG,3,2,1
13184,4006570057,QN,31-40 38 STREET,02,C0,RUPCHAND  PHULMATIE,2,1,1
13185,4007160080,QN,25-90 46 STREET,02,C0,ANGELO LONGO,2,1,1
13186,4007240028,QN,31-68 47 STREET,01,B2,31-68 47 STREET LLC,2,1,1
13187,4009690048,QN,21-35 73 STREET,01,A1,"DEL CARRO PADOVAN, TRUSTEE, DANIELA",2,1,1
13188,4009700029,QN,21-50 75 STREET,02,C0,"PEFANIS, MARIETTA",2,1,1
13189,4010910024,QN,23-38 98 STREET,01,B3,NORYS REYES,2,1,1
13190,4011710030,QN,32-50 76 STREET,02,C0,"RODRIGUEZ, RICHARD",2,1,1
13191,4012230034,QN,38-11 65 STREET,06,E9,38-11 65TH STREET REALTY CORP,2,1,1
13192,4012520001,QN,33-34 80 STREET,08,W1,NYC DEPARTMENT OF EDUCATION,2,1,1
13193,4012820118,QN,70-28 BROADWAY,01,B3,"CAMACHO, FEDERICO",2,1,1
13194,4013520021,QN,70-64 45 AVENUE,01,B2,CLAUDIO JIMBO,2,1,1
13195,4013540026,QN,72-38 43 AVENUE,10,G0,"RBLENDERS, LLC",2,1,1
13196,4013660075,QN,26-31 92 STREET,01,B2,"ANGULO, JUANITA",2,1,1
13197,4014120034,QN,32-52 83 STREET,01,B1,"WU, CHUN XIU",2,1,1
13198,4014140006,QN,32-02 85 STREET,01,B3,"SOLORZANO, JHENNY",2,1,1
13199,4015520021,QN,40-50 CASE STREET,02,C3,SOLIDTEK USA CORP.,2,1,1
13200,4015550043,QN,41-85 GLEANE STREET,02,C0,"ZHANG,  XIONG QIANG",2,1,1
13201,4015800041,QN,86-15 DONGAN AVENUE,03,D4,DONGAN APARTMENT CORPORATION,2,1,1
13202,4015890106,QN,94-15 40 ROAD,02,C0,BLANCA B. DUTAN,2,1,1
13203,4016450013,QN,24-18 ERICSSON STREET,01,A1,EXPERT HOME BUYERS LLC,2,1,1
13204,4016510047,QN,25-39 MCINTOSH STREET,01,A5,PENA FREDDY,2,1,1
13205,4016920040,QN,31-25 105 STREET,01,B1,"MUNIZ, NARCISA",2,1,1
13206,4017490055,QN,107-01 37 AVENUE,04,S9,"RODRIGUEZ, ROSA",2,1,1
13207,4018200108,QN,126-16 NORTHERN BL SR SOUTH,07,G2,JYB 126 LLC,3,2,1
13208,4018940009,QN,94-30 54 AVENUE,01,B3,"DACO, AVELINDA B",2,1,1
13209,4019390045,QN,55-04 102 STREET,01,B9,"132-43,LLC",2,1,1
13210,4019500061,QN,57-44 GRANGER STREET,01,B3,57-44 GRANGER STREET LLC,2,1,1
13211,4021270018,QN,102-17 64 ROAD,03,D4,64TH APARTMENT CORP,3,2,1
13212,4021510152,QN,105-23 65 ROAD,04,D7,FR DEVELOPMENT LLC,2,1,1
13213,4022310024,QN,110-34 JEWEL AVENUE,01,A1,"BERNSTEIN, STEVEN J",2,1,1
13214,4023670027,QN,53-51 61 STREET,01,A9,ROBERT N SALVESON,2,1,1
13215,4023990080,QN,66-04 54 AVENUE,01,B2,"SHEEHAN, EDWARD",2,1,1
13216,4024130025,QN,66-18 51 ROAD,01,B1,"QU, HAISHENG",2,1,1
13217,4024760011,QN,51-11 GOLDSMITH STREET,01,B1,168 ASTORIA LLC,2,1,1
13218,4026310007,QN,59-19 56 STREET,01,B2,SUAREZ JUAN,2,1,1
13219,4026540042,QN,59-18 59 ROAD,01,A1,"PARKE, PATRICK G",2,1,1
13220,4027280020,QN,60-24 59 AVENUE,01,B2,"BECKER, MARY ANN",2,1,1
13221,4027350024,QN,60-21 60 PLACE,01,B1,"MCBRIDGE, JOHN",2,1,1
13222,4027550005,QN,62-33 59 DRIVE,01,A5,"GUBICZA, FERENC",2,1,1
13223,4031170050,QN,62-24 ELLWELL CRESCENT,04,S1,"NASIMOVA, YELIZAVETA",2,1,1
13224,4033040065,QN,9 MARKWOOD PLACE,01,A3,"ESHAGHIAN, MAHROKH",2,1,1
13225,4033550124,QN,83-34 TALBOT STREET,02,C0,JOHNNY C YEH,2,1,1
13226,4035010032,QN,59-48 MADISON STREET,02,C0,KJ REALTY PARTNERS INC.,2,1,1
13227,4035390048,QN,10-34 WYCKOFF AVENUE,04,K4,WYCKOFF COVERT LLC,2,1,1
13228,4036020029,QN,65-15 ADMIRAL AVENUE,01,A5,"GRASSO, DAWN",2,1,1
13229,4037020020,QN,67-38 MYRTLE AVENUE,04,S2,COMMUNITY CAPITAL CO,2,1,1
13230,4037230037,QN,78-44 65 STREET,01,B3,LEISTMAN DIANE,2,1,1
13231,4037700011,QN,73-06 METROPOLITAN AVENUE,05,K2,73-06 METRO LLC,3,2,1
13232,4037970009,QN,69-09 78 STREET,01,A1,"LAM, WEI MAN",2,1,1
13233,4038250012,QN,78-14 76 STREET,01,A9,"PRESTIPINO, CAMILLEARENARE",2,1,1
13234,4038290020,QN,78-40 79 LANE,01,A9,"DUCEY, COLLEEN",2,1,1
13235,4040000125,QN,13-06 125 STREET,01,B1,"CHOI, DONG HO",2,1,1
13236,4042010014,QN,22-17 125 STREET,01,B1,"CAI , ANNA",2,1,1
13237,4042660035,QN,25-48 126 STREET,01,B1,LING ZHANG,2,1,1
13238,4043160035,QN,119-11 29 AVENUE,07,G2,KARAYANIS GEORGE & JOHN,2,1,1
13239,4045310400,QN,10 AVENUE,09,Q8,BEECHHURST YACHT CLUB,2,1,1
13240,4047010031,QN,16-22 CLINTONVILLE STREET,08,M1,ST LUKES R C CHURCH,4,3,1
13241,4047090070,QN,151-48 21 AVENUE,01,A1,"BARRETTA, ANTHONY",2,1,1
13242,4048520056,QN,156-05 29 AVENUE,01,A2,"SHUL, SUUNG",2,1,1
13243,4049380001,QN,29-16 FRANCIS LEWIS BLVD,07,G4,"BLUE HILLS FUELS, LLC",2,1,1
13244,4050020042,QN,139-50 35 AVENUE,03,D4,NB OWNERS CORP C/O METRO MANAGEMENTDEVEL OPMENT INC,3,2,1
13245,4054160069,QN,43-62 159 STREET,01,B1,"WU, FEIPING",2,1,1
13246,4054410047,QN,45-12 163 STREET,01,B3,"LIN, GUO HUA",2,1,1
13247,4055210026,QN,44-02 FRANCIS LEWIS BLVD,05,O2,"196-58 44TH AVENUE ASSOCIATES, LLC",2,1,1
13248,4055230015,QN,200-20 44 AVENUE,05,O7,BAYSIDE REALTY LLC,2,1,1
13249,4055840021,QN,171-42 BAGLEY AVENUE,01,A1,"HE, LINGJIE",2,1,1
13250,4056700024,QN,56-40 185 STREET,01,B3,WANG LAN FANG,2,1,1
13251,4058000008,QN,201-08 23 AVENUE,01,A2,BULENT PEKTAS,2,1,1
13252,4060110033,QN,28-30 212 STREET,01,A3,LAWRENCE W LUE,2,1,1
13253,4062480006,QN,39-11 215 PLACE,01,B1,"ZHU, XIAO GUANG",2,1,1
13254,4063900010,QN,62-28 136 STREET,01,B3,"BONG, WAI LOON",2,1,1
13255,4069000127,QN,61-15 172 STREET,01,B1,KOKIASMENOS GEORGE,2,1,1
13256,4072310120,QN,181-19 KILDARE ROAD,01,A3,"BADALOV, ILYA",2,1,1
13257,4074420001,QN,213-01 58 AVENUE,08,M1,ST ROBERT BELLARMINE R C,5,4,1
13258,4075020011,QN,50-35 CLOVERDALE BOULEVARD,08,M1,JEWISH CNTR OF BAYSID,2,1,1
13259,4075310074,QN,223-11 56 ROAD,01,B2,"CHEN, YU",2,1,1
13260,4083500063,QN,58-33 254 STREET,01,B1,"HUANG, XIAO YUN",2,1,1
13261,4085100031,QN,75-20 255 STREET,02,C6,GLEN OAKS VILLAGE OWNERS INC,51,50,1
13262,4085830057,QN,82-45 251 STREET,01,A5,"HOFFMAN, JAMES",2,1,1
13263,4088300076,QN,87-83 LITTLE NECK PARKWAY,01,B2,"CRUPI, JOSEPH PETER",2,1,1
13264,4088940095,QN,88-43 ELDERT LANE,02,C0,CASTRO FELIX,2,1,1
13265,4089190001,QN,80-10 JAMAICA AVENUE,04,K4,80-10 JAMAICA AVENUE CORP,2,1,1
13266,4089580008,QN,78-30 90 AVENUE,01,B2,"FULO, LORENZO A",3,2,1
13267,4090850035,QN,84-07 102 ROAD,02,C0,"WU, YI",2,1,1
13268,4091000051,QN,101-47 93 STREET,01,B2,"RAMKISSOON, REYNOLD",3,2,1
13269,4091790006,QN,101-10 85 ROAD,01,B3,"ANDRUELA, PHILIP",2,1,1
13270,4092260047,QN,86-17 112 STREET,01,A1,"LI, VICKI",2,1,1
13271,4092320020,QN,84-22 117 STREET,01,A1,"LEVY, STUART A",2,1,1
13272,4092340023,QN,84-34 LEFFERTS BOULEVARD,01,A1,SHMUEL Y GUTFREUND,2,1,1
13273,4092370016,QN,84-30 122 STREET,01,B2,"FIREWORKER, EZRA",2,1,1
13274,4093490001,QN,117-04 91 AVENUE,02,C0,"MAHIL, MANJIT SINGH",2,1,1
13275,4093640001,QN,90-28 VAN WYCK EXPRESSWAY,08,I6,MEDISYS HEALTH NETWORK INC.,2,1,1
13276,4093780012,QN,95-22 101 STREET,01,B3,DELFINO AGUILAR,2,1,1
13277,4093900025,QN,106-03 97 AVENUE,01,B2,"KHAIRALLAH, CAROL",2,1,1
13278,4094610042,QN,97-15 121 STREET,01,B3,"SINGH, DALJIT",2,1,1
13279,4094810023,QN,133-07 101 AVENUE,01,B2,HOOSEIN RAYMAN,2,1,1
13280,4094940014,QN,127-30 101 AVENUE,02,C3,"PERSAUD, NARINDRA",2,1,1
13281,4095040027,QN,103-59 100 STREET,10,G1,"BAKHSH, MONICA OWATTIE",2,1,1
13282,4095310021,QN,104-36 109 STREET,01,A9,"TAGGAR, MOTILAL",2,1,1
13283,4095440013,QN,107-14 107 STREET,01,A1,RODRIGUEZ ISMENIA,2,1,1
13284,4095610006,QN,124-12 103 AVENUE,01,B1,"PMANGRA, PR   SH",2,1,1
13285,4095880018,QN,103-28 135 STREET,01,B3,SYLVIA BROOKS,2,1,1
13286,4095910032,QN,105-31 131 STREET,01,A1,MANGAL  VEDWATTIE,2,1,1
13287,4095910051,QN,105-07 131 STREET,02,C5,"DEUTSCHE BANK NATIONAL TRUST COMPANY, AS  TRUSTEE O",2,1,1
13288,4097360106,QN,84-67 DANIELS STREET,02,C0,"LI, XIU ZHEN",2,1,1
13289,4098100021,QN,172-25 91 AVENUE,02,C0,UNAVAILABLE OWNER,2,1,1
13290,4099060021,QN,90-30 185 STREET,01,B2,"PHAGGOO, SONNY",2,1,1
13291,4099160024,QN,88-17 180 STREET,01,B3,"BEGUM, ROKEYA",2,1,1
13292,4099220039,QN,89-20 183 STREET,01,A1,"SOOKRAM, ROBERT",2,1,1
13293,4099450087,QN,86-37 MIDLAND PARKWAY,01,A3,HCN VENTURE LLC,2,1,1
13294,4100210011,QN,143-17 102 AVENUE,01,B2,HITLALL  HITLALL,2,1,1
13295,4100440003,QN,144-10 105 AVENUE,01,B2,RUTH NAGGLES,2,1,1
13296,4101420066,QN,153-15 109 AVENUE,01,B3,"ESTERINE, ALAN",2,1,1
13297,4102330192,QN,173-32 103 ROAD,01,A1,"SADEEK, SHERIDAN",2,1,1
13298,4102590119,QN,108-07 175 STREET,01,B2,"BERTRAND, JOSETTE F",2,1,1
13299,4103660051,QN,187-17 104 AVENUE,01,B3,"WILLIAMS-LAMPART, NADIEN D",2,1,1
13300,4104660016,QN,91-09 197 STREET,01,B2,"RAJINDRANAUTH, UMESH",2,1,1
13301,4104780035,QN,93-22 205 STREET,01,A1,"RUPCHAND , RUDRA R",2,1,1
13302,4104810076,QN,90-36 199 STREET,01,B3,"DHANRAJ, ESARDAI",3,2,1
13303,4105450087,QN,94-29 211 STREET,01,B3,"CRUZ, VICTOR",2,1,1
13304,4105780033,QN,89-76 212 STREET,01,A1,AMBROSE CAROLINE,2,1,1
13305,4106100026,QN,94-80 218 STREET,02,C0,AMIR MELATPARAST,2,1,1
13306,4106400013,QN,91-18 215 PLACE,01,A1,"SZTUCZKO, IRENE",2,1,1
13307,4109020037,QN,202-01 109 AVENUE,01,B9,SOPHIA K FRANKLIN,2,1,1
13308,4109780019,QN,112-09 202 STREET,01,A1,"WALLACE, FIONA",2,1,1
13309,4110210064,QN,114-48 205 STREET,01,A9,"BRUNO, GLORIA",2,1,1
13310,4110350036,QN,115-38 196 STREET,01,A1,LUIS MEADE,2,1,1
13311,4111010018,QN,106-05 215 STREET,01,A1,"OGBUJI, ELIZABETH",3,2,1
13312,4111200025,QN,109-11 217 STREET,01,A1,"KERNIZAN, JOSETTE",2,1,1
13313,4111680059,QN,221-19 105 AVENUE,01,A1,"JEAN, CALY",2,1,1
13314,4111900019,QN,223-28 108 AVENUE,01,A2,HYA MANAGEMENT INC.,2,1,1
13315,4117020026,QN,135-20 120 AVENUE,01,B2,THEODORE KENNETH,2,1,1
13316,4117050043,QN,114-38 114 STREET,01,A1,"NARINE, HEMCHAND",2,1,1
13317,4117830022,QN,133-27 124 STREET,01,B2,DABYDEEN  KALYAN,2,1,1
13318,4119270021,QN,109-29 141 STREET,01,B3,ALFRED NEALS,2,1,1
13319,4119430017,QN,146-03 111 AVENUE,01,A1,"KNIGHTS, CLAUDETTE",2,1,1
13320,4119470176,QN,147-59 109 AVENUE,01,B3,PAUL W. MESSAM,2,1,1
13321,4119600040,QN,111-04 145 STREET,01,B3,"CHAMBLE-BRIGGS, LORINE",2,1,1
13322,4119900018,QN,115-50 146 STREET,01,A1,"ROBINSON, SHEILA",2,1,1
13323,4120140082,QN,117-64 142 PLACE,01,B2,"MOROCHO, CARLOS E",2,1,1
13324,4120170014,QN,117-18 144 STREET,01,A1,"SHEIKH, QASIM G",2,1,1
13325,4120440167,QN,146-12 120 AVENUE,01,B2,DENNIS THOMAS,2,1,1
13326,4121080004,QN,128-31 149 STREET,01,A1,"FARLEY, RAYMOND J.",2,1,1
13327,4121470037,QN,109-32 157 STREET,01,B2,"HOSSEN, SHAMIMA",2,1,1
13328,4122040266,QN,153-29 118 AVENUE,01,A9,"BONNAIRE, RODRIGUE",2,1,1
13329,4122090163,QN,118-52 155 STREET,01,A9,CLINTON GRAHAM,2,1,1
13330,4122200005,QN,121-11 153 STREET,01,A2,"DALTON, CARLINE M",2,1,1
13331,4122250065,QN,155-25 116 DRIVE,01,A1,"FOSKEY , ZENA",2,1,1
13332,4122530008,QN,121-05 LONG STREET,01,A1,"REECE, KESTER",2,1,1
13333,4123260046,QN,169-01 LINDEN BOULEVARD,01,B3,"ROBERTS , RONALD B",2,1,1
13334,4123720212,QN,170-22 118 ROAD,01,B3,"BOXILL, YVONNE",2,1,1
13335,4125730019,QN,167-10 137 AVENUE,08,M1,"MT. PISGAH BAPTIST CHURCH, INC.",2,1,1
13336,4125980015,QN,172-06 144 ROAD,01,B3,"PETGRAVE, COURTNEY",2,1,1
13337,4126320030,QN,118-49 202 STREET,01,B3,"FAROOQUI, ZAHID K",2,1,1
13338,4126320061,QN,118-06 203 STREET,01,A1,"DEVINS, CASANDRA K",2,1,1
13339,4126960053,QN,131-07 MERRICK BOULEVARD,07,G4,CHEEMA GURPAL,2,1,1
13340,4129330072,QN,131-46 224 STREET,01,A2,"PHILLIPS, ANSLEM",2,1,1
13341,4130410059,QN,140-11 183 STREET,01,B1,HALIFAX GROUP LLC,2,1,1
13342,4130670272,QN,142-22 223 STREET,01,A2,"BOND , LEWIS  JR.",2,1,1
13343,4131490011,QN,222-21 141 ROAD,01,A1,"SIMEON, STEPHANIE",2,1,1
13344,4131810049,QN,138-24 233 STREET,01,A1,"ALLEYNE, OSBORNE",2,1,1
13345,4132020011,QN,137-53 234 STREET,01,B3,SWAN MARILYN,3,2,1
13346,4135510022,QN,241-06 CANEY ROAD,01,B2,"BOWEN, DAVID  A.",2,1,1
13347,4135700035,QN,243-55 144 AVENUE,01,A1,"JEREL-BEST, KAREN G",2,1,1
13348,4137330047,QN,235-36 148 ROAD,01,B2,"FARROW, CELIA B",2,1,1
13349,4139630071,QN,157-14 84 STREET,01,A2,"DIPRIMO, NICOLO",2,1,1
13350,4155140048,QN,11-41 SAGE STREET,01,B1,"MISHKOWITZ, MOISHE",2,1,1
13351,4155270010,QN,13-60 BEACH CHANNEL DRIVE,02,C0,A & R MANAGEMENT NY LLC,2,1,1
13352,4157420150,QN,29-14 FALCON AVENUE,01,B2,"BLACKMAN, COLIN C",2,1,1
13353,4158100030,QN,19-15 SEAGIRT BOULEVARD,03,D1,SEAGIRT HOUSING DEV FUND,2,1,1
13354,4160400052,QN,439 BEACH 66 STREET,02,C0,"GOODEN-WITTER, SANDRA",2,1,1
13355,4161340039,QN,1-77 BEACH 91 STREET,02,C0,177 BEACH 91 CORP,2,1,1
13356,4162080052,QN,424 BEACH 127 STREET,01,B3,LOCONTE JOSEPH,2,1,1
13357,4163190061,QN,176 BEACH 146 STREET,01,A1,"BRECHER, JOSEPH E",2,1,1
13358,4163210064,QN,182 BEACH 148 STREET,01,A1,MATTES MICHAEL,2,1,1
13359,5000370072,SI,63 SCRIBNER AVENUE,01,B1,ANTHONY J VISCIONE,3,2,1
13360,5000390064,SI,153 BENZIGER AVENUE,01,B3,"VOORSPUY, CINDY",2,1,1
13361,5000840041,SI,118 PROSPECT AVENUE,01,A5,GENNARI ROBERT,2,1,1
13362,5001000030,SI,300 PROSPECT AVENUE,08,W9,UNAVAILABLE OWNER,6,5,1
13363,5001380061,SI,14 LIVINGSTON COURT,02,C3,"BARON, LYUDMILA",4,3,1
13364,5001500207,SI,138 PELTON AVENUE,01,A1,"JENNIFER L. KACZMAREK, TRUSTEE",2,1,1
13365,5001940128,SI,50 RECTOR STREET,07,G2,ALL NEW REALTY LLC,2,1,1
13366,5002080004,SI,497 CARY AVENUE,01,B2,"VILLALTA, OSMIN R",2,1,1
13367,5002200017,SI,200 MYRTLE AVENUE,01,B2,WILLIAMS-JENKINS KIM,2,1,1
13368,5002590036,SI,23 DANA STREET,01,B2,"LASKOWSKI, AMANDA M",2,1,1
13369,5002870025,SI,679 PELTON AVENUE,01,A1,JOSEPH MAIELLO JR,2,1,1
13370,5003100194,SI,39 CLOVE LAKE PLACE,01,A1,JOSEPH VERHEY,2,1,1
13371,5003320142,SI,11 FAIRVIEW AVENUE,01,A1,"PERSICO, ALPHONSE",2,1,1
13372,5003350010,SI,140 RICE AVENUE,01,A1,"VOLPE, ERIKA",2,1,1
13373,5003530027,SI,11 MUNDY AVENUE,02,C2,JOHN REILLY AND WILLI,5,4,1
13374,5003560221,SI,36 SOUTH GREENLEAF AVE,01,B2,"VARVARA, ANTHONY",2,1,1
13375,5003770608,SI,146 KEMBALL AVENUE,01,A0,GRACE A YACCA,2,1,1
13376,5003940074,SI,551 COLLEGE AVENUE,01,A0,LAWRENCE PLAIA,2,1,1
13377,5004350019,SI,250 WILLARD AVENUE,01,B2,"SCARSELLI, MIRJANA",3,2,1
13378,5004700048,SI,408 LIVERMORE AVENUE,01,B2,"AMATO, PATRICIA",2,1,1
13379,5005210102,SI,92 BEACH STREET,02,C0,"NUZZOLO, MICHAEL",2,1,1
13380,5005300001,SI,66 TOMPKINS STREET,01,B2,66 TOMPKINS STREET REALTY CORP.,2,1,1
13381,5005800157,SI,33 NATALIE COURT,01,B2,ADAM PISKADLO,2,1,1
13382,5006210037,SI,95 PLEASANT VALLEY AVE,01,A1,T MC MAHON,2,1,1
13383,5006220086,SI,42 PLEASANT VALLEY AVE,01,B2,M DERUVO,3,2,1
13384,5007070040,SI,79 WINTHROP PLACE,01,A1,"MCCABE, MICHAEL J",2,1,1
13385,5007510009,SI,535 NORTH GANNON AVENUE,05,H3,"VICTORY HOSPITALITY, LLC",2,1,1
13386,5007650084,SI,234 PERRY AVENUE,01,A2,MARIO PEREZ,2,1,1
13387,5007850057,SI,210 MARTIN AVENUE,01,A2,"YANG, HUAI",2,1,1
13388,5008710114,SI,153 FOUR CORNERS ROAD,01,A3,YOUSSEF ZAKA H,2,1,1
13389,5008780350,SI,121 CIRCLE ROAD,01,A3,"LEVITZ, LEONARD",2,1,1
13390,5009050014,SI,724 TODT HILL ROAD,01,A3,SHCHEGOL ALEX,3,2,1
13391,5009420042,SI,2481 RICHMOND ROAD,04,K4,RW DEVELOPMENT CORP,2,1,1
13392,5009500105,SI,58 SUMMIT AVENUE,01,A1,DORIS BURTNER,2,1,1
13393,5010160024,SI,59 NEW STREET,01,A1,PACHECO BENITO,2,1,1
13394,5010480013,SI,54 HOMESTEAD AVENUE,01,A1,"DELCID, OMAR",2,1,1
13395,5010650062,SI,122 SMITH PLACE,01,A1,CARDONA CARLOS. A,2,1,1
13396,5011610001,SI,125 LAKE AVENUE,06,F5,CHAYIL PROPERTIES LLC,11,10,1
13397,5011920012,SI,137 VAN PELT AVENUE,04,S2,KENNETH ROSENTHAL,2,1,1
13398,5011940072,SI,202 SIMONSON AVENUE,04,S4,"AKRAM AL-OKAM, MEMBER",2,1,1
13399,5012120026,SI,91 DE HART AVENUE,01,B2,"SWINDELL, DARRYLE JR.",2,1,1
13400,5012300074,SI,19 GRIDLEY AVENUE,01,B9,"GUAMAN, LUIS A",2,1,1
13401,5016320100,SI,29 BRAD LANE,01,A5,JOSE MOYA,2,1,1
13402,5016447501,SI,6 JULES DRIVE,02,R3,NAME NOT ON FILE,35,34,1
13403,5024100015,SI,290 RICHMOND HILL ROAD,01,A5,SALVATORE DURANTE,2,1,1
13404,5026370019,SI,61 ALBERTA AVENUE,01,A1,"CAMACHO, ALEXANDRA",2,1,1
13405,5028650018,SI,19 EGBERT PLACE,01,A2,"RUSSO, MICELE",2,1,1
13406,5028660003,SI,785 TOMPKINS AVENUE,01,B3,JOSEPH DE SANTIS,2,1,1
13407,5029250486,SI,302 SKYLINE DRIVE,02,C6,CELEBRATION TOWNHOUSE,10,9,1
13408,5029650010,SI,177 CHESTNUT AVENUE,01,B9,"TANG, MEI LING",2,1,1
13409,5030980012,SI,255 MC CLEAN AVENUE,01,A2,"DU, MIKKO",2,1,1
13410,5031880059,SI,32 PROVIDENCE STREET,01,A2,SALVATORE STUTO III,2,1,1
13411,5032280090,SI,158 BEVERLY ROAD,01,A2,"BACCARI, GINA",2,1,1
13412,5032700050,SI,37 JEROME AVENUE,01,A2,"LUNJA, LIRIDONA",2,1,1
13413,5032740003,SI,306 HUMBERT STREET,01,B3,"MOLSKI, FLORA",4,3,1
13414,5033500056,SI,105 JEROME ROAD,01,A1,JOSEPH P MAROTTA,2,1,1
13415,5033940068,SI,48 SCOTT AVENUE,01,A5,"MICHALEWICZ, MALGORZATA",2,1,1
13416,5034030014,SI,16 ORLANDO STREET,01,A2,ELENA CAPULI,3,2,1
13417,5035920115,SI,19 FREMONT AVENUE,01,A1,"KELLY JR, BRIAN P",2,1,1
13418,5040260008,SI,351 GUYON AVENUE,01,A1,"EMMA, LEONARD",2,1,1
13419,5041920020,SI,22 2 STREET,01,B2,2ND STREET ZHANG REALTY LLC,2,1,1
13420,5042310108,SI,35 ALLISON AVENUE,01,A2,DIEHL MARIAN,2,1,1
13421,5042650008,SI,97 GUYON AVENUE,05,K1,"VENUS PROPERTIES, LLC",2,1,1
13422,5044360032,SI,150 WEST CEDARVIEW AVE,01,A3,"CALCAGNI, MARY O",2,1,1
13423,5044780499,SI,254 CORONA AVENUE,01,A5,"MELIOUS, DANIEL",2,1,1
13424,5046610004,SI,176 GUYON AVENUE,01,A1,MACDONALD JAMES R,2,1,1
13425,5050180061,SI,163 TWOMBLY AVENUE,01,A5,"GARBER, GENNADY",2,1,1
13426,5052030012,SI,3854 HYLAN BOULEVARD,08,W8,"ARK & DIV HOLDINGS, LLC",2,1,1
13427,5052890015,SI,126 PACIFIC AVENUE,01,A2,THE NAPOLITANO FAMILY MEDICAID IRREVOCAB LE TRUST,2,1,1
13428,5053780116,SI,4549 HYLAN BOULEVARD,01,A1,"DEJOHN, PAULA",2,1,1
13429,5054150083,SI,4464 HYLAN BOULEVARD,01,A1,DOROTHY LOMBARDO,2,1,1
13430,5054910011,SI,355 RIDGEWOOD AVENUE,01,B2,CHANG JIAN LIN,2,1,1
13431,5055280146,SI,366 RIDGEWOOD AVENUE,01,B3,"VITALE, MICHAEL",2,1,1
13432,5060870121,SI,175 DAHLIA STREET,01,A5,"JEFFREY S. GOODHARTZ, AS TRUSTEE",2,1,1
13433,5061660079,SI,2228 ARTHUR KILL ROAD,10,G1,VERIZON NEW YORK INC,3,2,1
13434,5069060001,SI,363 ASHLAND AVENUE,01,A1,"MARTINELLI, EVELYN",2,1,1
13435,5074650115,SI,4500 ARTHUR KILL ROAD,01,A1,STATEN ISLAND LAND DE,3,2,1
13436,5075900063,SI,4441 ARTHUR KILL ROAD,01,A1,"LELLA, DANIELA E",2,1,1
13437,5077990008,SI,7090 AMBOY ROAD,10,G1,WE REAL ESTATE HOLDING CORP.,2,1,1
13438,5078870071,SI,299 BRIGHTON STREET,01,B2,"GRANTON, JOHN",2,1,1
13439,5079000058,SI,132 BRIGHTON STREET,01,A3,TOMES ROBERT,2,1,1
13440,5080210002,SI,185 FISHER AVENUE,01,A1,ARLENE A AMUNDSEN,2,1,1
13441,1000720007,MN,151 MAIDEN LANE,05,H2,151 MAIDEN LLC,2,1,1
13442,1001110160,MN,86 CATHERINE STREET,08,W1,NYC DEPARTMENT OF EDUCATION,4,3,1
13443,1003720004,MN,20 AVENUE C,02,C1,"18-22 AVENUE C REALTY,",2,1,1
13444,1006030171,MN,449 HUDSON STREET,01,A4,"KEENA,MARY,C",2,1,1
13445,1006110003,MN,237 WEST 4 STREET,04,S2,"237 WEST 4TH STREET, LLC",2,1,1
13446,1006200047,MN,361 BLEECKER STREET,04,S1,"LIPMAN-WULF, LLC",2,1,1
13447,1007350017,MN,431 WEST 37 STREET,04,D6,"EQR-MANTENA, LLC",2,1,1
13448,1007850049,MN,206 WEST 36 STREET,07,U4,VERIZON NEW YORK INC,3,2,1
13449,1008020056,MN,122 WEST 27 STREET,05,O6,NORTHERN STAR TEXTILE CORP,2,1,1
13450,1008400026,MN,27 WEST 38 STREET,05,HB,FORTUNA FIFTH AVE LLC,2,1,1
13451,1009030057,MN,397 THIRD AVENUE,04,K4,299 3RD DEVELOPMENT LLC,3,2,1
13452,1010530034,MN,617 9 AVENUE,04,S9,"NINTH AVENUE REALTY, LLC",2,1,1
13453,1014290026,MN,1433 2 AVENUE,04,S5,"TUAN, LUCIA",2,1,1
13454,1014290127,MN,1437 2 AVENUE,04,S5,TAYAB REAL ESTATE COLTD,2,1,1
13455,1014800001,MN,1176 YORK AVENUE,08,I9,SOCIETY OF THE NY HOSPITAL,9,8,1
13456,1015870027,MN,1740 YORK AVENUE,07,Y6,NYC DEPARTMENT OF SANITATION,4,3,1
13457,1018440020,MN,200 MANHATTAN AVENUE,02,C1,MANHATTAN VALLEY LM APARTMENTS LLC,5,4,1
13458,1019110018,MN,133 WEST 126 STREET,02,C0,AARON A. SCHMIDT,2,1,1
13459,2025990005,BX,415 BRUCKNER BOULEVARD,07,U0,"CONSOLIDATED EDISON CO.OF N.Y.,INC.",2,1,1
13460,2027360011,BX,720 GARRISON AVENUE,06,E1,STELLMAR LLC,3,2,1
13461,2027750020,BX,327 BRYANT AVENUE,,Z9,"MEZO, ALEX",5,4,1
13462,2028230046,BX,1700 GRAND CONCOURSE,03,D3,"GC 1700, LLC",2,1,1
13463,2028490013,BX,1736 JEROME AVENUE,07,G3,NAPA REALTY CORP.,2,1,1
13464,2028550045,BX,1275 JEROME AVENUE,07,G2,DMZ HOLDINGS LLC,2,1,1
13465,2028920085,BX,1845 WEBSTER AVENUE,07,G3,1845 WEBSTER AVENUE GASOLINE LLC,2,1,1
13466,2029920073,BX,1883 VYSE AVENUE,02,C6,UNAVAILABLE OWNER,9,8,1
13467,2032150014,BX,2620 UNIVERSITY AVENUE,03,D1,KINGSBRIDGE HOUSING DEVELOPMENT FUND COR PORATION,2,1,1
13468,2032280049,BX,170 WEST 180 STREET,02,C0,DONES LISSANDER,2,1,1
13469,2033840018,BX,330 EAST 236 STREET,01,B1,"ZHU, YING ZI",2,1,1
13470,2034710033,BX,1844 PATTERSON AVENUE,01,B3,"SMITH , HASSAN  J",2,1,1
13471,2035570072,BX,617 BEACH AVENUE,01,B3,EDWIN RUIZ,2,1,1
13472,2036790038,BX,2068 HERMANY AVENUE,01,B3,"RODRIGUEZ, TANYA",2,1,1
13473,2036930026,BX,2238 QUIMBY AVENUE,01,B3,"KIRA, MICHAEL  N",2,1,1
13474,2037760017,BX,1224 MANOR AVENUE,01,A5,"U.S. BANK TRUST, N.A.",2,1,1
13475,2038160004,BX,1036 CASTLE HILL AVENUE,04,S1,1036 CASTLE HILL INC.,2,1,1
13476,2038720034,BX,1704 EAST 174 STREET,01,B1,EASTHERS BEATRICE,2,1,1
13477,2039460007,BX,2100 ST RAYMOND AVENUE,08,W1,NYC DEPARTMENT OF EDUCATION,2,1,1
13478,2039760042,BX,2477 TRATMAN AVENUE,02,C0,"SY & M MANAGEMENT I, LLC",2,1,1
13479,2040250019,BX,646 BAKER AVENUE,01,B1,LYVERE GARDENS LLC,2,1,1
13480,2042670054,BX,1919 COLDEN AVENUE,01,B1,"REGINA, PATRICIA",2,1,1
13481,2044620036,BX,2578 TENBROECK AVENUE,01,A5,"ALLI, JOSEPHINE",2,1,1
13482,2044620054,BX,2577 PEARSALL AVENUE,01,A5,"TAGUINOD, JANET",2,1,1
13483,2044820056,BX,2551 MICKLE AVENUE,01,A5,"MARTINEZ-CABRERA, WILMAN A",2,1,1
13484,2046360029,BX,3348 COLDEN AVENUE,01,B1,"HUTCHINSON, SIDIA",2,1,1
13485,2046670042,BX,719 EAST 219 STREET,01,B3,"GARCIA , WILFREDO",2,1,1
13486,2046710061,BX,848 EAST 213 STREET,01,B1,VICTORIA AKUJUO,2,1,1
13487,2046730056,BX,818 EAST 215 STREET,01,B1,"MATOS, ANTONIO",2,1,1
13488,2046920008,BX,959 EAST 221 STREET,01,B3,EESS DEVELOPMENT CORP.,2,1,1
13489,2047080153,BX,1126 EAST 214 STREET,01,B1,"BREMANG, SYLVESTER",2,1,1
13490,2048290054,BX,4042 LOWERRE PLACE,01,B9,HERMAN LOCARIO,2,1,1
13491,2048320055,BX,643 EAST 229 STREET,02,C0,"KHODABAKHSH, BABAK",3,2,1
13492,2048400037,BX,715 EAST 226 STREET,02,C0,JONES JOAN S,2,1,1
13493,2048660063,BX,930 EAST 231 STREET,01,B1,ROSA CASTRO IRREVOCABLE TRUST,2,1,1
13494,2048760057,BX,1022 EAST 230 STREET,01,A5,"SHAKES-GARVEY, MEARL",2,1,1
13495,2049020054,BX,1152 EAST 224 STREET,02,C3,"HUDA, SHAFI",2,1,1
13496,2049760003,BX,4006 GUNTHER AVENUE,01,A9,S.CLEVELAND BAKER & OLIVE BAKER REVOCABL E TRUST,3,2,1
13497,2050080023,BX,4135 WICKHAM AVENUE,01,B1,"BIGNALL, HOWARD A",2,1,1
13498,2050310014,BX,4243 SETON AVENUE,01,B1,"EDWARDS, VALRINE  T",2,1,1
13499,2050360029,BX,610 NEREID AVENUE,07,G5,HESS RETAIL STORES LLC,2,1,1
13500,2053110064,BX,2925 HASKIN STREET,01,A1,"TERAN, DAVID E",2,1,1
13501,2054010044,BX,1578 HOLLYWOOD AVENUE,01,A1,"CABRERA-STOEBE, HAYDEE",2,1,1
13502,2054030055,BX,1426 HOLLYWOOD AVENUE,01,B3,"SIESER, EVELYN",2,1,1
13503,2054190033,BX,2911 BARKLEY AVENUE,01,A2,"GUPTA, SANDEEP",2,1,1
13504,2054410005,BX,500 LOGAN AVENUE,02,C0,"FIGUEROA, ANNA L",2,1,1
13505,2054900007,BX,3236 SCHLEY AVENUE,01,A2,"GALAXY CONSTRUCTION SERVICES, CORP",2,1,1
13506,2055170132,BX,1 ALDEN PARK,01,A8,EDGEWATER PK OWNERS COOPERATIV,7,6,1
13507,2055180232,BX,4217 THROGS NECK EXPWY,02,C0,WAI KAM CHENG,2,1,1
13508,2055190044,BX,3168 WISSMAN AVENUE,01,A1,"CONNOLLY, JOHN",2,1,1
13509,2055310136,BX,944 REVERE AVENUE,01,A1,MARY B. WYNNE TRUSTNO. 1,2,1,1
13510,2055610047,BX,536 CALHOUN AVENUE,01,B1,"ZORILLA, JOHN",2,1,1
13511,2056250181,BX,65 BUCKLEY STREET,01,A2,MARIE FURST CAESAR,2,1,1
13512,2056250186,BX,55 BUCKLEY STREET,01,B2,DIMAIO FRANCIS,2,1,1
13513,2056260184,BX,10 PELL PLACE,01,A2,MURPHY JOANN,2,1,1
13514,2056260468,BX,74 CENTRE STREET,10,G0,MALDONADO CARMEN L,2,1,1
13515,2056480057,BX,662 MINNIEFORD AVENUE,01,A1,MARILYN J CARUSO,2,1,1
13516,2058831149,BX,6112 FIELDSTON ROAD,01,A1,"DYER, ANNE",2,1,1
13517,2059370360,BX,4900 PALISADE AVENUE,08,W3,RIVERDALE COUNTRY SCH,7,6,1
13518,3002970006,BK,219 CLINTON STREET,02,C6,219 CLINTON ST HOUSING CORP,3,2,1
13519,3003710009,BK,491 CLINTON STREET,01,B3,"VERONICA SANTISI RACCUGLIA, TRUSTEE",2,1,1
13520,3004070052,BK,313 BUTLER STREET,11,V1,"313 BUTLER STREET, LLC",2,1,1
13521,3004470030,BK,274 3 AVENUE,04,S3,JOANNE DENTE,2,1,1
13522,3006340072,BK,185 19 STREET,01,B9,DIPIERRO DANIEL J,2,1,1
13523,3006970040,BK,842 5 AVENUE,07,G4,BILL WOLF PETROLEUM CORP,2,1,1
13524,3008030150,BK,5400 1 AVENUE,07,U9,"ASTORIA GENERATING COMPANY ACQUISITIONS,  L.L.C.",11,10,1
13525,3008420029,BK,758 56 STREET,04,S1,758 L.L.C.,2,1,1
13526,3008730054,BK,291 18 STREET,01,B3,"SABATELLI, DANIEL R",2,1,1
13527,3011410053,BK,652 CLASSON AVENUE,08,M1,BKLYN PENT ASSN INC,2,1,1
13528,3012910019,BK,1276 CARROLL STREET,01,A9,"MINKOWICZ, AARON",2,1,1
13529,3012920073,BK,431 CROWN STREET,01,A4,UNITED LUBAVITCH YOUTH OF YESHIVA,2,1,1
13530,3013240016,BK,16 LAMONT COURT,01,B1,"CAYENNE, HAZEL",2,1,1
13531,3013810001,BK,1579 ST JOHNS PLACE,08,P5,CALVARY CHURCH OF THE FIRSTBORN,3,2,1
13532,3013880063,BK,909 EASTERN PARKWAY,01,B1,"OKOUNEV, YOSEF Y",2,1,1
13533,3014280031,BK,704 LEFFERTS AVENUE,11,V0,704 LEFFERTS LLC,2,1,1
13534,3017040025,BK,1912 FULTON STREET,08,M4,THE MOUNT SINAI CH OF GOD IN CHRIST INC,4,3,1
13535,3017810057,BK,283 KOSCIUSZKO STREET,02,C0,OLGA ORTIZ,2,1,1
13536,3018000059,BK,469A LEXINGTON AVENUE,01,B3,"HODGES, DWAYNE S",2,1,1
13537,3018810028,BK,75 CLASSON AVENUE,07,G5,75 CLASSON AVE CORP,2,1,1
13538,3018980017,BK,835 KENT AVENUE,02,C4,SIMON LOPEZ,5,4,1
13539,3019090011,BK,139 EMERSON PLACE,02,C1,"CARSAL ASSOCIATES, INC.",2,1,1
13540,3021860001,BK,555 WYTHE AVENUE,04,D7,BEDFORD GARDENS COMPANY,9,8,1
13541,3023290021,BK,88 ROEBLING STREET,04,S2,88 ROEBLING STREET LL,2,1,1
13542,3024040024,BK,260 BERRY STREET,04,S2,BIZZY MANAGEMENT LLC,2,1,1
13543,3026000001,BK,176 MCGUINNESS BOULEVARD,07,G4,HELF ENTERPRISES LLC,2,1,1
13544,3027240001,BK,417 MEEKER AVENUE,11,V3,411-417 MEEKER LLC,3,2,1
13545,3027737502,BK,39 POWERS STREET,02,R1,UNAVAILABLE OWNER,2,1,1
13546,3027770021,BK,325 HUMBOLDT STREET,02,C3,325 HUMBOLDT STREET LLC,3,2,1
13547,3029250001,BK,272 MORGAN AVENUE,06,F1,GRAND MORGAN EQUITIES LLC,3,2,1
13548,3032310018,BK,34 CEDAR STREET,01,B2,"SIERRA-GOMEZ, RAUL JR",3,2,1
13549,3035950048,BK,880 SARATOGA AVENUE,02,C0,BARR DORA E,2,1,1
13550,3035950049,BK,882 SARATOGA AVENUE,02,C0,"BATTICE, YORK E",2,1,1
13551,3036230018,BK,971 THOMAS S BOYLAND ST,01,B1,EDMONDS JULIA,2,1,1
13552,3037200003,BK,217 SHEFFIELD AVENUE,01,B2,BROOKLYN AVE EQUITIES LLC,2,1,1
13553,3037310001,BK,283 VAN SINDEREN AVENUE,06,F5,SNEDIKER AVENUE OWNERS LLC,7,6,1
13554,3038100031,BK,780 DUMONT AVENUE,02,C0,JAMES SAUNDERS,2,1,1
13555,3039050015,BK,8 NORWOOD AVENUE,01,B1,"CABRERA, MARCIA E",2,1,1
13556,3039850012,BK,676 LIBERTY AVENUE,04,S9,TCN LIBERTY MANAGEMENT INC,3,2,1
13557,3040010109,BK,417 CLEVELAND STREET,01,B2,"SALTIBUS, GEORGE",2,1,1
13558,3040240036,BK,873 BELMONT AVENUE,01,B1,"HIDALGO, JOSE M",2,1,1
13559,3040570036,BK,474 VAN SICLEN AVENUE,01,B1,"RIDDICK, PAMELA A.",2,1,1
13560,3041040059,BK,72 EUCLID AVENUE,01,B3,"BATISTA, JUAN",2,1,1
13561,3046700035,BK,357 EAST 95 STREET,02,C3,CARLOS E. PROVIDENCE,3,2,1
13562,3046960028,BK,468 EAST 49 STREET,01,A9,"WILLIAMS, SHARON",2,1,1
13563,3047130021,BK,577 EAST 92 STREET,02,C0,"OUDKERK, SHONDELL",2,1,1
13564,3047370009,BK,5220 TILDEN AVENUE,01,A5,"MCFARLANE, ROLANDO",2,1,1
13565,3047590064,BK,643 EAST 48 STREET,01,A1,PIERRE P MICHEL,2,1,1
13566,3047720004,BK,5110 CLARENDON ROAD,01,B1,"LOWE, BETTY",2,1,1
13567,3047920040,BK,431 MAPLE STREET,10,G0,CLINTON ABBOTT,2,1,1
13568,3048810015,BK,358 EAST 45 STREET,01,A1,BX J & J HOLDINGS LLC,2,1,1
13569,3048840037,BK,72 EAST 31 STREET,01,B1,"STRADFORD, STEPHANIE",2,1,1
13570,3048900025,BK,300 EAST 37 STREET,08,M1,CHURCH OF GOD & SAINTS OF CHRIST THE STO NE OF TRUT,2,1,1
13571,3049040010,BK,370 EAST 34 STREET,08,W1,NYC DEPARTMENT OF EDUCATION,2,1,1
13572,3049720037,BK,714 EAST 39 STREET,01,A9,"WILLIAMS, ROMAINE",2,1,1
13573,3050280018,BK,86 LINCOLN ROAD,01,A1,"WINTER, YVETTE",2,1,1
13574,3050340050,BK,106 MIDWOOD STREET,01,A4,"DAVIS, MELANIE",2,1,1
13575,3050390063,BK,319 FENIMORE STREET,01,B1,"ST.OMER, TERRY",2,1,1
13576,3051680003,BK,2408 BEVERLEY ROAD,01,B1,"MIYAGAWA, CHIORI",2,1,1
13577,3053460044,BK,3916 15 AVENUE,05,K2,3920 15 AVENUE LLC,2,1,1
13578,3053800044,BK,1690 42 STREET,02,C0,"FREUND, FREDDA CHAYIE",2,1,1
13579,3054600065,BK,1731 51 STREET,01,A9,CORNERSTONE 51 LLC,2,1,1
13580,3055150016,BK,2124 59 STREET,01,A5,"HALPERT, LOUIS",2,1,1
13581,3056610047,BK,1171 53 STREET,01,B1,DAVID MOSKOVITS,2,1,1
13582,3057000073,BK,815 59 STREET,04,S4,815 YING DONG LLC,2,1,1
13583,3057660031,BK,1152 67 STREET,02,C1,YIP AND WONG REALTY CORP,2,1,1
13584,3057990019,BK,338 62 STREET,01,B2,"TSE, YUK FOO",2,1,1
13585,3058880070,BK,69 72 STREET,01,A1,PAUL SAIA,2,1,1
13586,3059000014,BK,7118 8 AVENUE,01,A5,"LI, ANNY",2,1,1
13587,3059290072,BK,327 BAY RIDGE PARKWAY,01,B2,MOUSA A KHALIL,2,1,1
13588,3059370041,BK,7512 COLONIAL ROAD,02,C0,"MCEVOY, CHARLES",2,1,1
13589,3059400079,BK,311 76 STREET,04,K4,"NG, ALICE",2,1,1
13590,3059550021,BK,1036 76 STREET,01,A5,"PEDERSEN, LEIF",2,1,1
13591,3059900051,BK,8022 6 AVENUE,02,C0,LIVANOS PANTAZIS,2,1,1
13592,3060990001,BK,9255 SHORE ROAD,03,D4,DIVERSIFIED PROPERTY MGMT.,2,1,1
13593,3062200061,BK,1143 76 STREET,01,A5,"DEMARCO, RICK",2,1,1
13594,3062990015,BK,2136 81 STREET,02,C0,"LU, ZHI PEI",2,1,1
13595,3063130036,BK,8116 BAY 16 STREET,02,C0,"XI HUANG, AS TRUSTEE",2,1,1
13596,3063380013,BK,1216 85 STREET,01,A5,ARGANO NICOLO,2,1,1
13597,3063600074,BK,70 BAY 10 STREET,01,A5,"DICK, KI CHUNG",2,1,1
13598,3063660020,BK,8651 17 AVENUE,02,C0,SABASTIANO PICCININNI,2,1,1
13599,3063920071,BK,150 BAY 8 STREET,02,C0,"CHOI, SHUN K",2,1,1
13600,3064420047,BK,192 BAY 25 STREET,01,B3,192 BAY 25TH SRTEET LLC,2,1,1
13601,3065100027,BK,872 EAST 8 STREET,01,A1,ABRAHAM SULTANIK,2,1,1
13602,3065190027,BK,1046 EAST 7 STREET,01,A1,"LEVY, MAURICE",2,1,1
13603,3065730077,BK,1329 EAST 10 STREET,01,B2,"IMANOEL, HELEN",2,1,1
13604,3065860002,BK,406 AVENUE N,01,B1,"YAAKOV LERCHER, TRUSTEE",2,1,1
13605,3065860074,BK,1537 EAST 4 STREET,01,A9,"ESSES, ALISON",2,1,1
13606,3065890084,BK,1521 EAST 7 STREET,01,A1,EZRA SHALOM,2,1,1
13607,3066140056,BK,709 AVENUE P,01,A9,NATALIE HABERT,2,1,1
13608,3066150037,BK,1572 EAST 9 STREET,01,A9,"MASLATON, MURRAY",2,1,1
13609,3066150050,BK,809 AVENUE P,01,B2,D POLEVOY,2,1,1
13610,3066160017,BK,1530 EAST 10 STREET,01,A3,"MICHAEL S. ZEITOUNE, TRUSTEE",2,1,1
13611,3066390077,BK,1711 EAST 7 STREET,01,A9,"SAFDEYE, SONNY",2,1,1
13612,3066640014,BK,1716 EAST 8 STREET,01,A5,"KBARITI, MORDI",2,1,1
13613,3066810073,BK,18 BILLINGS PLACE,01,A3,"FARCA, MICHAEL",2,1,1
13614,3067380017,BK,1242 EAST 19 STREET,01,B2,TABAK MARTIN,2,1,1
13615,3067510030,BK,1454 EAST 14 STREET,01,B2,IMIR HARUN,2,1,1
13616,3067590016,BK,1526 EAST 13 STREET,08,M4,ST. BRENDAN'S RC CHU,2,1,1
13617,3067710050,BK,2405 AVENUE P,04,S2,MBJ PROPERTIES LLC,2,1,1
13618,3069120021,BK,2661 MILL ROAD,11,V0,UNIVERSAL ACTIONS LLC,2,1,1
13619,3070700148,BK,2301 BOARDWALK WEST,08,I6,ATLANTIC GERIATRIC VENTURES,2,1,1
13620,3070760053,BK,1943 WEST 13 STREET,01,A9,"XIE, ZHAO ZHOU",2,1,1
13621,3071100035,BK,2060 EAST 8 STREET,01,A3,"ASSA, EZAK",2,1,1
13622,3071100074,BK,2095 EAST 7 STREET,02,C2,ZUKY REALTY INC,2,1,1
13623,3071330014,BK,2168 EAST 7 STREET,01,B2,"CHEN, YING ZHEN",2,1,1
13624,3071510105,BK,2275 WEST 1 STREET,01,A1,"MISHIYEV, DANIL",2,1,1
13625,3071590022,BK,2238 EAST 8 STREET,01,A1,"ROMANO, SOPHIA",2,1,1
13626,3071740019,BK,27 STRYKER COURT,02,C0,"LI, ANNIE YANHONG",2,1,1
13627,3071800066,BK,2384 OCEAN PARKWAY,01,B2,"NAHUM, MOSHE",2,1,1
13628,3071980019,BK,2452 EAST 3 STREET,01,B3,EB 1 HOLDINGS LLC,2,1,1
13629,3072970027,BK,1956 EAST 19 STREET,01,A1,"STANKEVICH, YULIYA",2,1,1
13630,3073050047,BK,2613 AVENUE T,01,A5,CHIN NGAI LAM,2,1,1
13631,3073170040,BK,1249 AVENUE U,04,S9,1249 AVENUE U REALTYCORP.,2,1,1
13632,3073240028,BK,2510 OCEAN AVENUE,01,B2,2510 OCEAN LLC,2,1,1
13633,3073270004,BK,2210 AVENUE T,01,A1,ALBERT YEDID,2,1,1
13634,3073270073,BK,2051 EAST 22 STREET,01,B3,"SULTAN, MARCUS",2,1,1
13635,3073980026,BK,2348 EAST 14 STREET,01,A9,"ZAIBAK, VICTOUR",2,1,1
13636,3074180062,BK,2451 EAST 16 STREET,01,B2,ESTATE OF THOMAS NICHOLS,2,1,1
13637,3075570018,BK,117 KENILWORTH PLACE,01,A1,"LEE, SANG WON",2,1,1
13638,3075850011,BK,1115 EAST 21 STREET,01,A1,LANGSAM EUGENE,2,1,1
13639,3076020081,BK,1212 EAST 21 STREET,01,A1,HERBST ABRAHAM,2,1,1
13640,3076040015,BK,1145 EAST 22 STREET,01,A1,"MATALON, ELI",2,1,1
13641,3076220015,BK,1239 EAST 22 STREET,01,A1,GROSS BENJAMIN,2,1,1
13642,3076240079,BK,3304 BEDFORD AVENUE,08,M1,CONGREGATION TORAH U'TEFFILLAH INC,2,1,1
13643,3076420051,BK,3332 BEDFORD AVENUE,01,A1,"DEUTSCH, CHAIM",2,1,1
13644,3076460026,BK,1249 EAST 28 STREET,01,A1,"WEISS, JACOB",2,1,1
13645,3076560027,BK,1440 EAST 21 STREET,01,A1,HENRY BREJT,2,1,1
13646,3076680036,BK,1323 EAST 32 STREET,08,W2,"KOLLEL BNEI TORAH, INC.",2,1,1
13647,3077010061,BK,1656 MADISON PLACE,01,A1,"JEAROLMEN, CHAIM E.",2,1,1
13648,3077340008,BK,1611 UTICA AVENUE,05,K5,UTICA 2018 LLC,2,1,1
13649,3077370012,BK,1053 EAST 53 STREET,01,B1,"BERNARD, BERNADETTE",2,1,1
13650,3077380034,BK,953 EAST 54 STREET,01,B3,CUTHBERT SYLVESTER,2,1,1
13651,3077380043,BK,5416 GLENWOOD ROAD,01,B3,"WILLIAMS, ANN P",2,1,1
13652,3078500080,BK,1496 EAST 53 STREET,01,A9,FOWAD ABDO,3,2,1
13653,3079020071,BK,1492 EAST 58 STREET,01,A9,"PILOAR, ILAN",2,1,1
13654,3080060062,BK,756 EAST 86 STREET,01,B2,ROSSI GWENDOLYN,3,2,1
13655,3080810064,BK,1437 EAST 84 STREET,01,B9,"MCLEOD, FRANCIS LEROY",2,1,1
13656,3081460041,BK,1290 ROCKAWAY PARKWAY,01,A1,"FIORELLO , PATRICIA",2,1,1
13657,3081800013,BK,1155 EAST 92 STREET,01,B1,CASS JOHNSON,2,1,1
13658,3081820049,BK,113 CONKLIN AVENUE,01,A5,FRANK D ROSA,3,2,1
13659,3084590006,BK,2457 EAST 72 STREET,01,B1,"BROVAKOS, TIMOTHY",2,1,1
13660,3084720001,BK,2801 FILLMORE AVENUE,02,C9,NYSANDY11 MARINE PARK LLC,30,29,1
13661,3085220035,BK,2015 EAST 36 STREET,01,A9,"JABLONSKI, MARK P",2,1,1
13662,3087380062,BK,220 AMHERST STREET,01,A3,"BOROVSKIY, SVETLANA",2,1,1
13663,3087937501,BK,4050 NOSTRAND AVENUE,04,RM,UNAVAILABLE OWNER,2,1,1
13664,3088230067,BK,2325 GERRITSEN AVENUE,08,M3,RESURRECTION RC CHURCH,2,1,1
13665,4000990030,QN,25-61 49 AVENUE,10,G1,PSTR REALTY CORP,2,1,1
13666,4003620017,QN,12-02 37 AVENUE,05,H3,CP & SONS LLC,2,1,1
13667,4004740007,QN,38-61 10 STREET,06,F5,38-61 10TH STREET CORP,2,1,1
13668,4005560001,QN,33-20 23 STREET,01,B1,"KUAN LOU, HOK",2,1,1
13669,4005970078,QN,26-51 29 STREET,01,B2,"LYMBERIS, PETER",2,1,1
13670,4006010132,QN,32-04 36 AVENUE,04,S4,MIHAIL IANAS,2,1,1
13671,4006080020,QN,34-19 31 STREET,04,S1,"KARIDIS, ATHANASIA (TRUST)",2,1,1
13672,4006920140,QN,31-09 42 STREET,01,B1,"SHI, YU",2,1,1
13673,4008040059,QN,23-84 38 STREET,01,B2,"BEGUM, KULSUM",2,1,1
13674,4008050037,QN,22-12 STEINWAY STREET,02,C0,KOPANOS ANGELIKI,2,1,1
13675,4008720043,QN,25-03 23 STREET,04,S4,25-03 23RD STREET CORPORATION,2,1,1
13676,4008720068,QN,25-34 CRESCENT STREET,03,D4,2534 CRESCENT ST OWNERS CORP,2,1,1
13677,4009690039,QN,21-51 73 STREET,01,B1,"GEORGALIS, ANNA",2,1,1
13678,4011280013,QN,30-16 80 STREET,02,C0,"RAHAMAN, AMRAL N",2,1,1
13679,4012640014,QN,34-20 78 STREET,03,D4,34 20 PROPERTIES LTD,2,1,1
13680,4013510023,QN,70-29 45 AVENUE,08,M1,ST JOHN CHRYSOSTOM CH,3,2,1
13681,4013760041,QN,26-37 96 STREET,02,C2,"HE, YI XING",2,1,1
13682,4013760045,QN,26-29 96 STREET,02,C3,ANDRE B NOEL,3,2,1
13683,4015830081,QN,90-28 43 AVENUE,04,S9,T2 MANAGEMENT INC.,3,2,1
13684,4016160036,QN,99-37 102 STREET,08,M1,"EL AMANECER DE LA ESPERANZA MINISTRY, IN C.",3,2,1
13685,4016960042,QN,101-01 NORTHERN BOULEVARD,05,K1,"LKM ENTERPRISES, INC",2,1,1
13686,4017480067,QN,34-47 106 STREET,01,B2,CLEMENT JAON E,3,2,1
13687,4017530088,QN,35-29 109 STREET,02,C2,KLC PROPERTIES LLC,2,1,1
13688,4018370159,QN,87-69 52 AVENUE,01,A1,"QUACH, JOHN LOI",2,1,1
13689,4018560066,QN,90-29 55 AVENUE,02,C0,"CHAU, HOI WAI",2,1,1
13690,4018710071,QN,55-01 92 STREET,01,B2,HANNAH HUIHUI LIN,3,2,1
13691,4019330021,QN,50-22 103 STREET,02,C2,103 STREET REALTY LLC,2,1,1
13692,4021070044,QN,99-39 62 ROAD,02,C0,ABRAHAM JAVDANFAR,2,1,1
13693,4021790046,QN,108-35 68 ROAD,01,A3,"GEROV, SIMON",2,1,1
13694,4022300050,QN,110-35 JEWEL AVENUE,04,S1,MIZRAHI FAMILY TRUST,2,1,1
13695,4023830016,QN,65-43 52 AVENUE,01,A9,"GARCIA, JOHNNY X",2,1,1
13696,4026980039,QN,59-56 58 ROAD,01,B2,SKOCZEK ANDRZEJ,2,1,1
13697,4027460015,QN,60-13 61 STREET,01,A5,"KOBER, JO ANN",2,1,1
13698,4027530253,QN,64-46 58 ROAD,01,A5,VINCENT KEEGAN,2,1,1
13699,4027580072,QN,62-43 60 DRIVE,01,A5,"FUGETT, JASON",2,1,1
13700,4027960005,QN,69-62 GRAND AVENUE,04,S3,69-62 GRAND AVENUE R,2,1,1
13701,4028170056,QN,57-69 78 STREET,01,A1,BALCERZAK WACLAW,3,2,1
13702,4029050028,QN,54-19 83 STREET,01,B2,"MOTA, YOBANA",2,1,1
13703,4029230035,QN,69-25 61 DRIVE,01,A1,"BONGIORNO, ROBERTO",2,1,1
13704,4030410035,QN,65-50 79 PLACE,01,A5,"BOIARDI, MICHAEL",3,2,1
13705,4030690027,QN,79-02 JUNIPER VALLEY ROAD,01,B1,"ZHOU, KAILUN",2,1,1
13706,4033080005,QN,50 OVERHILL ROAD,01,A3,"ROBAINA, ANA MARIA",2,1,1
13707,4035040033,QN,68-16 60 STREET,01,B2,"PELLEGRINO, ROSE",2,1,1
13708,4036190005,QN,66-87 FRESH POND ROAD,05,K1,JOFRESH LLC C/O MIDWO,5,4,1
13709,4036640053,QN,70-15 72 STREET,01,B2,"JAEGER, GRACE MARY",2,1,1
13710,4037130002,QN,60-56 COOPER AVENUE,01,B2,DURAN  RICHARD,2,1,1
13711,4038800081,QN,90-18 81 ROAD,01,A5,"CHIAROVANO, ROBERT",2,1,1
13712,4039590011,QN,6-07 129 STREET,01,A1,GLADYS G. RAMIREZ,2,1,1
13713,4039740087,QN,126-01 11 AVENUE,01,B1,"TAYLOR, EMILY",2,1,1
13714,4040440001,QN,14-14 WATERS EDGE DRIVE,08,Y2,NYC POLICE DEPARTMENT,2,1,1
13715,4040610004,QN,110-14 15 AVENUE,10,G7,110-14 15TH AVE LLC,2,1,1
13716,4044420024,QN,8 CENTER DRIVE,01,A1,"GJAFERO, CAZIM",2,1,1
13717,4045110068,QN,6-02 CLINTONVILLE STREET,01,A3,"KUAN, SHAO YUN",2,1,1
13718,4046280038,QN,145-47 18 AVENUE,01,B3,"CHEN, YI ZHEN",2,1,1
13719,4047080053,QN,151-43 21 AVENUE,01,B1,DEMETRA  ANTONIADES AS TRUSTEE,2,1,1
13720,4050050042,QN,35-14 149 STREET,02,C1,MD REALTY LLC,2,1,1
13721,4050370095,QN,132-41 41 AVENUE,01,B2,PENG KUEI-YUN,2,1,1
13722,4052030008,QN,45-02 45 AVENUE,04,S9,"C&C QUEENS REALTY, LLC",2,1,1
13723,4053650005,QN,189-11 NORTHERN BOULEVARD,04,K4,"159 PLAZA, LLC",3,2,1
13724,4053890003,QN,42-55 158 STREET,02,C0,"XIA, NAN YE",2,1,1
13725,4053920031,QN,42-32 162 STREET,04,S2,FLUSHING PROPERTY MANAGEMENT GROUP INC,2,1,1
13726,4054170171,QN,43-70 160 STREET,01,B2,"LIN, YING  JU",2,1,1
13727,4055700079,QN,164-15 UNDERHILL AVENUE,01,A0,MICHAEL F MELUZIN,2,1,1
13728,4057480075,QN,163-07 20 ROAD,01,A0,LARKIN SUSAN,2,1,1
13729,4057900040,QN,199-39 23 AVENUE,01,A1,"LANDOLFI, WILLIAM R",2,1,1
13730,4059710008,QN,28-18 200 STREET,01,A1,"LETTAS , SEVASTI TOULA",2,1,1
13731,4062250015,QN,39-18 211 STREET,01,B1,"LIAO, JENNIFER HONGXIA",2,1,1
13732,4063110029,QN,40-15 217 STREET,02,C0,"CHEN, YAN",4,3,1
13733,4063120022,QN,40-30 219 STREET,01,A1,ATLANTIC DISTRICT OF THE LUTHERAN CHURCH -MISSOURI,2,1,1
13734,4068510012,QN,78-10 164 STREET,08,I6,HEALTH CARE CENTER,2,1,1
13735,4068990048,QN,61-24 172 STREET,01,B1,HIN MAN AU,2,1,1
13736,4069840001,QN,74-04 UTOPIA PARKWAY,08,M1,R C CHURCH HOLY FAMIL,4,3,1
13737,4070210075,QN,81-50C UTOPIA PARKWAY,08,W6,ST JOHN'S UNIVERSITY,2,1,1
13738,4070720042,QN,61-29 183 STREET,01,A2,ANASTASIOS VENTOURAS,3,2,1
13739,4072140016,QN,75-24 198 STREET,01,B1,"SHOFEL, LARRY",2,1,1
13740,4072900001,QN,196-10 UNION TURNPIKE,09,Q1,NYC DEPARTMENT OF PARKS AND RECREATION,14,13,1
13741,4073020012,QN,204-14 45 ROAD,01,A5,TONY CHIU,2,1,1
13742,4073190025,QN,204-17 48 AVENUE,01,B3,ALICE L SZETO,2,1,1
13743,4074060034,QN,197-09 56 AVENUE,01,A1,"HU, ZHIYANG",2,1,1
13744,4074300036,QN,56-51 201 STREET,01,A1,"GOLIA, ANNA MARIA",2,1,1
13745,4075680011,QN,57-05 230 STREET,01,B2,THE JOHN AND NANCY CARDILLO FAMILY TRUST,2,1,1
13746,4076180001,QN,217-04 64 AVENUE,01,B3,"WU, JOHNNY KWOK KEUNG",2,1,1
13747,4076650020,QN,64-30 231 STREET,01,B2,"CHEN, HENG",2,1,1
13748,4080240057,QN,317 WARWICK AVENUE,01,A1,"VULIN, SANDRA VALE",2,1,1
13749,4080660060,QN,217 38 ROAD,01,A1,"MASTROGIANNIS, ANASTASIA",2,1,1
13750,4080960039,QN,240-11 LITTLE NECK ROAD,01,A1,"DEVINS, THOMAS  V",2,1,1
13751,4081060061,QN,242-01 PINE STREET,01,A1,JOSEPH TARTAGLIA,3,2,1
13752,4081170004,QN,247-10 43 AVENUE,01,A5,PETER BURNS,3,2,1
13753,4081510001,QN,37-03 255 STREET,01,A0,ELAINE J EISEMAN,2,1,1
13754,4082290025,QN,45-18 LITTLE NECK PARKWAY,05,O5,TREEMAR ASSOCIATES LLC,2,1,1
13755,4082450110,QN,53-11 MORENCI LANE,01,A0,"REMTULA, AMINMOHAMED",2,1,1
13756,4082510006,QN,252-42 BRATTLE AVENUE,01,A1,"PANJWANI, NAND",2,1,1
13757,4082670037,QN,255-24 IOWA ROAD,01,A2,"KOKOLIS, STEPHANOS",2,1,1
13758,4086730015,QN,77-76 271 STREET,01,A0,BOULOS GEORGE M,2,1,1
13759,4087400207,QN,81-59 265 STREET,01,A1,"PATEL, RAJESHKUMAR B",2,1,1
13760,4088310033,QN,87-64 257 STREET,01,A1,"THOMAS, ANN M",2,1,1
13761,4089570001,QN,78-12 90 ROAD,01,B3,"MCINTOSH, WILLIAM",2,1,1
13762,4090190029,QN,94-27 85 STREET,01,B2,"WENZ, FREDERICK",2,1,1
13763,4090250003,QN,87-08 95 AVENUE,01,B2,"SAMAROO, DRUPATTIE",2,1,1
13764,4090810017,QN,81-14 101 AVENUE,02,C1,"AMAR MARKETING ENTERPRISE III, LLC",2,1,1
13765,4091790033,QN,101-11 86 AVENUE,02,C1,101-11 86TH AVE CORP,2,1,1
13766,4092240031,QN,86-54 111 STREET,01,B2,A BETTER WORLD REAL ESTATE CORP.,3,2,1
13767,4092310023,QN,83-08 122 STREET,04,C7,"METROPOLE HOMES, INC.",2,1,1
13768,4092750048,QN,86-20 122 STREET,01,B3,"LATCHMINARAIN, TREVOR",2,1,1
13769,4093200129,QN,112-21 ATLANTIC AVENUE,01,A5,A VOLL,2,1,1
13770,4093900012,QN,95-20 107 STREET,01,A1,"CAMPOS, JULIA",2,1,1
13771,4094380011,QN,94-18 121 STREET,01,B3,94-18 121ST STREET CORP.,2,1,1
13772,4094380134,QN,120-07 95 AVENUE,02,C0,ALL COOL HVAC LLC,2,1,1
13773,4094440043,QN,127-11 95 AVENUE,01,A1,"KHATERI, SAFDAR",2,1,1
13774,4094500072,QN,94-15 134 STREET,01,B3,"LACKEYRAM, MALCOLM V",2,1,1
13775,4094660039,QN,95-15 125 STREET,01,B3,DAVID E MERIDA,2,1,1
13776,4095480065,QN,107-33 110 STREET,01,A9,JORGE SILVA,2,1,1
13777,4095490076,QN,107-11 111 STREET,01,B3,"BASDEO , RONALD",2,1,1
13778,4096010049,QN,107-69 109 AVENUE,01,B1,MARTHA COLLADO,2,1,1
13779,4096760047,QN,89-47 146 STREET,01,A1,"PIERRE AS TRUSTEE, NORBERT C",2,1,1
13780,4097020055,QN,147-13 HILLSIDE AVENUE,04,K4,MERPRIETO REALTY LLC,2,1,1
13781,4097850001,QN,84-67 161 STREET,01,B3,"CHAWDHURY, RIDWAN",2,1,1
13782,4098240065,QN,170-13 89 AVENUE,01,B2,"KHAN, MD KAMRUL",2,1,1
13783,4098240068,QN,170-11 89 AVENUE,01,A1,"KHAN, SARWOR",2,1,1
13784,4098460011,QN,86-47 HIGHLAND AVENUE,04,D6,HIGHLAND HILLS RLTYLTD,2,1,1
13785,4099070064,QN,90-39 185 STREET,01,B2,"NAIDU, ASHA D",2,1,1
13786,4101660061,QN,107-58 164 STREET,01,A1,RESOURCE CAPITAL GROUP LLC,2,1,1
13787,4101830021,QN,109-18 167 STREET,01,B2,"AFROZ, SONIA",2,1,1
13788,4102150001,QN,92-07 175 STREET,08,W1,NYC DEPARTMENT OF EDUCATION,2,1,1
13789,4103140023,QN,115-04 180 STREET,01,A1,"DYER, ANGELA",2,1,1
13790,4103730011,QN,104-11 187 STREET,01,A1,"CHANDRAKUAR, BASMATIE",2,1,1
13791,4103770007,QN,104-17 189 STREET,01,A1,VALERIE PEARSON,2,1,1
13792,4103870039,QN,115-61 MEXICO STREET,01,A1,J H BAILEY,2,1,1
13793,4104240034,QN,187-37 ILION AVENUE,01,B3,MR M HEATH,2,1,1
13794,4105180021,QN,86-88 PINTO STREET,01,A1,"MILCHMAN, AARON",2,1,1
13795,4107320020,QN,220-35 93 ROAD,01,A1,BURNS MARA D,3,2,1
13796,4107550036,QN,224-19 92 ROAD,01,A1,"CARTAGENA, BEATRIZ P",2,1,1
13797,4109200076,QN,104-05 210 STREET,01,A1,"GRANVILLAGE, PAULINE",2,1,1
13798,4109870032,QN,191-45 113 ROAD,01,A1,G ALVAREZ,2,1,1
13799,4110430025,QN,202-17 116 AVENUE,01,B3,"RODRIGUEZ TOLEDO, ELI",2,1,1
13800,4111040119,QN,217-18 104 AVENUE,01,A1,"RAMNARAINE, MAIKAISKWARRIE",2,1,1
13801,4113220030,QN,116-05 221 STREET,01,B3,"THOMAS, CLEMENT",3,2,1
13802,4114780077,QN,111-11 110 STREET,01,A1,LUIS M PEREZ,3,2,1
13803,4115310043,QN,137-29 95 STREET,01,A5,"MORANO , JOHN",2,1,1
13804,4115980038,QN,117-09 111 AVENUE,01,B3,PERSAUD RAMNAUTH,2,1,1
13805,4116330030,QN,111-50 130 STREET,01,A1,NANDRANIE BODHOO,3,2,1
13806,4117020012,QN,120-23 135 STREET,01,B3,"DAVID, ANIL A",2,1,1
13807,4118630012,QN,129-03 130 STREET,07,G3,STERLING CANYON LLC C,2,1,1
13808,4119380032,QN,145-62 LAKEWOOD AVENUE,01,B2,"SEUSARRAN, JASMATEE",2,1,1
13809,4119510022,QN,110-11 LIVERPOOL STREET,01,A1,"NATHANIEL, EVELYN",2,1,1
13810,4119730126,QN,114-26 144 STREET,01,B2,"KUMAR, KRISHAN",2,1,1
13811,4120490024,QN,123-14 146 STREET,01,A1,"BLEASDILLE, MYRTLE",2,1,1
13812,4120600072,QN,142-20 BASCOM AVENUE,01,B2,"MEDINA, JENNY N",2,1,1
13813,4121060066,QN,147-07 130 AVENUE,01,A1,"HARRINGTON, SANDY",2,1,1
13814,4121090023,QN,130-25 146 STREET,01,A1,"RESTREPO, MARIA",2,1,1
13815,4121120040,QN,130-04 150 STREET,01,A1,DAVID D ECCLESTON,2,1,1
13816,4121650010,QN,110-39 UNION HALL STREET,01,B2,"MULTANI, LAKHWINDER",2,1,1
13817,4122030201,QN,150-36 116 DRIVE,01,A1,CRAIG EDWARDS,2,1,1
13818,4122090162,QN,118-50 155 STREET,01,A9,"118-50 155TH STREETR, LLC",2,1,1
13819,4122430027,QN,119-14 LONG STREET,01,B3,"LEE, CAROL",2,1,1
13820,4122780034,QN,153-21 134 AVENUE,01,B3,YELLOW STONE HOMES LLC,2,1,1
13821,4123140152,QN,140-48 159 STREET,01,A1,VERA BURLL ELLIOTT,2,1,1
13822,4123310098,QN,114-48 168 STREET,01,A2,DAVIS CARLTON,2,1,1
13823,4123450081,QN,170-01 116 AVENUE,01,A1,"ROJAS, ROMEL A",2,1,1
13824,4124680064,QN,177-48 119 ROAD,01,B2,"TYSON, ZAKEER",2,1,1
13825,4124700029,QN,119-50 177 STREET,01,B3,"CAMPBELL, LOLETA",2,1,1
13826,4124810087,QN,177-51 TROUTVILLE ROAD,01,A1,"BOGLE, PAULA",2,1,1
13827,4126230056,QN,118-27 198 STREET,01,B3,"NATH, RIPON",2,1,1
13828,4126640012,QN,188-20 120 AVENUE,01,B3,"WALTERS-NISBETT, ELVIRA",2,1,1
13829,4127100017,QN,195-08 122 AVENUE,01,A1,"ORTEGA, BEVERLY ANN",2,1,1
13830,4130490007,QN,142-01 FARMERS BOULEVARD,05,K1,142 HOLDING CORP,8,7,1
13831,4131010046,QN,221-21 135 AVENUE,01,B3,"MCCOLLOUGH, KESWICK",2,1,1
13832,4131110021,QN,220-02 135 AVENUE,01,A1,"MCDONALD, FAYETTE  N",2,1,1
13833,4131810044,QN,138-14 233 STREET,01,B3,"MCKENZIE, CHENNEY",2,1,1
13834,4131860059,QN,139-42 231 STREET,01,A1,"COMBS, VINCENT",2,1,1
13835,4131940025,QN,225-05 143 AVENUE,01,A2,"SIMMONS, AVIS LAMONTA",2,1,1
13836,4132710007,QN,165-11 144 DRIVE,01,A1,"SIMPKINS, KEVIN",2,1,1
13837,4134350039,QN,222-08 147 AVENUE,01,B2,SAMALAD INC.,2,1,1
13838,4136060026,QN,139-11 254 STREET,01,B3,JUAN A. VARGAS,2,1,1
13839,4136290025,QN,137-16 256 STREET,01,A2,RENE ISIDORE,3,2,1
13840,4142310091,QN,99-72 RAU COURT,01,A1,MICHAEL S ODEA,2,1,1
13841,4155440051,QN,11-37 NAMEOKE STREET,01,B3,"PIERRE, ROSENA",2,1,1
13842,4157090006,QN,22-14 LORETTA ROAD,03,D3,"ALLEN BY THE BAY HDFC, INC., AS NOMINEE",2,1,1
13843,4159610092,QN,564 BEACH 43 STREET,01,A6,"HELWIG, DORA",2,1,1
13844,4160490016,QN,69-21 BURCHELL AVENUE,02,C0,BETTER PROPERTIES NY INC.,2,1,1
13845,4160530038,QN,69-10 BEACH CHANNEL DRIVE,02,C0,JOHNSON LEON,2,1,1
13846,4162300033,QN,139 BEACH 120 STREET,02,C1,139 BEACH 120TH STREET REALTY LLC,2,1,1
13847,4162820036,QN,1-41 BEACH 137 STREET,01,A1,141 BEACH 137 STREET LLC,2,1,1
13848,5000540018,SI,77 HIGHVIEW AVENUE,01,A1,BELMAR FAMILY TRUST,3,2,1
13849,5000840001,SI,81 SUMNER PLACE,01,A5,WILLIAM REYES,2,1,1
13850,5001090015,SI,50 CASTLETON AVENUE,01,B2,ZENON K. ZYSK,2,1,1
13851,5001500422,SI,8 ELIZABETH AVENUE,01,A5,"FUSCO, JOSEPH",2,1,1
13852,5001650012,SI,363 NORTH BURGHER AVENUE,01,A1,VICTOR M. CRUZ,2,1,1
13853,5001830008,SI,481 BROADWAY,01,B2,DENNIS MOODY,3,2,1
13854,5002150218,SI,11 DUBOIS AVENUE,01,A1,MT CALVARY HOLY CHURCH,2,1,1
13855,5002160001,SI,107 CAROLINE STREET,01,B2,"MAGORI, LIELLE",2,1,1
13856,5002170044,SI,400 BROADWAY,06,F2,DOUBLE 6 REALTY NY LLC,2,1,1
13857,5002490001,SI,9 UNIVERSITY PLACE,01,A1,"CICERO, PAUL",2,1,1
13858,5002530029,SI,322 SHARON AVENUE,01,A1,ALLEN D BOYER AND KATHLEEN DICKS,2,1,1
13859,5002760038,SI,561 DAVIS AVENUE,01,A1,"BRUSCHI, LOUIS A",2,1,1
13860,5002790078,SI,31 PARK VIEW PLACE,01,A1,"CALCAGNO, HELEN M",2,1,1
13861,5003020035,SI,14 BLAINE COURT,01,A1,MICHAEL ZALL,3,2,1
13862,5003100141,SI,23 PURCELL STREET,01,A1,ANN MARIE WOLD,2,1,1
13863,5003360035,SI,1 SMITH AVENUE,01,A1,"FISHER, RANDY",2,1,1
13864,5003890104,SI,73 BURNSIDE AVENUE,01,B3,"CUCCIO, PETER F",2,1,1
13865,5003980046,SI,154 WARDWELL AVENUE,01,A1,"YABROUDY, JOSEPH A",2,1,1
13866,5006880001,SI,289 OCEAN TERRACE,01,A3,RAMAKRISHNA CHRUKURI,2,1,1
13867,5006940072,SI,109 REON AVENUE,01,B2,"BROGNA, ROBERT",2,1,1
13868,5007220040,SI,48 QUINLAN AVENUE,01,A1,JOSEPH PERAZZO,2,1,1
13869,5007490047,SI,415 NORTH GANNON AVENUE,01,B2,"SHARMA, RAVINDER NATH",2,1,1
13870,5020150032,SI,2059 RICHMOND AVENUE,05,K9,FANELLI FAMILY RICHMOND AVENUE LP,6,5,1
13871,5022440026,SI,94 ST ANDREWS ROAD,01,A3,MARAIO RICHARD,2,1,1
13872,5022870107,SI,375 LIGHTHOUSE AVENUE,01,A2,"MESSINA, SALVATORE",2,1,1
13873,5028200119,SI,145 EDGEWATER STREET,07,T2,JR SEA KNIGHTS-AMER I,2,1,1
13874,5028580105,SI,229 ANDERSON STREET,01,A5,"RADOUANE, OMAR",2,1,1
13875,5029220020,SI,545 TARGEE STREET,05,K8,HOME DEPOT U S A INC,2,1,1
13876,5029700005,SI,257 ST MARYS AVENUE,01,A1,ADRIAN DIAZ,2,1,1
13877,5031160097,SI,84 AUSTIN AVENUE,01,A0,"LESNIAK, MAREK",2,1,1
13878,5032820071,SI,120 PIAVE AVENUE,11,V0,NAPLES CONSTRUCTION COMPANY LLC,2,1,1
13879,5033300030,SI,219 ATLANTIC AVENUE,01,A5,JAMES G RUDOLPH,2,1,1
13880,5035730072,SI,2051 HYLAN BOULEVARD,05,K1,2051-2061 HYLN BLVD LLC,2,1,1
13881,5036060050,SI,140 PRESCOTT AVENUE,01,A1,"THOMAS, ROBERT",2,1,1
13882,5036340017,SI,171 BURBANK AVENUE,01,A2,"WOITKOWSKI, MATTHEW",2,1,1
13883,5038830006,SI,555 GREELEY AVENUE,08,M4,RC CHUR ST MARGARET M,2,1,1
13884,5042200006,SI,313 ROSE AVENUE,01,B2,MIGNANO JOSEPH,2,1,1
13885,5043130027,SI,50 DALTON AVENUE,01,B2,"LIO, PAUL E",2,1,1
13886,5052710003,SI,73 WIMAN AVENUE,01,A1,LATA GEZIME,2,1,1
13887,5052930053,SI,159 RIDGECREST AVENUE,01,A1,JOSEPH STABACH,2,1,1
13888,5053037501,SI,5 HARBOUR COURT,02,R3,NAME NOT ON FILE,63,62,1
13889,5053230006,SI,3942 RICHMOND AVENUE,05,K6,"BRIAN, CRIS, DANA, & ZANE TARANTO LLC",2,1,1
13890,5054410090,SI,23 BLAISE COURT,01,B2,DOUGLAS VAN SISE,2,1,1
13891,5055110076,SI,148 ELTINGVILLE BLVD,01,A1,"BENNETT, MICHAEL",2,1,1
13892,5056100027,SI,47 READING AVENUE,01,A5,"GORBACH, VIKTOR",2,1,1
13893,5056580189,SI,42 WOLCOTT AVENUE,01,A1,DANIEL DUNN,2,1,1
13894,5056960056,SI,81 DETROIT AVENUE,01,A2,"BLANDA AS TRUSTEE, JOSEPH",2,1,1
13895,5059650055,SI,1769 ARTHUR KILL ROAD,07,G3,1769 ARTHUR KILL ROAD LLC,2,1,1
13896,5060450014,SI,22 EVERTON AVENUE,01,B2,GIUSEPPE CONENNA,2,1,1
13897,5067750001,SI, HYLAN BOULEVARD,09,Z8,ST PATS CATH,22,21,1
13898,5067890123,SI,103 SOUTH GOFF AVENUE,01,B2,"Joseph R. Fiorito, Jr.",2,1,1
13899,5068960018,SI,72 FOSTER ROAD,01,A1,"BUTLER, DENNIS",2,1,1
13900,5069200077,SI,975 LAMONT AVENUE,01,B2,"GORVITZ, ROGER J",2,1,1
13901,5069430009,SI,6023 AMBOY ROAD,01,A1,JOSEPH FALLACARO JR,2,1,1
13902,5071520056,SI,2453 ARTHUR KILL ROAD,07,T9,"DONJON MARINE CO., INC.",3,2,1
13903,5074980001,SI,79 PLEASANT PLAINS AVE,01,B2,BEDNARCZYK THOMAS,2,1,1
13904,5074980043,SI,67 GAYNOR STREET,01,B2,D'ANGELO NICHOLAS,2,1,1
13905,5077860037,SI,193 BEDELL AVENUE,01,A1,"FAZIO, NICOLA",2,1,1
13906,5078910039,SI,212 MANHATTAN STREET,01,B2,"ELSON, KARLA",2,1,1
13907,5078930004,SI,364 SLEIGHT AVENUE,01,A1,"MOLINARO, DONNA",2,1,1
13908,5079970056,SI,5301 ARTHUR KILL ROAD,01,B3,"LINDER, CYNTHIA",2,1,1
13909,5080220108,SI,186 FISHER AVENUE,01,A1,J RIDDO,2,1,1
13910,5080230047,SI,5294 ARTHUR KILL ROAD,01,A2,ALSON MICHAEL,2,1,1
13911,1005750067,MN,35 WEST 11 STREET,02,C2,NANCY RUDOLPH ASSOCIATES,2,1,1
13912,1006270008,MN,32 GANSEVOORT STREET,05,O5,32 GANSEVOORT STREET LLC,2,1,1
13913,1007590001,MN,450 9 AVENUE,04,C7,WESTFRONT ASSOCIATES,12,11,1
13914,1008300006,MN,57 WEST 28 STREET,05,O5,JOHN ASSOCIATES LLC,2,1,1
13915,1008300042,MN,258 5 AVENUE,05,O6,FIVE POINTS 260 OWNER LLC,2,1,1
13916,1010420016,MN,335 WEST 51 STREET,08,M2,PH9PAULS HOUSE,2,1,1
13917,1014040110,MN,121 EAST 69 STREET,04,S2,IRA T. TITUNIK,2,1,1
13918,1018600013,MN,145 WEST 105 STREET,02,C6,145-147 WEST 105TH STRET,3,2,1
13919,1020370005,MN,43 MACOMBS PLACE,08,M1,ST MATTHEWS BAPT CHUR,2,1,1
13920,2024410200,BX,655 MORRIS AVENUE,04,D7,MORRIS AVENUE HOUSING DEVELOPMENT FUND C OMPANY INC,2,1,1
13921,2025060081,BX,1256 SHAKESPEARE AVENUE,01,B9,1256 SHAKESPEARE INC,2,1,1
13922,2025080031,BX,1035 ANDERSON AVENUE,03,D3,"ASHLEYS DEFENSE, LLC",2,1,1
13923,2028650179,BX,1665 DAVIDSON AVENUE,02,C0,LORETTA R SMITH,2,1,1
13924,2029000051,BX,1860 WEBSTER AVENUE,07,G3,AMRON REALTY CORP,2,1,1
13925,2029070026,BX,440 EAST 175 STREET,01,B2,"DELACRUZ, JUDITH",2,1,1
13926,2029390015,BX,1520 CROTONA PARK EAST,01,A2,"CLARK, BELIA",2,1,1
13927,2032050013,BX,2618 GRAND AVENUE,01,A1,"TRUONG, JONATHAN",2,1,1
13928,2032730257,BX,609 EAST FORDHAM ROAD,07,G5,"PACO EAST FORDHAM,    .",2,1,1
13929,2032820059,BX,373 EAST 194 STREET,01,B3,CLARA TAPIA,2,1,1
13930,2032990008,BX,3014 BAINBRIDGE AVENUE,02,C0,"SHAHZAD, SAMINA",2,1,1
13931,2033330018,BX,3062 PERRY AVENUE,01,B2,PERRY AVENUE INC. DEFINED BENEFIT PLAN,2,1,1
13932,2033360035,BX,149 E MOSHOLU PARKWAY N,08,W1,NYC DEPARTMENT OF EDUCATION,2,1,1
13933,2033890025,BX,4385 MARTHA AVENUE,01,B3,"MCSHANE, KRISTEN",2,1,1
13934,2034300279,BX,317 HARDING PARK,01,A1,NASHIR ABDUL R,2,1,1
13935,2034450031,BX,158 SOUNDVIEW AVENUE,01,B1,"PEREZ, RAYMOND",2,1,1
13936,2034610021,BX,232 BETTS AVENUE,01,A1,"BROWDER, GEANETTE",2,1,1
13937,2034990033,BX,456 UNDERHILL AVENUE,02,C0,"ALEBDY, ABDULLAH",2,1,1
13938,2035590054,BX,657 THIERIOT AVENUE,01,B1,SOTOMAYOR MARITZA,3,2,1
13939,2035600073,BX,613 LELAND AVENUE,01,A1,"BLANCO, ANA",2,1,1
13940,2035750026,BX,2211 CINCINNATUS AVENUE,02,C3,24 CINCINNATUS CORP.,2,1,1
13941,2035940031,BX,1720 LAFAYETTE AVENUE,01,B1,AURELIO FIGUEROA FAMILY IRREVOCABLE TRUS T AGREEMEN,3,2,1
13942,2037150060,BX,1021 WARD AVENUE,02,C0,"KUMAR, THAKUR PERSAUD",2,1,1
13943,2037360064,BX,1141 COLGATE AVENUE,02,C0,LEONARD MILLS,2,1,1
13944,2037710070,BX,1219 WHEELER AVENUE,02,C1,1219 W REALTY LLC,2,1,1
13945,2037730023,BX,1236 ELDER AVENUE,02,C0,MANUEL MORAN,2,1,1
13946,2038110050,BX,2159 POWELL AVENUE,02,C0,"PERSAUD-SALIM, DRUPATTIE",2,1,1
13947,2038140069,BX,2145 NEWBOLD AVENUE,02,C0,"GOMEZ, CARLOS T",2,1,1
13948,2038320076,BX,2319 NEWBOLD AVENUE,01,B3,F DONOVAN PERUYERO,2,1,1
13949,2038610141,BX,1361 BRONX RIVER AVENUE,02,C0,MASTER DEVELOPMENT 26 CORP.,2,1,1
13950,2038790022,BX,1342A THIERIOT AVENUE,02,C0,"MILLMANN PROPERTIES, LLC C/O FRANK",4,3,1
13951,2038950062,BX,1471 ROSEDALE AVENUE,01,A1,"TIRADO, ZENAIDA",2,1,1
13952,2042580005,BX,1950 CRUGER AVENUE,,Z9,LORC LLC,2,1,1
13953,2044570072,BX,2527 HERING AVENUE,01,A1,"CHAUDHRY, SAGIR M",2,1,1
13954,2045520044,BX,2923 RADCLIFF AVENUE,02,C0,"YU, YOU LEI",2,1,1
13955,2046160016,BX,3208 HERING AVENUE,01,A2,"GONZALEZ , FERNANDO",2,1,1
13956,2046800026,BX,823 EAST 221 STREET,02,C2,"823 EAST 221 STREET, LLC",2,1,1
13957,2046890061,BX,942 EAST 219 STREET,01,B1,MURPHY ARLENE,2,1,1
13958,2047160005,BX,3866 LACONIA AVENUE,01,A2,"SCHEMAN, LUZ N",4,3,1
13959,2048330012,BX,4125 WHITE PLAINS ROAD,04,S2,WPR 230 LLC,2,1,1
13960,2048400009,BX,4005 BARNES AVENUE,02,C0,"AUSTRIE, MALON",2,1,1
13961,2048510028,BX,821 EAST 226 STREET,01,B2,"MCNAUGHTON, RUPERT",2,1,1
13962,2048860067,BX,3446 GRACE AVENUE,01,A1,"VAZQUEZ, JOHN",2,1,1
13963,2048970052,BX,1216 EAST 223 STREET,01,B9,WILLIAMS SAMUEL L,2,1,1
13964,2049490092,BX,4059 BOSTON ROAD,05,GU,"4059 BOSTON POST RLTY,IN",2,1,1
13965,2049900052,BX,2209 STRANG AVENUE,01,A1,"MENDEZ, MERLY",2,1,1
13966,2050830056,BX,4617 WHITE PLAINS ROAD,04,K4,4715-17 WHITE PLAINS RD LLC,2,1,1
13967,2053040001,BX,1201 BALCOM AVENUE,09,Z8,ST RAYMONDS CEMETERY,2,1,1
13968,2053060130,BX,1120 SWINTON AVENUE,01,A1,"O'NEILL, DANIEL",2,1,1
13969,2054000009,BX,1571 HOLLYWOOD AVENUE,02,C0,"LIU, YUSHENG",2,1,1
13970,2054140225,BX,3284 GRISWOLD AVENUE,02,C0,"LOGRANDE, ANTONINO",2,1,1
13971,2054720042,BX,820 THROGS NECK EXPWY SR,01,A2,"BAGGIO, MARIO",2,1,1
13972,2054750045,BX,728 ELLSWORTH AVENUE,01,A2,"MCMILLAN, SUSAN K",2,1,1
13973,2055010111,BX,207 MEAGHER AVENUE,01,B1,LILLIEN MARIANNA,2,1,1
13974,2055200194,BX,3101 HARDING AVENUE,01,B1,"LIN, JING",2,1,1
13975,2055360088,BX,901 BRINSMADE AVENUE,01,B3,KUANJIANG ZHENG,2,1,1
13976,2055760097,BX,4020 EAST TREMONT AVENUE,05,O2,DIPIETRANTONIO ROSA D,2,1,1
13977,2056000057,BX,267 ROBINSON AVENUE,01,A1,"NEAL, ULRIC",2,1,1
13978,2056260121,BX,50 REYNOLDS STREET,01,B1,"LIVINGSTON, JOHN",2,1,1
13979,2056290200,BX,62 HAWKINS STREET,01,A1,"BORRELLI-SAVARESE, MARIE",2,1,1
13980,2056380103,BX,171 ROCHELLE STREET,01,A2,GALINAT DANUTA,2,1,1
13981,3001820057,BK,103 SMITH STREET,04,C7,"103-109 SMITH RESIDENCES, LLC",4,3,1
13982,3003740041,BK,165 LUQUER STREET,02,C0,"SOMEKH, TAL",2,1,1
13983,3004070001,BK,159 3 AVENUE,07,G4,AST HOLDING CORP,4,3,1
13984,3006360063,BK,131 20 STREET,02,C0,"AHMAD, MOHAMMAD S",2,1,1
13985,3006770028,BK,206 31 STREET,01,B9,PASQUALE ROMAGNUOLO,2,1,1
13986,3006850019,BK,194 33 STREET,02,C0,"MARTIN, SHAWN A",2,1,1
13987,3007360047,BK,4422 3 AVENUE,04,S5,4422 3RD AVENUE LLC,2,1,1
13988,3007420069,BK,821 45 STREET,05,O3,BXMK 821 LLC.,2,1,1
13989,3007560045,BK,4624 5 AVENUE,04,S9,4624 5TH AVENUE BROOKLYN LLC,3,2,1
13990,3008910056,BK,283 21 STREET,01,A9,"SHORT, DORIS",2,1,1
13991,3009580023,BK,618 PRESIDENT STREET,02,C3,JOSE ROSARIO,2,1,1
13992,3009600016,BK,701 CARROLL STREET,08,W9,BERKELEY CARROLL SCHOOL,2,1,1
13993,3010350032,BK,316 13 STREET,01,B1,"MARTINEZ, LUIS ORLAND",2,1,1
13994,3010420062,BK,249 15 STREET,01,B2,DOUGLAS E ASHFORD,2,1,1
13995,3011780044,BK,766 FRANKLIN AVENUE,04,S4,"766 FRANKLIN AVENUE PARTNERSHIP, L.P.",3,2,1
13996,3012350017,BK,906 PROSPECT PLACE,03,D1,DRK PROSPECT PLACE LLC,2,1,1
13997,3012400021,BK,788 PARK PLACE,02,C1,788 PARK LLC,2,1,1
13998,3012810057,BK,1055 CARROLL STREET,01,B1,BRICKOUS CHARLES D,2,1,1
13999,3013100062,BK,459 EMPIRE BOULEVARD,01,B9,"YOSEF SUSSKIND, AS TRUSTEE",2,1,1
14000,3013360018,BK,1760 ATLANTIC AVENUE,07,Y6,NYC DEPARTMENT OF SANITATION,3,2,1
14001,3013540039,BK,1568 BERGEN STREET,01,B9,"AHMAD, ADRIANA  L",2,1,1
14002,3014090006,BK,1690 PRESIDENT STREET,04,C7,1690 PRESIDENT STREET LLC,2,1,1
14003,3014090033,BK,1740 PRESIDENT STREET,01,B1,"WP BROWN EQUITIES, LLC",2,1,1
14004,3015530044,BK,1391 HERKIMER STREET,01,B9,"JPMORGAN CHASE BANK, N.A.",2,1,1
14005,3016030011,BK,1034 DEKALB AVENUE,02,C0,1034 DEKALB AVE LLC,2,1,1
14006,3016480019,BK,800 MADISON STREET,08,I7,CARING SUPPORTED HOUSING DEVELOPMENT FUN D,2,1,1
14007,3016780091,BK,453 DECATUR STREET,01,B3,"EISENBERG, ADAM MARK",2,1,1
14008,3017120020,BK,888 HERKIMER STREET,02,C0,"SPENCER, SHAUNA",2,1,1
14009,3018320021,BK,130 JEFFERSON AVENUE,02,C1,"HALL-SIMMONDS, JOANN",2,1,1
14010,3019900010,BK,435 FRANKLIN AVENUE,04,S2,SAWIYATU SOFUWATU L'ISLAM ASSOCIATION IN C,2,1,1
14011,3020440027,BK,83 CARLTON AVENUE,02,C0,83 CARLTON LLC,2,1,1
14012,3020460001,BK,141 CLERMONT AVENUE,01,B2,"MAROTTA, ALEXIS C",2,1,1
14013,3021170033,BK,777 FULTON STREET,04,S9,"JOSEPH, JEAN STERNE",2,1,1
14014,3021787501,BK,170 DIVISION AVENUE,02,R6,UNAVAILABLE OWNER,2,1,1
14015,3022320071,BK,95 LYNCH STREET,02,C0,"BLUM, RACHEL",2,1,1
14016,3024940020,BK,257 FRANKLIN STREET,,Z9,UNAVAILABLE OWNER,2,1,1
14017,3025040026,BK,112 EAGLE STREET,02,C0,"TOMASZEWSKI, HENRY",2,1,1
14018,3025050011,BK,156 EAGLE STREET,02,C2,"HOMAT REALTY, LLC",2,1,1
14019,3027660011,BK,2 BUSHWICK AVENUE,07,G4,EMC2 BUSHWICK LLC,2,1,1
14020,3027810030,BK,663 GRAND STREET,04,S2,YOUNG JA LEE,2,1,1
14021,3027860033,BK,195 LEONARD STREET,01,A9,LAMPON RAMON,3,2,1
14022,3032320069,BK,1261 DEKALB AVENUE,02,C3,"MORALES, JACKELINE A",2,1,1
14023,3034860019,BK,19 MARGINAL ST EAST,01,B2,REALTY REAHABBERS INC.,3,2,1
14024,3035650048,BK,810 HOWARD AVENUE,08,N9,URBAN CENTER/CHANGEHDC,5,4,1
14025,3037240026,BK,258 BRADFORD STREET,02,C0,"MERCURIO, GUY",2,1,1
14026,3038510017,BK,448 NEWPORT STREET,01,B1,"ADAMES, ADA",2,1,1
14027,3039500011,BK,205 BARBEY STREET,01,B2,"PEREZ DEL CID, MARCO",2,1,1
14028,3039520032,BK,170 ASHFORD STREET,01,B2,"CURTIS, HELLEN D",2,1,1
14029,3039710042,BK,288 ESSEX STREET,01,B2,"FLORES, JUDITH",2,1,1
14030,3039790028,BK,260 SCHENCK AVENUE,01,B2,ARA FUNDING GROUP LLC,2,1,1
14031,3039800030,BK,599 GLENMORE AVENUE,01,B2,"PLAZA , CARLOS",2,1,1
14032,3040920004,BK,719 NEW LOTS AVENUE,04,K4,ZUBA LLC,2,1,1
14033,3041060031,BK,838 JAMAICA AVENUE,05,K1,838 JAMAICA AVENUE LLC,3,2,1
14034,3041260008,BK,173 LOGAN STREET,01,B3,"RAMON LOPEZ-GONZALEZ, JOSE",3,2,1
14035,3042460032,BK,278 FOUNTAIN AVENUE,02,C0,"HOQUE, MOHAMED REJAUL",2,1,1
14036,3042980018,BK,658 PENNSYLVANIA AVENUE,01,B1,ADDIE FAULK,2,1,1
14037,3043440001,BK,1868 LINDEN BOULEVARD,07,G3,HAM II REALTY LLC,3,2,1
14038,3046230028,BK,133 CLARKSON AVENUE,08,W1,NYC DEPARTMENT OF EDUCATION,2,1,1
14039,3046950045,BK,929 SCHENECTADY AVENUE,01,A9,"EHIGIATOR, HENRY",2,1,1
14040,3047380062,BK,479 EAST 53 STREET,02,C0,"HECTOR, JACQULIN",2,1,1
14041,3048650030,BK,615 LINDEN BOULEVARD,01,B2,"DRAY, HANNAH",2,1,1
14042,3048830040,BK,4611 CHURCH AVENUE,04,S2,4611 CHURCH AVE LLC,2,1,1
14043,3048850013,BK,14 EAST 32 STREET,01,A5,RYAN ANN,3,2,1
14044,3048910021,BK,282 EAST 38 STREET,01,B9,JAMAICA VENTURES LLC,2,1,1
14045,3049630022,BK,1210 SCHENECTADY AVENUE,01,A9,MANUELA ROBLES,2,1,1
14046,3049910074,BK,1389 TROY AVENUE,01,B1,"ALI, ANNESIA",2,1,1
14047,3050427502,BK,1930 BEDFORD AVENUE,04,RM,1934 BEDFORD LLC,2,1,1
14048,3052150024,BK,2809 NEWKIRK AVENUE,08,W2,ST STEPHEN LUTHERAN CHURCH,4,3,1
14049,3053270029,BK,254 EAST 5 STREET,01,B2,STEVEN COBURN,2,1,1
14050,3053380060,BK,500 CHURCH AVENUE,08,W2,YESHIVAT SHAARE TORAH INC.,2,1,1
14051,3053677501,BK,1502 37 STREET,02,R3,UNAVAILABLE OWNER,8,7,1
14052,3053750069,BK,383 OCEAN PARKWAY,04,S2,BS OCEAN PARKWAY LLC,2,1,1
14053,3053800019,BK,1632 42 STREET,01,B2,"GUTWEIN, RAIZY",2,1,1
14054,3054410022,BK,15 PARKVILLE AVENUE,06,F5,15 PARKVILLE LLC,2,1,1
14055,3054790018,BK,1724 53 STREET,01,A5,"ROSEN, BLIMA",2,1,1
14056,3055050046,BK,1877 59 STREET,01,B3,"FELDMAN, YOCHEVED",2,1,1
14057,3055870038,BK,4002 FT HAMILTON PARKWAY,08,W1,ST CATHERINE ALEXANDR,4,3,1
14058,3056300004,BK,4715 14 AVENUE,01,B1,14TH AVE. BAYIS CORP.,2,1,1
14059,3056470070,BK,1115 51 STREET,01,A3,"SINGER, MALKA",2,1,1
14060,3056680076,BK,1105 54 STREET,08,M1,CONGREGATION BETH HIL,2,1,1
14061,3056750018,BK,1130 54 STREET,01,A5,RL 9-12 TRUST,2,1,1
14062,3058820026,BK,90 70 STREET,01,B3,"MANDALA, JEROME P",2,1,1
14063,3058920038,BK,464 OVINGTON AVENUE,01,B3,464 OVINGTON LLC,2,1,1
14064,3059760023,BK,76 79 STREET,01,A1,DOUGLAS LAZZARO R,2,1,1
14065,3059930003,BK,8017 10 AVENUE,01,B3,"YU, DON LOK",2,1,1
14066,3060160021,BK,246 83 STREET,01,A3,"FOUNDOULAKIS, JOHN",2,1,1
14067,3060217501,BK,936 83 STREET,02,R3,UNAVAILABLE OWNER,4,3,1
14068,3062100042,BK,7416 13 AVENUE,05,K1,THE CATHERINE FERRARA SABELLA REVOCABLE,2,1,1
14069,3062840046,BK,8002 18 AVENUE,02,C0,"TRUNCALI IRREVOCABLE TRUST, DATED 09/25/ 2013",3,2,1
14070,3062870058,BK,2047 81 STREET,01,A5,"JULIANO, ANGELA",2,1,1
14071,3063280008,BK,8305 19 AVENUE,02,C0,"RUAN, HUOMIN",2,1,1
14072,3063380020,BK,1234 85 STREET,01,A1,"MARINO, LINDA",2,1,1
14073,3063430001,BK,1701 86 STREET,04,K4,BRUCE SOLOMON,2,1,1
14074,3064017501,BK,8719 BAY 16 STREET,02,R3,UNAVAILABLE OWNER,5,4,1
14075,3064470023,BK,187 BAY 29 STREET,02,C0,"WONG, WAN TIK",2,1,1
14076,3064610319,BK,314 BAY 13 STREET,01,A5,"CHEN, ZHI JUAN",2,1,1
14077,3065090089,BK,809 OCEAN PARKWAY,01,B2,"CARLEBACH, Y BILLIE",2,1,1
14078,3065340037,BK,1170 EAST 9 STREET,01,B2,"KHEZRIE, NANCY",2,1,1
14079,3065360055,BK,1177 EAST 10 STREET,01,A9,1177 EAST TENTH STREET RESIDENCE TRUST,2,1,1
14080,3065440039,BK,1274 EAST 9 STREET,01,B2,"OZEIREY, DAVID",2,1,1
14081,3065700075,BK,1417 EAST 7 STREET,01,A7,DAVID CHETRIT,2,1,1
14082,3065880007,BK,616 AVENUE N,01,B2,BREVOORT REALTY LLC C,2,1,1
14083,3066070058,BK,1555 DAHILL ROAD,02,C0,FENG HONGSHU,2,1,1
14084,3066100021,BK,1630 EAST 4 STREET,01,B1,1630 EAST 4TH STREET LLC,2,1,1
14085,3066390059,BK,1747 EAST 7 STREET,01,A9,LEAH M LEW,2,1,1
14086,3066830022,BK,1832 EAST 8 STREET,01,A1,IG GINDI 2009 GENERATIONAL TRUST,2,1,1
14087,3067560033,BK,1470 EAST 19 STREET,01,B1,BLUMBERG ANDREW M,2,1,1
14088,3068050059,BK,1821 EAST 22 STREET,01,A1,"SHOUELA, ISAAC",2,1,1
14089,3068300071,BK,1837 EAST 24 STREET,01,A3,"ELMANN, MINDY",3,2,1
14090,3069150016,BK,116 28 AVENUE,02,C0,"LI THOMAS, WEI BIN",2,1,1
14091,3069240121,BK,2517 WEST 17 STREET,01,B2,"CHEN, JIN XIAN",2,1,1
14092,3069940023,BK,1726 HART PLACE,10,G1,3100 CROPSEY AVENUE LLC,2,1,1
14093,3070360076,BK,4710 SURF AVENUE,01,B2,"ZELINSKAYA, SVETLANA",2,1,1
14094,3071040204,BK,1969 EAST 1 STREET,01,A3,CATTON  DAVID,2,1,1
14095,3071230033,BK,38 VILLAGE ROAD NORTH,01,A9,ARMOND SORRENTINO,2,1,1
14096,3071310012,BK,2178 EAST 5 STREET,01,B2,SHVUT UZI,2,1,1
14097,3071350075,BK,2109 EAST 8 STREET,02,C0,"SETTON, REGINE",2,1,1
14098,3071470066,BK,20 VILLAGE COURT,01,B3,"TAWIL, DEBORAH",2,1,1
14099,3071570086,BK,2259 EAST 5 STREET,02,C0,ELIE 2259 LLC,2,1,1
14100,3071580017,BK,2262 EAST 7 STREET,02,C0,JACK BIKHAR,2,1,1
14101,3071590014,BK,2216 EAST 8 STREET,01,B3,"ESSES, JOSEPH",2,1,1
14102,3071760004,BK,346 AVENUE W,01,A3,"346 AVENUE W, LLC",2,1,1
14103,3071770058,BK,2349 EAST 1 STREET,01,B1,"ALAHAB , NATAN",2,1,1
14104,3072240036,BK,727 GERALD COURT,01,A9,PHILIP DE LEON,2,1,1
14105,3072900074,BK,2251 CONEY ISLAND AVENUE,01,A9,2251 SDM LLC.,2,1,1
14106,3072910128,BK,1227 AVENUE T,01,A9,"SALMAN, RAFAEL",2,1,1
14107,3073120028,BK,1958 FORD STREET,01,A1,"MOUADEB, RON",2,1,1
14108,3073160005,BK,1212 AVENUE T,01,B3,DAVID CHUNG,2,1,1
14109,3075570019,BK,113 KENILWORTH PLACE,04,D7,1520 MANAGEMENT CORP.,2,1,1
14110,3075840074,BK,1104 EAST 21 STREET,01,A1,"LASRY, HELENA",2,1,1
14111,3075850071,BK,1038 EAST 22 STREET,01,A5,"GLATT, MANUEL",2,1,1
14112,3076400053,BK,1212 EAST 23 STREET,01,B2,"PROBST, EDWARD H",2,1,1
14113,3076410042,BK,2300 AVENUE L,01,A3,EDDIE SITT,2,1,1
14114,3076470011,BK,1283 EAST 29 STREET,01,A1,ABRAHAM Y BERGMAN,2,1,1
14115,3076490034,BK,1227 EAST 31 STREET,01,B2,"FELDMAN, JUDY",2,1,1
14116,3076490071,BK,1266 EAST 32 STREET,01,A1,"SUSSMAN, YECHEZKEL",2,1,1
14117,3076750035,BK,1567 EAST 21 STREET,01,B3,"MOSES, DEBORAH",2,1,1
14118,3076900027,BK,1541 EAST 29 STREET,01,A1,"ZWICK, JEFFREY",2,1,1
14119,3076930016,BK,1573 EAST 31 STREET,01,B1,"CAHANE, CHAIM",2,1,1
14120,3077910026,BK,1139 EAST 43 STREET,01,A9,NIEVES GEORGE,2,1,1
14121,3078220057,BK,2032 EAST 41 STREET,01,B1,2032 EAST 41 LLC,2,1,1
14122,3078420012,BK,2153 TROY AVENUE,01,A9,"ST. LOUIS, CLAYVAN",2,1,1
14123,3078810069,BK,1356 EAST 57 STREET,01,A9,"MCKENZIE, ELEANORA",2,1,1
14124,3078950016,BK,2223 UTICA AVENUE,07,G9,GJB UTICA AVE REALTY CORP.,2,1,1
14125,3078960062,BK,1700 EAST 52 STREET,01,A1,JOSEPH ARNAO,2,1,1
14126,3079860018,BK,657 EAST 81 STREET,01,B1,"BROWN, OLIVE",2,1,1
14127,3080120400,BK,6020 FLATLANDS AVENUE,,Z9,NYS DEPARTMENT OF TRANSPORTATION,15,14,1
14128,3082200149,BK,1270 EAST 94 STREET,01,B2,"WHITELY, NEVILLE A",2,1,1
14129,3084070052,BK,2059 EAST 64 STREET,01,A1,"YEDID, RAFI",2,1,1
14130,3085070030,BK,1921 KIMBALL STREET,01,A1,JOSE R DOMINGUEZ,2,1,1
14131,3085230062,BK,2042 EAST 38 STREET,01,A5,"MARABELLO, JOSEPH R",2,1,1
14132,3085460047,BK,2016 EAST 55 STREET,01,A9,"PARWAIZ, RAJA TABISH",4,3,1
14133,3086660652,BK,2909 BRIGHTON 6 STREET,08,M1,HEBREW ALL BRIGHTON B,3,2,1
14134,3087240205,BK,257 CORBIN PLACE,01,B1,RAMAZ ASHUROV,2,1,1
14135,3089390908,BK,72 BEVY COURT,01,B2,JAMES RELAY,2,1,1
14136,4000480048,QN,46-09 VERNON BOULEVARD,01,B9,LOMBARDI ERASMO,2,1,1
14137,4002360001,QN,36-17 GREENPOINT AVENUE,04,S3,"3615 GREENPOINT, LLC",3,2,1
14138,4003870028,QN,38-20 27 STREET,02,C0,"ZARATE, JOSE B",3,2,1
14139,4004187501,QN,29-11 QUEENS PLAZA NORTH,04,RM,UNAVAILABLE OWNER,2,1,1
14140,4006920051,QN,31-16 43 STREET,01,B1,LUIS LEON,2,1,1
14141,4007610069,QN,47-21 DITMARS BOULEVARD,01,A0,4721 DITMARS BLVD LLC,2,1,1
14142,4008450062,QN,28-13 23 AVENUE,04,S1,KONSTATINE PSALIDAS,2,1,1
14143,4008740045,QN,21-23 24 DRIVE,01,B3,"TSAPROUNIS, DIMITRIOS",2,1,1
14144,4008870032,QN,25-35 18 STREET,04,C7,NOMI DEVELOPMENT LLC,2,1,1
14145,4008880009,QN,18-23 25 ROAD,01,B2,18-23 25TH ROAD REALTY LLC,2,1,1
14146,4009440069,QN,19-45 75 STREET,02,C0,"ANTONIO GUADAGNINO, AS TRUSTEE",2,1,1
14147,4010060023,QN,22-40 75 STREET,01,B3,"KEDZIERSKA, ALINA",2,1,1
14148,4010120026,QN,22-44 81 STREET,01,A5,KONSTANTINOS BLAFAS,2,1,1
14149,4012260080,QN,39-58 56 STREET,01,B1,"CHU, GRACE",2,1,1
14150,4013320105,QN,41-28 60 STREET,01,B1,"JOA, JOHNNY",2,1,1
14151,4013740143,QN,26-45 94 STREET,01,A1,GERTRUDE KIERNAN,2,1,1
14152,4015910061,QN,94-36 41 ROAD,02,C0,ZHANG & CHEN PROPERTY LLC,2,1,1
14153,4016510057,QN,25-19 MCINTOSH STREET,01,A5,"INGA, JUAN",2,1,1
14154,4016520053,QN,25-11 HUMPHREYS STREET,01,A5,DAYROVIS OBJIO,2,1,1
14155,4017470072,QN,35-27 105 STREET,02,C0,"ORELLANA, WALTER M",2,1,1
14156,4017530091,QN,35-27 109 STREET,02,C2,RRR UNITED REALTY LLC,2,1,1
14157,4018350036,QN,50-08 88 STREET,02,C3,"PENG, MEI HSIEN",2,1,1
14158,4018570027,QN,90-56 55 AVENUE,02,C0,"WANG, WEN QING",2,1,1
14159,4019350012,QN,104-34 CORONA AVENUE,04,S5,"104-34 CORONA, INC.",2,1,1
14160,4019840037,QN,40-08 108 STREET,04,S5,"169TH STREET DEVELOPMENT, LLC",2,1,1
14161,4020050021,QN,108-44 49 AVENUE,02,C3,AB VASQUEZ GROUP LLC,2,1,1
14162,4020090059,QN,109-25 54 AVENUE,01,B2,CARPIO MARIO,2,1,1
14163,4020880022,QN,96-27 QUEENS BOULEVARD,07,G4,ALLIANCE ENERGY LLC,2,1,1
14164,4022210017,QN,108-24 JEWEL AVENUE,01,A3,POLINA NATANOVA,2,1,1
14165,4023180068,QN,58-15 48 AVENUE,02,C0,"ZHANG, LI PING",2,1,1
14166,4024840084,QN,52-86 73 STREET,01,A5,"ORLANDO, FRANK L",2,1,1
14167,4024970007,QN,53-51 69 STREET,01,B3,"CHO, EILEEN YI",2,1,1
14168,4025370022,QN,54-28 46 STREET,06,E1,MASPETH SKYLINE HOLDING LLC,2,1,1
14169,4027080016,QN,61-22 55 DRIVE,01,B2,"HREHOROWICZ, IGNACY",2,1,1
14170,4027960001,QN,69-54 GRAND AVENUE,04,S2,69-54 GRAND AVENUE LLC,2,1,1
14171,4028680017,QN,86-42 55 ROAD,01,A1,LOPEZ ALFONSO,2,1,1
14172,4030420059,QN,65-27 79 PLACE,01,A1,WALTER J TUFT,2,1,1
14173,4030640025,QN,77-31 66 DRIVE,01,B2,"XING, GUANG RONG",2,1,1
14174,4030670017,QN,66-04 79 STREET,01,B3,66-04 79TH STREET LLC,2,1,1
14175,4031110043,QN,63-35 CARLTON STREET,01,B3,"ILYAYEV, BORIS",2,1,1
14176,4031970051,QN,68-29 KESSEL STREET,01,A1,"DISLA, ORLANDO",2,1,1
14177,4032050039,QN,68-23 CLYDE STREET,01,B1,"MOI, LING FANG",2,1,1
14178,4032080015,QN,69-18 NANSEN STREET,01,A1,ISTARKI ILDAR,2,1,1
14179,4033510041,QN,104 82 ROAD,01,A3,"BANK, ISABEL S",2,1,1
14180,4035500055,QN,960 CYPRESS AVENUE,07,G4,"DZIARDZIEL, DANIEL",2,1,1
14181,4035910029,QN,72-72 61 STREET,04,S4,"PARAGAN, DAVE",2,1,1
14182,4036080058,QN,64-06 ADMIRAL AVENUE,06,F5,6406 ADMIRAL AVENUE LLC,2,1,1
14183,4037120035,QN,79-28 60 LANE,01,B2,"TINEO, RAFAEL",2,1,1
14184,4037730043,QN,67-20 78 STREET,02,C0,"GANCI (LIFE ESTATE), MARGHERITA",2,1,1
14185,4038700129,QN,82-60 89 STREET,01,A1,"CUSTODIO, GABRIEL",2,1,1
14186,4039360056,QN,5-20 COLLEGE PLACE,01,B2,"PAREJAS, ALBERTO",2,1,1
14187,4039550046,QN,6-14 128 STREET,01,B1,"HUANG, BI HUA",2,1,1
14188,4039740066,QN,9-23 126 STREET,01,B3,DONNA ANN FINN,2,1,1
14189,4040240046,QN,10-25 117 STREET,01,A2,"BILIK, MICHAEL R",2,1,1
14190,4042490071,QN,23-52 144 STREET,01,A5,"LAMPA, CARMEN",2,1,1
14191,4042910016,QN,119-39 27 AVENUE,01,B3,"MEIER, DIEDERICH",2,1,1
14192,4045170034,QN,12-14 CLINTONVILLE STREET,01,B2,"D''AMICO, SALVATORE",2,1,1
14193,4045180046,QN,150-37 14 AVENUE,05,O2,"MULTI-SOUND STUDIOS 2, LLC",2,1,1
14194,4045580017,QN,157-37 12 ROAD,01,A1,"CERASUOLO, CARMINE",2,1,1
14195,4045950075,QN,162-19 CRYDERS LANE,01,A1,"OLIVIERI, CLARICE",2,1,1
14196,4046490007,QN,147-05 17 AVENUE,01,A1,MCALEER MARYANN,2,1,1
14197,4046550023,QN,20-40 149 STREET,01,B3,"COLOMA , HERBERT  R",2,1,1
14198,4046740025,QN,23-10 150 STREET,01,B3,GINO CIARNIELLO REVOCABLE LIVING TR,2,1,1
14199,4047030080,QN,151-14 17 AVENUE,01,B3,PRASSOS HELEN,2,1,1
14200,4047140028,QN,151-58 24 ROAD,01,A1,"HUANG, YAO E",2,1,1
14201,4048160036,QN,30-28 150 STREET,01,B2,"LI, XIAOPING",2,1,1
14202,4048710068,QN,28-29 159 STREET,01,A2,"KINKELA, TRUSTEE, DAVID",2,1,1
14203,4049717502,QN,36-32 MAIN STREET,05,RC,UNAVAILABLE OWNER,2,1,1
14204,4051940032,QN,43-11 ROBINSON STREET,01,B2,"QING FA, CHEN",2,1,1
14205,4052400057,QN,33-50 156 STREET,01,A1,"FATTUTA, WILLIAM J",2,1,1
14206,4054150022,QN,43-29 157 STREET,01,B1,4329 157 ST LLC,2,1,1
14207,4054280024,QN,43-31 170 STREET,01,B1,"FELLIN, PHILIP",2,1,1
14208,4055160042,QN,43-58 193 STREET,01,A1,"SKASILAS, BILL",2,1,1
14209,4055630011,QN,47-23 164 STREET,01,A1,ELTAWIL BARBARA,2,1,1
14210,4058020001,QN,201-05 26 AVENUE,01,A1,"ZHANG, MING LEI",2,1,1
14211,4060740010,QN,198-22 33 AVENUE,01,A5,"MA, QIN",2,1,1
14212,4060850049,QN,34-07 203 STREET,01,A1,MARIO MERCADO,2,1,1
14213,4063530009,QN,130-14 58 AVENUE,01,B1,MICHAEL DELLICARPINI REVOCABLE TRUST DAT ED 8/30/94,2,1,1
14214,4063860021,QN,136-46 61 ROAD,05,O2,6122 138 HOLDING LLC,2,1,1
14215,4071680013,QN,73-21 180 STREET,01,A3,"SHIMONOV, DANIL",2,1,1
14216,4072520013,QN,82-09 KENT STREET,01,A1,"MUSHIBAYEV, ALBERT",2,1,1
14217,4073530133,QN,47-21 201 STREET,01,A0,"DURAND, MARIA",2,1,1
14218,4079970006,QN,237-53 93 AVENUE,01,A1,"EVANGELISTA, AGOSTINNO",2,1,1
14219,4081170007,QN,247-14 43 AVENUE,01,A5,"JIN,  YI",2,1,1
14220,4086670001,QN,250-01 JERICHO TURNPIKE,05,GU,"HERBERT LINDENBAUM FAMILY PARTNERSHIP, I I",2,1,1
14221,4089000006,QN,75-14 88 AVENUE,01,A1,SUKHNATH DREPAUL,2,1,1
14222,4089620110,QN,91-58 84 STREET,01,A5,"YE, PENG",2,1,1
14223,4090210013,QN,95-18 86 STREET,01,B9,"SAMPAYO, JOSHUA",2,1,1
14224,4090790018,QN,78-25 LIBERTY AVENUE,02,C3,"NATH, RATAN K",2,1,1
14225,4090960007,QN,90-14 101 AVENUE,07,G2,"SINGH, BHOOPAUL",2,1,1
14226,4090990016,QN,101-24 93 STREET,01,B9,"PINEDO , MARIA",2,1,1
14227,4091360163,QN,107-04 78 STREET,01,A1,MONTERO VICTOR,2,1,1
14228,4091550061,QN,107-27 90 STREET,01,A1,AKBAR KHAN,3,2,1
14229,4092050035,QN,86-70 110 STREET,02,C0,ALFONSO ALBAN,2,1,1
14230,4092780088,QN,86-31 124 STREET,02,C0,"FENNING, ROMA",2,1,1
14231,4092840058,QN,86-35 132 STREET,01,B2,ABDUL SHAFIEK,2,1,1
14232,4093290058,QN,87-83 LEFFERTS BOULEVARD,02,C3,87-83 LEFFERTS BOULEVARD LLC,2,1,1
14233,4093430022,QN,89-32 117 STREET,01,B1,"SINGH, JARNAIL",2,1,1
14234,4093530049,QN,89-19 126 STREET,07,G2,"SELLAM, JOSIANNE",3,2,1
14235,4094200008,QN,102-18 101 AVENUE,04,S9,"BEN DAVID REALTY, LLC",2,1,1
14236,4094240009,QN,106-20 101 AVENUE,02,C0,"AKAND,   NAZMA",2,1,1
14237,4094650028,QN,124-05 101 AVENUE,02,C3,RAJINDRA ROOPLALL,4,3,1
14238,4094790026,QN,133-05 97 AVENUE,01,B3,"TRUCIOS, RAFAEL",2,1,1
14239,4095270004,QN,104-08 LIBERTY AVENUE,05,K1,SHOP-RITE HARWARE INC,2,1,1
14240,4096090005,QN,129-10 107 AVENUE,01,B3,LIBERTY CORNER MANAGEMENT LLC,2,1,1
14241,4096250013,QN,139-30 QUEENS BOULEVARD,05,O2,TEACHERS FEDERAL CREDIT UNION,2,1,1
14242,4096310022,QN,136-07 87 AVENUE,01,B3,OROPEZA JULIO,2,1,1
14243,4097030049,QN,144-59 87 ROAD,01,B3,"DEBNATH, SHUVASHISH",3,2,1
14244,4097280017,QN,151-10 85 DRIVE,01,B2,"DAPHNIS, GUS",2,1,1
14245,4097630001,QN,87-85 153 STREET,01,A1,BUNDHOO SEELOCHANIE,2,1,1
14246,4097740169,QN,162-05 86 AVENUE,01,A1,"CHIMBORAZO, MARIA A",2,1,1
14247,4097960022,QN,91-11 MERRICK BOULEVARD,05,K2,JMS REALTY ASSOCIATES C/O COOKIES DEPT S TORES INC,2,1,1
14248,4098510017,QN,85-37 168 STREET,08,M1,JAMAICA MUSLIM CNTRINC,2,1,1
14249,4099060018,QN,90-22 185 STREET,02,C0,HERNANDEZ LEOPOLDO,2,1,1
14250,4099150026,QN,88-15 179 PLACE,01,B3,"ISHMAEL, SHAWZAM",2,1,1
14251,4099700121,QN,88-82 138 STREET,01,B1,"AHMED, REDWAN",2,1,1
14252,4100180062,QN,101-19 REMINGTON STREET,01,B3,"KAUR, DAVINDER",2,1,1
14253,4100480021,QN,145-19 TUSKEGEE AIRMEN WAY,01,A1,"BETHEL, JOSIE S",2,1,1
14254,4100700117,QN,107-12 REMINGTON STREET,01,A1,"TATE, RONALD",2,1,1
14255,4101280039,QN,106-58 UNION HALL STREET,08,M1,MT ZION BAPTIST CHURCH,2,1,1
14256,4102740032,QN,110-23 175 STREET,01,B3,"TAVAREZ, SANTA",2,1,1
14257,4102820128,QN,111-24 173 STREET,01,A1,"JOHNSON, MAAT",2,1,1
14258,4103770029,QN,104-38 FARMERS BOULEVARD,01,A1,"ELLIOTT, KAREN",2,1,1
14259,4104150031,QN,185-35 HILBURN AVENUE,01,A1,"MONT, CAROLYN",2,1,1
14260,4104370030,QN,110-30 FARMERS BOULEVARD,05,K1,110 FARMERS BLVD REALTY LLC,2,1,1
14261,4104700008,QN,197-16 89 AVENUE,01,A1,GIRJAPRASHAD,3,2,1
14262,4105140024,QN,86-47 CLIO STREET,01,A1,"BABEKOV, GEORGI",2,1,1
14263,4105260008,QN,198-14 EPSOM COURSE,01,A1,"MUNAROV, YURIY",2,1,1
14264,4105270021,QN,199-29 ROMEO COURT,01,A1,DEAN E MAFFEI,2,1,1
14265,4106190043,QN,93-26 216 STREET,01,A1,"AZIZ, WAZIM",2,1,1
14266,4106250002,QN,92-04 213 STREET,01,A1,JYJ LLC.,2,1,1
14267,4106550048,QN,89-08 214 STREET,01,A1,"AUTAR, CHANDROUTIE",3,2,1
14268,4106590012,QN,89-85 215 PLACE,01,A1,CZERW ANTHONY,2,1,1
14269,4108610046,QN,100-30 195 STREET,01,A1,JOVODA Y. COOPER,3,2,1
14270,4109080025,QN,104-40 205 PLACE,01,B3,"SANDERS, LARRY",2,1,1
14271,4109330004,QN,196-16 HOLLIS AVENUE,01,B1,"MD MAINUDDIN, ABU NOMAN",2,1,1
14272,4109610505,QN,111-02 204 STREET,01,A1,"HOWELL, AMETH",2,1,1
14273,4110180012,QN,114-14 202 STREET,01,A5,"CRICHLOW, RUDOLPH",2,1,1
14274,4110430031,QN,202-05 116 AVENUE,01,A1,SHIRLEY JONES,2,1,1
14275,4110710038,QN,116-16 200 STREET,01,B2,"CALVERT, TESSANN",3,2,1
14276,4111560006,QN,220-07 104 AVENUE,01,A1,COLUMBUS MOLETTE,2,1,1
14277,4111640071,QN,105-12 220 STREET,01,A1,"KATSARAS, ADAMANTIA",2,1,1
14278,4113540021,QN,132-02 CROSS BAY BOULEVARD,04,K4,"BISSOONDYAL, GANGARAM",2,1,1
14279,4116850038,QN,128-03 FOCH BOULEVARD,08,M1,OZONE PARK CHURCH OFNAZARENE,2,1,1
14280,4118760136,QN,134-14 135 AVENUE,01,B2,"RAMOS, WILFREDO",2,1,1
14281,4119630038,QN,111-60 147 STREET,01,A1,"COLEMAN, HELEN M",2,1,1
14282,4120580197,QN,128-06 142 STREET,01,A5,W M TURNER,2,1,1
14283,4121060040,QN,128-16 148 STREET,01,A1,TOWLER EUCLINE,2,1,1
14284,4121080026,QN,149-06 SUTTER AVENUE,01,A1,1430 BRYANT CAPITAL GROUP LLC,2,1,1
14285,4121550001,QN,111-13 SUTPHIN BOULEVARD,08,M1,SATSANG AMERICA INC,2,1,1
14286,4121740105,QN,111-22 159 STREET,01,A1,"CLAYVON, THOMAS",2,1,1
14287,4121940016,QN,114-37 157 STREET,01,A1,"MONDAL, CHANCHAL C",2,1,1
14288,4121940022,QN,157-04 MEYER AVENUE,02,C2,"WILLIAMS, ROBIN",2,1,1
14289,4121970012,QN,115-14 158 STREET,01,A1,"HAYNES, CARLTON C",2,1,1
14290,4122800009,QN,155-20 132 AVENUE,01,B3,"HOSSAIN, MOHAMMED K",2,1,1
14291,4123660044,QN,117-19 169 STREET,01,A1,"LINTON, PAMELA",2,1,1
14292,4124030069,QN,115-41 172 STREET,01,B3,"PARRIS, WENDELL",2,1,1
14293,4126680078,QN,188-05 122 AVENUE,01,A1,"O''BRIEN, GEORGE",2,1,1
14294,4127450039,QN,117-33 228 STREET,01,A2,VITT 0701 WALKER LLC,2,1,1
14295,4129130046,QN,234-16 130 AVENUE,01,A2,CLARENCE WITHERSPOON,2,1,1
14296,4129430087,QN,131-75 232 STREET,01,A1,"ROBERTS, TAJMA",2,1,1
14297,4130690021,QN,222-29 143 AVENUE,01,A1,"THORPE, ONIEL C",2,1,1
14298,4130800005,QN,184-07 144 AVENUE,01,A2,"SIMPSON,JODI A.",2,1,1
14299,4131370026,QN,223-02 138 AVENUE,01,A1,"JOHNSON, FLORENCE",2,1,1
14300,4132100006,QN,133-62 HOOK CREEK BOULEVARD,01,A1,"AMANDAZI, EVERMOND",2,1,1
14301,4132720039,QN,44-53 166 STREET,01,A1,ROBERT J CLOWNEY,2,1,1
14302,4133560036,QN,146-52 183 STREET,01,B3,"MITCHELL, ANNETTE J",2,1,1
14303,4134590003,QN,225-11 147 AVENUE,01,A2,"PARRIS-TATE, JASMINE",2,1,1
14304,4135960027,QN,248-04 FRANCIS LEWIS BLVD,01,B3,"VELASQUEZ, ROBERTO",3,2,1
14305,4135990040,QN,245-06 FRANCIS LEWIS BLVD,05,K1,ALMONTE FRANCIS BLVD REALTY LLC,2,1,1
14306,4136020010,QN,145-11 FRANKTON STREET,01,A1,MILTON WALKER,2,1,1
14307,4136030029,QN,257-02 HOOK CREEK BOULEVARD,01,A1,AKINYEMI TITILOLA A,2,1,1
14308,4136050042,QN,141-22 256 STREET,01,B3,"BAILEY, DENNIS J",2,1,1
14309,4141720069,QN,158-45 102 STREET,01,A1,"ZINNANTI, ANTONINO",2,1,1
14310,4142401329,QN,162-28 104 STREET,01,A1,JERRY SANTANGELO,2,1,1
14311,4153080071,QN,615 CROSS BAY BOULEVARD,01,B2,"PORCELLA, DANIEL",3,2,1
14312,4155050001,QN,13-11 VIRGINIA STREET,08,I6,ROCKAWAY REAL ESTATE HOLDINGS ASSOCIATES  LLC,2,1,1
14313,4160370010,QN,420 BEACH 64 STREET,01,B9,"SMITH, REUBEN",2,1,1
14314,4161830021,QN,110-06 BEACH 110 STREET,08,W2,ROCKLYN ECCLESIASTICAL CORP.,2,1,1
14315,4162950050,QN,418 BEACH 145 STREET,01,A2,GENNADIY KORAMBLYUM,2,1,1
14316,4163200030,QN,151 BEACH 146 STREET,01,A7,"GEYMAN, ANATOLY",2,1,1
14317,5000240043,SI,190 DANIEL LOW TERRACE,01,A1,"GJONBALIQ, RABA",2,1,1
14318,5000490164,SI,244 WESTERVELT AVENUE,01,A1,"ALWILL, JOHN",2,1,1
14319,5001320219,SI,114 DELAFIELD AVENUE,01,A1,"MALLEN, JR., THOMAS A",2,1,1
14320,5001520029,SI,260 PELTON AVENUE,01,A1,"OLIVO, MICHAEL JR",2,1,1
14321,5001550120,SI,426 PELTON AVENUE,01,A2,HELEN L CRIMMINS,2,1,1
14322,5001560065,SI,135 REGAN AVENUE,01,A2,"MARKE, EDUARD",2,1,1
14323,5002360043,SI,810 POST AVENUE,01,B2,"LA MORTE, RAFFAELLA",2,1,1
14324,5002610045,SI,30 CITY BOULEVARD,01,A1,CLAUDIA GARCENOT,2,1,1
14325,5003260367,SI,65 LAKELAND ROAD,01,A2,"DANISCHEWSKI, MARC C",2,1,1
14326,5003490039,SI,78 BEECHWOOD PLACE,01,B1,MAUREEN D. CARLO,2,1,1
14327,5003560204,SI,166 BENEDICT AVENUE,01,A2,PAUL A POLLASTRO JR,2,1,1
14328,5003650169,SI,25 MERRIMAN AVENUE,01,A1,"BARR, KERRIE MOLLOY",2,1,1
14329,5005060008,SI,204 VAN DUZER STREET,01,A1,OUR HOME LTD,2,1,1
14330,5005670024,SI,282 TARGEE STREET,02,C0,STROMFELD ALAN,2,1,1
14331,5006480077,SI,57 HAMILTON STREET,01,A5,HECTOR CORREA,2,1,1
14332,5006530018,SI,1336 CLOVE ROAD,01,A1,AHMAD AZIZI,2,1,1
14333,5006550024,SI,1390 CLOVE ROAD,01,B1,SALVATORE TROIA,2,1,1
14334,5006810111,SI,21 AYMAR AVENUE,01,A1,"ROSENZWEIG , AARON",3,2,1
14335,5007110006,SI,8B GARDEN STREET,01,A5,"CARLO, GERALD  R",2,1,1
14336,5007230037,SI,52 PERRY AVENUE,01,A2,SALTARELLI THOMAS A,2,1,1
14337,5007290027,SI,88 MANN AVENUE,01,B2,"GRIGOS, ANTHONY",2,1,1
14338,5007520109,SI,190 ELVIN STREET,01,A2,JOHN ESPOSITO,2,1,1
14339,5008490150,SI,40 DELLWOOD ROAD,01,A1,"KETA, EDMOND",2,1,1
14340,5010390250,SI,25 DERBY COURT,01,A5,"GERHARDT, DOLORES",2,1,1
14341,5010400029,SI,16 PALMER AVENUE,01,A1,SERE RICHARD J,2,1,1
14342,5010470057,SI,19 HOMESTEAD AVENUE,01,A1,"VENDITTI, PATRICIA",2,1,1
14343,5012000080,SI,312 VAN NAME AVENUE,01,A2,"DORANS, EDWARD J",2,1,1
14344,5012570022,SI,215 SOUTH AVENUE,01,A2,"GRAY, JACQUELINE",2,1,1
14345,5012670064,SI,4 BENJAMIN PLACE,01,A5,L C COOPLAND,2,1,1
14346,5014610017,SI,382 LATHROP AVENUE,01,A2,"STOFFERS, BRIANNE T",2,1,1
14347,5014810142,SI,28 DEVENS STREET,01,B2,MICHAEL J. GIORDANO,2,1,1
14348,5015080030,SI,343 WILLOW ROAD EAST,01,A1,"MOLEY, JOHN",2,1,1
14349,5021510022,SI,163 DAWSON CIRCLE,01,B2,"MIRZO, ARSIAN",2,1,1
14350,5026290082,SI,63 MILDRED AVENUE,01,A1,BERNARD H NOLAN,2,1,1
14351,5028290103,SI,71 HYLAN BOULEVARD,02,C0,JOSEPH H DURANDO,2,1,1
14352,5028470146,SI,125 VIRGINIA AVENUE,01,A1,KENNY OYEDIRAN OYEWOLE,2,1,1
14353,5032280087,SI,164 BEVERLY ROAD,01,A1,"BOVE, MICHAEL V",2,1,1
14354,5032690027,SI,55 BIONIA AVENUE,01,A5,"BRONSHTEYN, ARKADIY",2,1,1
14355,5033280114,SI,398 NORTH RAILROAD AVE,01,A5,"LAM, ANDY NGUYEN",2,1,1
14356,5033320017,SI,286 BURGHER AVENUE,01,B3,"SALVATORE BRUZZESE, AS TTE",2,1,1
14357,5033440006,SI,260 GARRETSON AVENUE,01,A1,"ADINOLFI, BENJAMIN",2,1,1
14358,5033950084,SI,26 APPLEBY AVENUE,01,A2,"ALLOVIQ, AJET",2,1,1
14359,5034030025,SI,80 LANSING STREET,01,A2,THOMAS A LAROSA,2,1,1
14360,5034120088,SI,31 PEARSALL STREET,01,B2,CAZIM VELJIC,2,1,1
14361,5036980022,SI,248 BOUNDARY AVENUE,01,A5,"DRAGOVIC, ASMIRA",2,1,1
14362,5037260023,SI,407 HAMDEN AVENUE,01,A5,THOMAS MAZZARELLA,2,1,1
14363,5037400033,SI,865 NUGENT AVENUE,01,A5,"SALYAMOV, ALISHER",2,1,1
14364,5040160001,SI,325 ISABELLA AVENUE,01,B3,LILIA LOPEZ,2,1,1
14365,5040540015,SI,230 WEED AVENUE,01,A2,"TUNG, AMY",2,1,1
14366,5042210021,SI,97 CODDINGTON AVENUE,01,A1,"SCALICI, ALESSANDRO",2,1,1
14367,5044680055,SI,27 JOSHUA COURT,01,A1,A SPANO,2,1,1
14368,5045000183,SI,41 COTTONWOOD COURT,01,B2,DOMINIC DEMATTIA,2,1,1
14369,5045830233,SI,98 TANGLEWOOD DRIVE,01,A5,NICHOLAS DEFENDIS,2,1,1
14370,5049860013,SI,42 THOLLEN STREET,01,B2,"MARKE, EJUP",2,1,1
14371,5050210045,SI,24 KELVIN AVENUE,01,B2,"COLEMAN, ANGELA",2,1,1
14372,5052080063,SI,305 NELSON AVENUE,04,S2,305 NELSON AVENUE LLC,3,2,1
14373,5053350062,SI,52 RANKIN STREET,01,A1,"GIARDINO, DEBORAH A",2,1,1
14374,5053400029,SI,239 LYNDALE AVENUE,01,A3,"DIGIOVANNI, THOMAS",2,1,1
14375,5054410044,SI,341 DEWEY AVENUE,01,A2,ANN JACHIMOWICZ,2,1,1
14376,5055230225,SI,337 ELTINGVILLE BLVD,01,A2,ROB A VOLPE,2,1,1
14377,5055950011,SI,3768 RICHMOND AVENUE,05,O1,SHREE RAM FAMILY LIMITED PARNTERSHIP,3,2,1
14378,5056150029,SI,60 STUYVESANT AVENUE,01,A2,"JOSEPH J. COCO, AS TRUSTEE",2,1,1
14379,5056830041,SI,53 KENMORE STREET,01,A1,CONNORS,2,1,1
14380,5061640018,SI,32 KNESEL STREET,01,A1,E C ROKICKI,2,1,1
14381,5062270017,SI,178 DETROIT AVENUE,01,B2,MARK A. ZAMBARDA,3,2,1
14382,5062420011,SI,22 MOSELY AVENUE,02,C0,"REYNA A. GRANDA, AS ADMINISTRATOR",3,2,1
14383,5064580020,SI,39 LYNCH STREET,01,A1,"CHIARAPPO, LAWRENCE",2,1,1
14384,5068050094,SI,22 GEORGES LANE,01,B2,DAVID WALSH,2,1,1
14385,5073800018,SI,65 ENGLEWOOD AVENUE,04,S1,ENGLEWOOD DEVELOPMENT LLC,7,6,1
14386,5075340143,SI,50 STATION AVENUE,01,A1,ALLEN POSECZNICK,2,1,1
14387,5075500052,SI,6659 AMBOY ROAD,05,O5,LOUIS RUSSELL,2,1,1
14388,5077960017,SI,59 BEDELL AVENUE,01,B3,KATHY THORSEN,2,1,1
14389,5078640056,SI,585 ROCKAWAY STREET,01,A1,HELEN THOMPSON,2,1,1
14390,5078670038,SI,118 SPRAGUE AVENUE,01,A1,"CASALE, JAMES",2,1,1
14391,5078680016,SI,7324 AMBOY ROAD,04,K4,PCNF REALTY LLC,2,1,1
14392,5078850012,SI,354 BRIGHTON STREET,01,A2,CHRISTINE F TULL,2,1,1
14393,5079090040,SI,516 MAIN STREET,01,A1,"CLEMENTE , LISA",2,1,1
14394,5079450070,SI,11 SATTERLEE STREET,01,A1,"RUSSELL, DAVID",2,1,1
14395,5080500078,SI,532 CRAIG AVENUE,01,A3,"CHIU, ANNE",2,1,1
14396,1002010002,MN,58 MOTT STREET,04,S5,58 MOTT STREET LLC,2,1,1
14397,1002320011,MN,456 BROADWAY,05,O5,ESV RLTY CORP,2,1,1
14398,1004260046,MN,6 RIVINGTON STREET,02,C6,SIX RIVINGTON ST CORP,2,1,1
14399,1005180042,MN,134 SULLIVAN STREET,01,B1,"SEXTON, BRENDAN III",2,1,1
14400,1005750072,MN,45 WEST 11 STREET,02,C6,45 WEST 11TH STREET,2,1,1
14401,1006110001,MN,233 WEST 4 STREET,04,C7,233 WEST 4TH STREET,3,2,1
14402,1007630002,MN,526 9 AVENUE,04,S3,RED MOON REALTY LLC,2,1,1
14403,1008370058,MN,20 WEST 36 STREET,05,O6,STATECOURT ENTERPRISES,2,1,1
14404,1009980120,MN,123 WEST 45 STREET,04,K4,ABT MANAGEMENT LLC,2,1,1
14405,1010670008,MN,457 WEST 57 STREET,03,D4,ADDISON HALL OWNERS CORP,2,1,1
14406,1011430037,MN,116 WEST 72 STREET,03,D4,116 WEST 72ND ST.RLTY. CORP.,2,1,1
14407,1013000021,MN,463 LEXINGTON AVENUE,04,K4,DELMAR 36 AR LLC,2,1,1
14408,1016230226,MN,55 EAST 117 STREET,02,C0,OUTLAW JANENE,2,1,1
14409,1017110046,MN,2294 1 AVENUE,04,S3,118 STREET REALTY LLC,2,1,1
14410,1019117503,MN,159 WEST 126 STREET,02,R2,UNAVAILABLE OWNER,2,1,1
14411,2023790143,BX,784 ELTON AVENUE,02,C0,GOOD RETURN REAL ESTATE LLC,2,1,1
14412,2026330032,BX,1045 TRINITY AVENUE,01,B2,"BRANCH, PATRICIA A",2,1,1
14413,2026340001,BX,1096 BOSTON ROAD,08,W1,NYC DEPARTMENT OF EDUCATION,4,3,1
14414,2028270001,BX,1865 EAST 176 STREET,08,W1,NYC DEPARTMENT OF EDUCATION,2,1,1
14415,2029310037,BX,1396 FULTON AVENUE,01,A1,"GREY, INGRID C",2,1,1
14416,2029580073,BX,1818 WATERLOO PLACE,01,A1,"HOSSAIN, MOHAMMED D",2,1,1
14417,2034950018,BX,420 BEACH AVENUE,01,A1,LAURA ALVAREZ,2,1,1
14418,2035940052,BX,729 ROSEDALE AVENUE,01,A5,"ALLEN, CLINTON S",2,1,1
14419,2035950024,BX,740 ROSEDALE AVENUE,01,A1,ALTIME COLTER,2,1,1
14420,2037690036,BX,1261 BRONX RIVER AVENUE,02,C3,"SALIM-RASHEED, BIBI Z",2,1,1
14421,2037700003,BX,1269 EVERGREEN AVENUE,01,B1,"RAMNARINE, GANGADAI",2,1,1
14422,2039870003,BX,1520 OVERING STREET,04,S2,"ROMERO, JOSE JR",2,1,1
14423,2041130014,BX,1641 TENBROECK AVENUE,01,B3,"VEGA, JENNIFER",2,1,1
14424,2041780022,BX,3519 BRUCKNER BOULEVARD,02,C2,COCCHIERI LUCILLE,2,1,1
14425,2041780036,BX,1708 PARKVIEW AVENUE,02,C0,"CARBONE, FRANK",2,1,1
14426,2042700013,BX,1953 LURTING AVENUE,01,B2,"CALLE, GINA",2,1,1
14427,2042830001,BX,2090 BRONXDALE AVENUE,07,G3,"GTY-CPG (QNS/BX) LEASING, INC.",2,1,1
14428,2043410013,BX,650 WARING AVENUE,08,W1,NYC DEPARTMENT OF EDUCATION,2,1,1
14429,2045950003,BX,3208 OLINVILLE AVENUE,01,B3,"ZAPATA, YOSENIA",2,1,1
14430,2046420062,BX,3529 WILLETT AVENUE,02,C1,3529 WILLETT LLC,2,1,1
14431,2047940003,BX,1804 ARNOW AVENUE,01,A2,IROSE G BRAMBLE,2,1,1
14432,2048370031,BX,725 EAST 223 STREET,02,C2,BRONX 725 REALTY LLC,3,2,1
14433,2048380021,BX,755 EAST 224 STREET,02,C1,DOUGERT REALTY ROUND II LLC,2,1,1
14434,2048510026,BX,829 EAST 226 STREET,02,C0,RE STRAT LIMITED LIABILITY COMPANY,2,1,1
14435,2048550035,BX,825 EAST 230 STREET,02,C0,"MOULTON, MARILYN J.",2,1,1
14436,2048570044,BX,836 EAST 233 STREET,07,G4,830 E 233 ST CORP,2,1,1
14437,2048780062,BX,1034 EAST 232 STREET,01,A1,"PERSAUD, DEERAM",2,1,1
14438,2050070038,BX,4231 GUNTHER AVENUE,01,B3,"MANGAL, JAGDISH",2,1,1
14439,2050810038,BX,4550 RICHARDSON AVENUE,02,C0,O'NEIL JOSEPH SANGSTE,3,2,1
14440,2050910014,BX,4418 BRUNER AVENUE,01,A1,"KABONGO, LUABEYA",2,1,1
14441,2050990059,BX,4423 SETON AVENUE,01,B2,"SINGH, MAVETTE",2,1,1
14442,2051340038,BX,2324 PALMER AVENUE,01,A2,"COTTES, ERIC",3,2,1
14443,2053450005,BX,3183 BAISLEY AVENUE,01,A1,"JIMENEZ, JAIRO",2,1,1
14444,2054280021,BX,838 EDISON AVENUE,01,B2,"PENA, JENNIFER M",2,1,1
14445,2054310003,BX,3721 EAST TREMONT AVENUE,01,A5,"GENNARELLI, ROSANNA",2,1,1
14446,2054830007,BX,616 ELLSWORTH AVENUE,01,B1,"DEL GROSSO, ANTHONY",2,1,1
14447,2055040050,BX,19 ASTER PLACE,01,A8,SILVER BEACH GARDENS CORPORATION,26,25,1
14448,2055330038,BX,1007 CALHOUN AVENUE,01,B3,ALISAM ASSOCIATES LLC,2,1,1
14449,2058060698,BX,4400 TIBBETT AVENUE,01,A3,HORACE MANN SCHOOL,2,1,1
14450,3001860012,BK,540 ATLANTIC AVENUE,05,O2,DAILY MIRROR ASSOCIATES LLC,2,1,1
14451,3003740001,BK,527 CLINTON STREET,02,C0,"BARBERA, PRUDENCE",2,1,1
14452,3005130036,BK,31 LUQUER STREET,02,C0,"ORTIZ, BERYLE",2,1,1
14453,3006340017,BK,190 18 STREET,01,B9,"CASSARINO, ROSARIO",2,1,1
14454,3006720016,BK,132 30 STREET,01,B9,"VERBIC, JOHN",2,1,1
14455,3006730057,BK,185A 31 STREET,01,B1,"DIAZ, JANUEL",2,1,1
14456,3007630029,BK,254 47 STREET,06,E1,ANMAR REALTY CORP,2,1,1
14457,3010470043,BK,560 5 AVENUE,05,K1,DANIELLE LEAH REALTY ASSOC.,2,1,1
14458,3010520018,BK,130 16 STREET,01,B3,VICTOR CHI HING CHEUNG,2,1,1
14459,3013120073,BK,617 EMPIRE BOULEVARD,01,A4,LAUFER PHILIP,2,1,1
14460,3013240049,BK,37 BALFOUR PLACE,01,A4,MOSES BORENSTEIN,2,1,1
14461,3013260018,BK,600 EMPIRE BOULEVARD,02,C2,JOSEPH HELLER,2,1,1
14462,3013690028,BK,1602 PROSPECT PLACE,02,C3,"DELANGE, DICK ADAM",2,1,1
14463,3014070074,BK,1531 CARROLL STREET,01,A5,"RAPPOPORT, ESRIEL",2,1,1
14464,3015330011,BK,186 MAC DOUGAL STREET,01,A9,"DUNCAN, UNDRA",2,1,1
14465,3017300045,BK,52 TOMPKINS AVENUE,04,S9,SIMON TOVA LLC,3,2,1
14466,3017620015,BK,939 BEDFORD AVENUE,01,B9,"EBANKS, CARLYE",2,1,1
14467,3017830081,BK,535 LAFAYETTE AVENUE,01,B1,THE GALBY GROUP LLC,2,1,1
14468,3018370011,BK,58 HANCOCK STREET,01,B3,JAN SMALL A/K/A JAN S,2,1,1
14469,3018750038,BK,30 HALL STREET,06,E7,HALL STREET REAL ESTATE LLC,2,1,1
14470,3019930008,BK,1063 FULTON STREET,04,S2,SIMMONS STANFIELD,2,1,1
14471,3020290055,BK,117 PARK AVENUE,01,B9,GIBSON MCARTHUR,2,1,1
14472,3020310007,BK,37 CARLTON AVENUE,,Z9,LESER GROUP,3,2,1
14473,3023200032,BK,173 NORTH 7 STREET,02,C0,"173 N. 7TH STREET, LLC",2,1,1
14474,3025060005,BK,364 MCGUINNESS BOULEVARD,06,E1,219-221 EAGLE STREEET,2,1,1
14475,3027360032,BK,59 WITHERS STREET,02,C1,MIRCO MANAGE REALTY LLC,2,1,1
14476,3029160056,BK,245 DEVOE STREET,02,C0,"LAPOINTE, MATTHEW",2,1,1
14477,3030560009,BK,304 MESEROLE STREET,06,F9,304 MESEROLE,2,1,1
14478,3030820017,BK,226 BOERUM STREET,01,B2,"BUCHANAN, MINOO",2,1,1
14479,3031570021,BK,88 GEORGE STREET,02,C2,88 GEORGE LLC,2,1,1
14480,3031590001,BK,167 KNICKERBOCKER AVENUE,06,E1,CACMY LLC,4,3,1
14481,3031730051,BK,171 TROUTMAN STREET,02,C0,CTK DEVELOPMENT CORP,2,1,1
14482,3032380017,BK,994 HART STREET,02,C0,"NUZZI, TRUSTEE, DOMINICK JR",3,2,1
14483,3034290057,BK,1189 DECATUR STREET,01,B2,"REVANDER-GEORGE, KATHERINE",2,1,1
14484,3035810053,BK,342 LEGION STREET,01,B1,GODFREY DOROTHY,2,1,1
14485,3036310030,BK,20 HEGEMAN AVENUE,08,I6,LINROC NURSING HOMEINC,3,2,1
14486,3036330019,BK,1031 THOMAS S BOYLAND ST,01,B1,"ROGERS-HERMANSTEIN, CHRISTINE C",2,1,1
14487,3037740114,BK,433 VERMONT STREET,01,A5,"WEISMAN, REBECCA L",2,1,1
14488,3038390034,BK,592 PENNSYLVANIA AVENUE,01,B1,ANN J BROWNE,2,1,1
14489,3039690020,BK,2966 ATLANTIC AVENUE,05,G8,2970-2972 ATLANTIC AVE CORP,2,1,1
14490,3039880001,BK,765 ESSEX STREET,10,G1,LATTARULO WILLIAM,2,1,1
14491,3040370107,BK,489 SHEPHERD AVENUE,01,A5,HENRY LEACOCK,3,2,1
14492,3040710003,BK,393 ATKINS AVENUE,02,C0,"ST HILL ESTAVA, MICHELINE",2,1,1
14493,3041240017,BK,137 NORWOOD AVENUE,01,A9,AIGBOJIE EDWARD A,2,1,1
14494,3042310033,BK,971 BELMONT AVENUE,01,B3,"VERA, MANUEL",3,2,1
14495,3043130019,BK,682 ELTON STREET,01,B3,GLENDA HAYNES,2,1,1
14496,3043170022,BK,96 LOUISIANA AVENUE,01,B1,2104 HUGHES AVENUE CORP,2,1,1
14497,3043360013,BK,754 ELTON STREET,01,B9,101 4TH AVE LLC,3,2,1
14498,3044550043,BK,1007 HEGEMAN AVENUE,02,C0,"HUGGINS, YOLANDA",2,1,1
14499,3046140067,BK,121 EAST 95 STREET,02,C3,"MCFARLANE, YVETTE",2,1,1
14500,3048020022,BK,444 MIDWOOD STREET,01,B2,"BOWSER, TANDRA",3,2,1
14501,3049000045,BK,467 EAST 46 STREET,01,A9,MACK COLEMAN,2,1,1
14502,3049020020,BK,108 EAST 32 STREET,01,B1,MAVIS L BRAITHWAITE,2,1,1
14503,3050140049,BK,3924 FARRAGUT ROAD,11,V0,ELEANOR MCCOURT,2,1,1
14504,3050170013,BK,809 EAST 42 STREET,06,E1,LUCKY MCMXCVI LLC,2,1,1
14505,3050900069,BK,2531 CHURCH AVENUE,04,S2,STEPHEN M HOSANNAH,2,1,1
14506,3051080001,BK,871 ROGERS AVENUE,08,M9,"THE CHURCH OF PENTECOST BROOKLYN, INC",2,1,1
14507,3053000001,BK,3723 13 AVENUE,04,S9,1305 38TH STREET LLC,2,1,1
14508,3053040026,BK,169 MINNA STREET,01,B1,MOHAMMED ABDIN,2,1,1
14509,3053110058,BK,50 LOUISA STREET,01,B1,"RANDAZZO, JOSEPH",2,1,1
14510,3053130018,BK,73 LOUISA STREET,02,C0,"RAPA, CARLO",2,1,1
14511,3053310053,BK,814 FRIEL PLACE,01,B3,MOHAMMED A HANIF,2,1,1
14512,3053400007,BK,722 CHURCH AVENUE,08,M1,"BROOKLYN ISLAMIC CENTER, INC.",2,1,1
14513,3053750031,BK,498 EAST 7 STREET,01,B2,"NIMAN, IGOR",2,1,1
14514,3053860007,BK,220 CORTELYOU ROAD,04,S2,MIKVAH OF KENSINGTON,2,1,1
14515,3054010057,BK,715 EAST 7 STREET,01,B2,"GOLD, YISRAEL",2,1,1
14516,3054150036,BK,101 WEBSTER AVENUE,01,B1,"RINGEL, ARYE",2,1,1
14517,3054500065,BK,1845 49 STREET,01,A9,ELLIOT ROSMAN,2,1,1
14518,3054560068,BK,1839 50 STREET,01,B1,ROSE LEIFER,2,1,1
14519,3054980030,BK,1760 57 STREET,01,B1,EMS 12-09 TRUST,2,1,1
14520,3055080059,BK,2147 59 STREET,01,A1,"FARKAS, ABRAHAM",2,1,1
14521,3055490064,BK,2019 65 STREET,01,B1,"ANDRESAKIS, MARY ELI",2,1,1
14522,3055917512,BK,1043 42 STREET,02,R1,UNAVAILABLE OWNER,2,1,1
14523,3056010064,BK,935 44 STREET,01,B1,"LAM, KAM TIM",2,1,1
14524,3056510058,BK,845 52 STREET,04,S2,LAM PETER HUNG,3,2,1
14525,3056600043,BK,1074 52 STREET,01,B1,"WEINBERGER, EDWARD",2,1,1
14526,3056680037,BK,1178 53 STREET,01,B1,"PERLSTEIN, AS TRUSTEE, JOSEF M",2,1,1
14527,3056740054,BK,1045 55 STREET,01,B1,"ABRAMZON, JACOB",2,1,1
14528,3057280064,BK,833 63 STREET,01,B2,ZHL MGT INC,2,1,1
14529,3058020057,BK,6324 7 AVENUE,08,M1,PENTACOSTAL CHRISTIAN CHURCH,2,1,1
14530,3059120035,BK,870 72 STREET,02,C0,"ZHU, AMY",2,1,1
14531,3060320031,BK,158 85 STREET,01,A1,PETER KONTOPIRAKIS,2,1,1
14532,3060330026,BK,240 85 STREET,01,B3,"TSIRULNIK, MAYYA",2,1,1
14533,3060600020,BK,148 88 STREET,01,A1,"ELDOMYATI, IBRAHIM",2,1,1
14534,3061050039,BK,115 94 STREET,01,A1,PAUL A ORSI,2,1,1
14535,3061870030,BK,1162 72 STREET,01,B1,"DILUCA, ANTHONY",2,1,1
14536,3061940035,BK,7202 19 AVENUE,01,B1,ANNA MARIA DILISCIANDRO IRREVOCABLE TRUS T,2,1,1
14537,3062120016,BK,1424 74 STREET,01,B2,ANTHONY & ANDREA MULE,2,1,1
14538,3062450019,BK,1428 77 STREET,01,B3,SLIPS ANDREJS,2,1,1
14539,3064590025,BK,289 BAY 8 STREET,01,A1,"GAGGI, ANTHONY",2,1,1
14540,3064610287,BK,287 BAY 13 STREET,01,A5,GUANG YUAN GUAN,2,1,1
14541,3064610305,BK,325 BAY 13 STREET,01,A5,"FELUMERO, JOANNE",2,1,1
14542,3065090035,BK,972 EAST 7 STREET,01,A1,LYNN SCHREM,2,1,1
14543,3065150003,BK,208 AVENUE I,01,B2,"GLUCK, ELIYOHU",2,1,1
14544,3065190051,BK,987 OCEAN PARKWAY,01,A3,"HARARY, BEN J",2,1,1
14545,3065300047,BK,901 AVENUE K,01,A1,THE MONIQUE HADDAD 2018 RESIDENCE TRUST,2,1,1
14546,3065410002,BK,506 AVENUE L,01,B2,508 AVENUE L TRUST,2,1,1
14547,3065690069,BK,1347 OCEAN PARKWAY,01,B1,1347 OCEAN PARKWAY LLC,2,1,1
14548,3065700077,BK,1415 EAST 7 STREET,01,A1,"TAWIL, DAVID",2,1,1
14549,3065770044,BK,1394 WEST 7 STREET,01,A2,"MIZHQUIRI, LUIS",2,1,1
14550,3065870006,BK,510 AVENUE N,01,A1,"SROUR, DANNY",2,1,1
14551,3065880041,BK,1560 EAST 7 STREET,01,B2,ALEX PASKIE,2,1,1
14552,3065880063,BK,1489 OCEAN PARKWAY,01,B2,MOSSERI DAVID V,2,1,1
14553,3065900048,BK,1494 EAST 9 STREET,01,B1,1484 EAST 9TH STREET RESIDENCE TRUST,2,1,1
14554,3066530056,BK,1781 WEST 4 STREET,01,B3,"FIORENTINO, JOHN",3,2,1
14555,3066560024,BK,1752 DAHILL ROAD,02,C0,"CHANG, SAMMY S W",2,1,1
14556,3066630015,BK,1800 EAST 7 STREET,01,B2,"DANIEL, RALPH",2,1,1
14557,3066900017,BK,20 WALDORF COURT,01,A1,"YUDENFRIEND, RICHARD",2,1,1
14558,3067100059,BK,977 EAST 17 STREET,01,A2,JUBILITH SHAPIRO,2,1,1
14559,3067590045,BK,1223 AVENUE P,01,A5,MOSHE KINDIL,2,1,1
14560,3067617503,BK,1408 AVENUE O,03,R4,UNAVAILABLE OWNER,2,1,1
14561,3067830022,BK,1754 EAST 21 STREET,01,A3,"LEVY, ALBERT",2,1,1
14562,3068060019,BK,1734 EAST 24 STREET,01,A1,"DAYAN, RAYMOND E",2,1,1
14563,3068217501,BK,1824 EAST 17 STREET,03,R4,"AVENUE R CONDOMINIUM, LLC",2,1,1
14564,3068270015,BK,1860 EAST 22 STREET,01,A1,"SKAF, SHLOMI",2,1,1
14565,3069950093,BK,2752 WEST 16 STREET,04,O8,"2752 WEST 16TH STREET, LLC",3,2,1
14566,3070210063,BK,2863 WEST 17 STREET,01,B1,"AMBROSIA, ANNA SUE",2,1,1
14567,3071040038,BK,383 AVENUE T,01,A7,"SUTTON, LAURIE",2,1,1
14568,3071040445,BK,2013 WEST STREET,01,B3,FRANCO JOSEPH,2,1,1
14569,3071080037,BK,2070 OCEAN PARKWAY,01,A1,"HAZAN, NINA",2,1,1
14570,3071290031,BK,2218 EAST 3 STREET,01,A3,AINI JACK,2,1,1
14571,3071530072,BK,2241 EAST 1 STREET,01,B1,LEVY CHARLES,2,1,1
14572,3071590104,BK,810 AVENUE V,01,A5,"ALHALABI, ILIE",2,1,1
14573,3072910110,BK,1960 EAST 13 STREET,01,A3,"MIZRAHI, RAVIT",2,1,1
14574,3072990018,BK,2022 EAST 21 STREET,01,A1,"MANDALAOUI, HARRIET BRIGIT",2,1,1
14575,3073030036,BK,4068 BEDFORD AVENUE,01,A1,BRAD ANZAROOT,2,1,1
14576,3073100008,BK,2976 AVENUE S,01,A5,MICHAEL G & MARYANN C LITTLES,2,1,1
14577,3073450016,BK,2126 EAST 13 STREET,02,C0,ELI CHAYA,2,1,1
14578,3074050017,BK,2398 EAST 21 STREET,01,B1,"LINGYUN, LI",2,1,1
14579,3074050018,BK,2400 EAST 21 STREET,01,A9,"HADCHITY, SAMER JEAN",2,1,1
14580,3074300073,BK,2763 CONEY ISLAND AVENUE,05,O2,"RBC HOLDINGS, LLC",2,1,1
14581,3074340017,BK,2526 EAST 14 STREET,01,A1,"BLACK, JIMMY",2,1,1
14582,3074590108,BK,1610 SHEEPSHEAD BAY ROAD,04,K4,"C.KYRIE AND VIRGINIA J. KALLAS FAMILY PA RTNERSHIP, L.P.",2,1,1
14583,3075850027,BK,1075 EAST 21 STREET,01,B2,ZICHERMAN MOSHE,2,1,1
14584,3075900070,BK,958 EAST 27 STREET,01,B1,SHIFRA MENDELOVITZ,2,1,1
14585,3076010027,BK,1143 EAST 37 STREET,01,B2,"JAMES, BETTINA",2,1,1
14586,3076110008,BK,1095 EAST 29 STREET,01,A1,"SCHINDLER, STEVEN",2,1,1
14587,3076380022,BK,1743 OCEAN AVENUE,01,A1,"MERKAZ THE CENTER, INC.",2,1,1
14588,3076400049,BK,2216 AVENUE L,01,B2,180 WEST END LLC,2,1,1
14589,3076450027,BK,1249 EAST 27 STREET,01,A1,BIENENSTOCK MARTIN,2,1,1
14590,3076620039,BK,1323 EAST 26 STREET,01,A1,"MINZER, DOVIE",2,1,1
14591,3076890112,BK,1570 EAST 29 STREET,01,A5,REBECCA ACKERMAN IRREVOCABLE LIVING TRUS T,2,1,1
14592,3076930029,BK,1533 EAST 31 STREET,01,B1,"HAREL, BEZALEL",2,1,1
14593,3077040049,BK,1620 EAST 32 STREET,01,B1,KULDIP SINGH,2,1,1
14594,3078870013,BK,1765 KIMBALL STREET,02,C0,"APRILE, CHRISTOPHER",2,1,1
14595,3079020034,BK,1421 EAST 57 STREET,01,A9,"FLORES, JULIO",2,1,1
14596,3079030057,BK,1430 EAST 59 STREET,01,B3,KLEVER JIMENEZ,2,1,1
14597,3079040033,BK,1425 EAST 59 STREET,01,B1,PATRICK EKEJI,2,1,1
14598,3080100053,BK,1160 REMSEN AVENUE,02,C0,"ROWLEY, DELMUS J",2,1,1
14599,3081640043,BK,9524 FARRAGUT ROAD,01,B2,"PASSALACQUA, JOSEPH",2,1,1
14600,3081800110,BK,9203 FLATLANDS AVENUE,04,S2,MANNETTI DIANA,2,1,1
14601,3084140016,BK,2059 EAST 73 STREET,01,A9,"QUINN, GERALD",2,1,1
14602,3084940025,BK,1703 EAST 54 STREET,02,C0,1705 E. 54 LLC,2,1,1
14603,3085000072,BK,1960 EAST 34 STREET,01,A9,"BORGESE , JOSEPH",2,1,1
14604,3086360041,BK,2315 EAST 64 STREET,01,A3,"MICHELE DAVID, AS TRUSTEE",2,1,1
14605,3086687503,BK,727 OCEAN VIEW AVENUE,04,RM,UNAVAILABLE OWNER,2,1,1
14606,4003890025,QN,38-18 24 STREET,10,G1,EASTERN KOEX REALTY CORP,2,1,1
14607,4003910032,QN,21-17 39 AVENUE,05,G8,LUPO REALTY CO,2,1,1
14608,4005350040,QN,14-36 30 ROAD,01,B1,"WEI LI, VIVIAN",2,1,1
14609,4005620009,QN,34-22 CRESCENT STREET,01,B1,"FATEMA, KANIZ",2,1,1
14610,4005960056,QN,26-26 29 STREET,02,C1,26-28 29TH STREET LLC,2,1,1
14611,4006190031,QN,31-14 28 ROAD,02,C1,NMIHALIOS REALTY LLC,2,1,1
14612,4006530074,QN,25-36 38 STREET,02,C1,"43 STREET REALTY, LLC",2,1,1
14613,4008720035,QN,25-23 23 STREET,02,C0,UNAVAILABLE OWNER,2,1,1
14614,4008830001,QN,21-33 25 ROAD,02,C0,ALBERT MATTAI,3,2,1
14615,4009110001,QN,3-15 26 AVENUE,11,V1,ASTORIA OWNERS LLC,4,3,1
14616,4011060024,QN,24-38 96 STREET,01,A2,ERNESTINE STEWART,2,1,1
14617,4011890099,QN,61-11 BROADWAY,01,A5,KERR  SOL A,2,1,1
14618,4012160062,QN,37-32 62 STREET,01,A1,VINCENT GERECITANO,2,1,1
14619,4013040025,QN,40-11 72 STREET,03,D1,AEM PARTNERS LLC,2,1,1
14620,4013440035,QN,42-26 67 STREET,02,C0,"CHEN, JI LIN",2,1,1
14621,4014940027,QN,41-07 74 STREET,02,C0,"CHRISTMAN, MARJORIE",2,1,1
14622,4015630048,QN,40-42 94 STREET,02,C2,40-42 94TH ST REALTY LLC,2,1,1
14623,4015830061,QN,89-22 43 AVENUE,04,S5,WILSON LAM REALTY INC,2,1,1
14624,4016920018,QN,31-24 106 STREET,01,B3,"CHEN, SHAOXUN",2,1,1
14625,4017460017,QN,35-14 105 STREET,01,A1,"SAQUIPULLA, MARIA",2,1,1
14626,4017700047,QN,102-11 ROOSEVELT AVENUE,05,O7,SELIM REALTY LLC,3,2,1
14627,4017740035,QN,37-48 108 STREET,02,C3,JUAN SOTOMAYOR,2,1,1
14628,4017760050,QN,104-49 ROOSEVELT AVENUE,01,B1,"LEMA, LUIS A",2,1,1
14629,4018360138,QN,49-26 87 STREET,01,A5,"WU, JIE",2,1,1
14630,4019280048,QN,102-07 ALSTYNE AVENUE,01,B2,"REYES, SUYAPA E",2,1,1
14631,4019520016,QN,56-12 WALDRON STREET,01,B1,"PEREZ, LAURA JANETH",2,1,1
14632,4022950077,QN,50-46 46 STREET,01,B3,SOCIMO PEREZ,2,1,1
14633,4024060002,QN,53-07 66 STREET,01,A1,"FLANAGAN, GERALD",2,1,1
14634,4024880016,QN,73-18 52 DRIVE,01,A1,"AGOSTO, WILLIAM",2,1,1
14635,4027310054,QN,59-72 60 LANE,01,B3,"BACINO, LEONARD",2,1,1
14636,4027330069,QN,60-19 60 DRIVE,01,B2,CINQUEMANI MARIO,2,1,1
14637,4027520167,QN,58-15 66 STREET,01,A9,"SALARI, ALEXANDRU",2,1,1
14638,4028100074,QN,73-10 57 AVENUE,01,B1,"GORSKI, ZOFIA",2,1,1
14639,4028360036,QN,60-17 69 STREET,01,B2,"SINGH, HARBANS",2,1,1
14640,4028770018,QN,85-26 53 AVENUE,01,B2,"HUGO, OTTO",2,1,1
14641,4029170050,QN,57-45 81 STREET,01,A1,"SKORUPA, EMETERIA CASTRO",2,1,1
14642,4031890047,QN,67-105 EXETER STREET,01,A5,"TANG, ALAN",2,1,1
14643,4032610063,QN,72-42 MANSE STREET,01,B9,"SALIM, JULIAN",2,1,1
14644,4032970023,QN,209 GREENWAY SOUTH,01,A3,209 GREENWAY LLC,2,1,1
14645,4033430051,QN,77-16 KEW FOREST LANE,01,A1,"FAYZIYEV, OLGA",2,1,1
14646,4034850036,QN,658 GRANDVIEW AVENUE,01,B1,658 GRANDVIEW LLC,2,1,1
14647,4035520038,QN,1654 GEORGE STREET,01,A2,JEANNETTE VIRUET,2,1,1
14648,4035700036,QN,58-50 78 AVENUE,02,C0,58-50 78TH AVENUE LLC,2,1,1
14649,4035790104,QN,75-08 60 PLACE,01,B3,WRIGHT KATHLEEN,2,1,1
14650,4036610047,QN,70-20 71 STREET,01,B2,"BOTTIGLIERI, SALVATORE",2,1,1
14651,4036890035,QN,72-11 COOPER AVENUE,01,B2,"RICHARD J. HANRAHAN, SR., TRUSTEE",2,1,1
14652,4037080055,QN,73-50 71 STREET,02,C3,67 FRESH LLC,2,1,1
14653,4037280057,QN,57-09 CLOVER PLACE,01,A2,"ROJAS, ZULMA",2,1,1
14654,4037400400,QN, CYPRESS AVENUE,09,Z8,CONGREGATION EMANU-EL,2,1,1
14655,4038170003,QN,77-35 79 PLACE,01,A9,"SAUER, NANCY  A",2,1,1
14656,4038440048,QN,78-03 85 STREET,01,A5,"MILAU, KEITH S",2,1,1
14657,4038690095,QN,82-77 88 PLACE,01,B1,"CHEN, SU TING",2,1,1
14658,4039480022,QN,124-15 6 AVENUE,01,A1,HUMPHREY B SILVA,2,1,1
14659,4039730047,QN,125-12 9 AVENUE,01,A1,"CROWLEY, KAREN",2,1,1
14660,4040600026,QN,110-27 15 AVENUE,01,B2,"YEUNG, WILLIAM",2,1,1
14661,4041090030,QN,14-50 142 STREET,01,A2,"MCCANN, LAURA",2,1,1
14662,4041620019,QN,119-04 20 AVENUE,01,B1,11904 GARDEN LLC,2,1,1
14663,4042280012,QN,23-39 124 STREET,01,B2,"YU, DENNIS ZHEN",2,1,1
14664,4045430081,QN,154-15 POWELLS COVE BLVD,01,A1,HALVATZIS ANITA,2,1,1
14665,4047840028,QN,144-46 29 AVENUE,01,A1,"RONG CHANG CASHMERE USA, INC.",2,1,1
14666,4049070001,QN,165-04 27 AVENUE,01,A2,FINA DIPASQUALE,2,1,1
14667,4049340048,QN,29-37 171 STREET,01,A1,"LI, CHENG MING",2,1,1
14668,4049527501,QN,32-05 LINDEN PLACE,02,R2,UNAVAILABLE OWNER,2,1,1
14669,4049850046,QN,146-17 34 AVENUE,01,A1,"KROEPFL, JOANNE F",2,1,1
14670,4050070019,QN,149-34 35 AVENUE,08,W8,"FUNCTIONAL LIFE ACHIEVEMENT, INC.",2,1,1
14671,4051490031,QN,137-68 JUNIPER AVENUE,01,B2,YONG X TENG,2,1,1
14672,4052890004,QN,165-11 CROCHERON AVENUE,01,A2,MIRZA KAUSAR,2,1,1
14673,4054190055,QN,43-44 162 STREET,04,S9,162 REALTY MANAGEMENT LLC,2,1,1
14674,4055380036,QN,196-73 45 ROAD,01,B1,"ZHAO, DONG LAN",2,1,1
14675,4055620072,QN,47-22 204 STREET,01,B3,MARIO RAMIREZ,2,1,1
14676,4060540078,QN,32-30 214 STREET,01,A3,JOSPH DANIELLO,2,1,1
14677,4062330022,QN,38-03 212 STREET,01,A1,"SANKARSINGH, MARK A.",2,1,1
14678,4063430170,QN,39-05 223 STREET,01,A1,MILES BLACKSBERG,2,1,1
14679,4067360050,QN,59-28 159 STREET,01,B3,"GAGE, JR, PHILLIP E",2,1,1
14680,4067500063,QN,61-36 PARSONS BOULEVARD,01,A1,"GRIFFIN, JOAN J",2,1,1
14681,4068460037,QN,162-19 76 AVENUE,01,B1,"YE, XIAO GUANG",2,1,1
14682,4069660025,QN,75-19 164 STREET,04,S4,"LEE, PETER JUNG HO",2,1,1
14683,4069700011,QN,164-12 77 AVENUE,01,B2,"HUANG, XINGYAO",2,1,1
14684,4070730044,QN,61-25 184 STREET,01,B2,"HUANG, SHI MIN",2,1,1
14685,4072570017,QN,185-24 80 ROAD,01,A1,"MULADY, RIMMA",2,1,1
14686,4074610128,QN,58-03 210 STREET,01,A1,TSU-CHUN KUO,2,1,1
14687,4076747501,QN,67-27 CLOVERDALE BOULEVARD,02,R2,PARK RIDGE CONDO,137,136,1
14688,4077480500,QN,213-06 75 AVENUE,03,D4,WP OWNERS CORP,16,15,1
14689,4079430200,QN,227-01 HILLSIDE AVENUE,02,C6,UNITED VET MUTUAL HOUSING CO. INC.,100,99,1
14690,4082300018,QN,251-04 GASKELL ROAD,01,A1,"MASUCCI, ANN B",2,1,1
14691,4082300300,QN,249-29 BEECHKNOLL AVENUE,01,A1,"ZAMIR, YORAM",2,1,1
14692,4082460054,QN,54-07 BROWVALE LANE,01,A1,"ZGALJARDIC, MICHAEL",2,1,1
14693,4086390079,QN,248-47 88 ROAD,01,B3,"FILPO, ERIN M",2,1,1
14694,4087730058,QN,83-48 262 STREET,01,A1,"SINGH, JASPREET",2,1,1
14695,4087870024,QN,84-40 258 STREET,01,A1,"SINGH, TARSEM",2,1,1
14696,4089160048,QN,80-69 88 ROAD,01,A9,KUE SETO,2,1,1
14697,4089900173,QN,92-20 95 STREET,01,A5,LOUIS HARMODIO F,2,1,1
14698,4091460019,QN,105-28 86 STREET,01,A1,"FERREIRA, ELIZABETH",3,2,1
14699,4091710059,QN, POWER ROAD,07,U7,NYC DEPARTMENT OF CITYWIDE ADMINISTRATIVE SERVICES,6,5,1
14700,4091870001,QN,102-01 JAMAICA AVENUE,04,K4,"POLANCO, LUIS",2,1,1
14701,4093000099,QN,87-34 111 STREET,01,B3,111TH ST. 1 LLC,4,3,1
14702,4093340023,QN,87-36 126 STREET,02,C3,HEMWATTIE PERSAUD,2,1,1
14703,4093350185,QN,87-35 126 STREET,01,B1,MOHAMMED S MIAH,2,1,1
14704,4093920017,QN,94-30 109 STREET,01,B1,"HARRIPERSAUD, MICHAEL",2,1,1
14705,4094060043,QN,97-29 104 STREET,02,C0,"GUZMAN, LIZANDRO",2,1,1
14706,4094480045,QN,94-23 132 STREET,01,A1,RIVERA JOSE,2,1,1
14707,4094590005,QN,121-10 95 AVENUE,01,A9,"HINNA, BHUWAN",2,1,1
14708,4094850048,QN,101-49 117 STREET,01,B2,"SURAJH, BRIJLAL A",2,1,1
14709,4094850058,QN,101-35 117 STREET,01,B3,"SINGH, NATHWINDER",2,1,1
14710,4095890031,QN,103-27 135 STREET,01,B2,"NARINE, NARENDRA",2,1,1
14711,4096300011,QN,134-07 87 AVENUE,01,B1,"PARAG, PREMCHAND",2,1,1
14712,4096760055,QN,89-27 146 STREET,01,B3,"SEEMONGAL, AUTAR",2,1,1
14713,4097010017,QN,87-24 144 STREET,01,A1,"BHOWMIK, BULBUL",2,1,1
14714,4098100026,QN,172-15 91 AVENUE,01,B2,"RASHID , RAHILA",2,1,1
14715,4100140022,QN,143-41 101 AVENUE,01,A9,RODRIGUEZ JUAN,2,1,1
14716,4100680220,QN,107-53 139 STREET,01,A1,"AMARJEET, DAVI",2,1,1
14717,4101940063,QN,110-44 167 STREET,01,B3,"BEST, JAMES K SR",2,1,1
14718,4101950026,QN,167-01 110 ROAD,01,A1,"COKLEY, THELMA",2,1,1
14719,4102050030,QN,167-08 111 AVENUE,01,A1,JOANNE BARKER FORBES,2,1,1
14720,4103300134,QN,103-41 177 STREET,01,A1,"NARAIN SINGH, LANA  R",2,1,1
14721,4103720034,QN,104-30 187 STREET,01,A1,"PARKER, VANESA MARIE",2,1,1
14722,4104360018,QN,187-40 HILBURN AVENUE,01,A2,"HARRY, MARY S",2,1,1
14723,4104440029,QN,188-11 91 AVENUE,01,B3,GOPAL DHANRAJ,3,2,1
14724,4105040036,QN,86-52 PALO ALTO STREET,01,A3,"RAMPHAL, RAVI",2,1,1
14725,4105040045,QN,86-64 PALO ALTO STREET,01,A3,PARINDRA RAMNARAYAN,2,1,1
14726,4105200039,QN,86-46 PINTO STREET,01,B1,ROSE MCALLISTER,2,1,1
14727,4105230058,QN,193-25 85 ROAD,01,A1,UNAVAILABLE OWNER,2,1,1
14728,4105670040,QN,92-02 212 STREET,01,B3,"ISHAK, HAMID",2,1,1
14729,4105830027,QN,88-36 209 STREET,01,A2,"ZAIDI, ZAHID",2,1,1
14730,4106960043,QN,218-22 94 ROAD,01,A1,"SUKHNANDAN, JERRY",2,1,1
14731,4107110033,QN,91-35 219 STREET,01,A1,"BOODHOO, CHUNNO",2,1,1
14732,4107280018,QN,94-38 222 STREET,01,B2,"GAFOOR, KAMLAWATEE H",2,1,1
14733,4108240011,QN,92-07 195 PLACE,04,C7,ONE NINETY SIXTH ST,2,1,1
14734,4109160015,QN,104-33 209 STREET,01,A1,"BROWN, ADA",2,1,1
14735,4109470039,QN,110-10 207 STREET,01,A1,"SAHA, SANKAR K",2,1,1
14736,4109510107,QN,190-15 112 AVENUE,01,A1,THE TRUST FBO HERBERT CASSIS CREATED UWO,2,1,1
14737,4109770035,QN,112-24 202 STREET,01,B3,B JOHNSON,3,2,1
14738,4109870050,QN,191-11 113 ROAD,01,B3,"NAPIER, MAIZIE",2,1,1
14739,4112190062,QN,221-36 112 ROAD,01,A0,AUGIRUS MERCIDIEU,2,1,1
14740,4112690032,QN,114-72 226 STREET,01,A5,"HARRIS, LOIS",2,1,1
14741,4114220001,QN,90-02 SOUTH CONDUIT AVENUE,01,B9,"ABREU, JOSE",2,1,1
14742,4114760001,QN,109-60 110 STREET,01,B2,"VEE'S PROPERTY MANAGEMENT 10960, LLC",2,1,1
14743,4116460027,QN,119-17 115 AVENUE,01,A1,"ALQOTAINI, ABDULGALIL",2,1,1
14744,4116990032,QN,135-19 120 AVENUE,01,B2,CAVE GEOFFREY,3,2,1
14745,4117240013,QN,130-45 117 STREET,01,A1,PIZZO GEORGE C,2,1,1
14746,4117570036,QN,121-27 133 STREET,01,A1,COLWIN L ABRAMS,2,1,1
14747,4120140013,QN,117-18 142 PLACE,01,A1,"ALI, JAMEER",3,2,1
14748,4120260108,QN,119-05 INWOOD STREET,01,A1,"GEORGES, JEAN FRITZ",2,1,1
14749,4120600256,QN,127-19 142 STREET,01,A5,"MCDONALD , PAULETTE",2,1,1
14750,4121010008,QN,126-33 146TH STREET,01,B3,"DARBY, NATHAN J. JR",3,2,1
14751,4121670023,QN,111-37 153 STREET,01,A1,"NANDJI, MAMA",3,2,1
14752,4122040150,QN,153-20 FOCH BOULEVARD,01,A9,"NELOM, DOCK",2,1,1
14753,4122160050,QN,150-21 122 AVENUE,01,A1,"JENKINS, JOHN",2,1,1
14754,4123430239,QN,168-05 116 AVENUE,01,B3,"GOMEZ, NORA",2,1,1
14755,4123510005,QN,169-11 FOCH BOULEVARD,11,V0,"LAMBACK, JANICE",2,1,1
14756,4123940120,QN,172-17 115 AVENUE,01,A1,"CATON, SHERWIN",2,1,1
14757,4124800001,QN,122-01 MERRICK BOULEVARD,07,G4,"YTE DIAGNOSTIC CNTR,INC",2,1,1
14758,4125370091,QN,130-19 176 PLACE,01,A5,"COWAN, HEATHER",2,1,1
14759,4126200018,QN,117-24 200 STREET,01,B3,"REINA, GEENA",2,1,1
14760,4128970038,QN,219-24 130 AVENUE,01,A2,"OLIVIER, CALIXTE",2,1,1
14761,4130410011,QN,183-22 140 AVENUE,01,B1,FEDERAL NATIONAL MORTGAGE ASSOCIATION,2,1,1
14762,4131600047,QN,134-28 233 STREET,01,A1,COOKHORN VALRIE,2,1,1
14763,4132050056,QN,133-76 242 STREET,01,A1,"PERSAUD, CAMINI",2,1,1
14764,4132460037,QN,244-31 137 ROAD,01,A2,"JAMES, ELAINE",2,1,1
14765,4132460039,QN,244-27 137 ROAD,01,A1,"BAMIDURO, ADEBAMIKE",2,1,1
14766,4134550062,QN,146-48 222 STREET,01,B2,"EDWARDS, ALFORD B",2,1,1
14767,4134790018,QN,145-11 222 STREET,01,B3,GLORIA BURCH,2,1,1
14768,4135010070,QN,144-49 230 PLACE,01,B3,"HORSFORD, HUGH M",2,1,1
14769,4137500157,QN,147-99 EDGEWOOD STREET,01,A1,"QUAMINA, JACQUELINE",2,1,1
14770,4150070080,QN,154-06 145 DRIVE,05,O5,PP TANGO NY 5 LLC,2,1,1
14771,4154570003,QN,206 EAST 6 ROAD,01,A2,HOUSING TRUST FUND CORPORATION,2,1,1
14772,4155710034,QN,7-75 CORNAGA AVENUE,01,A1,MOLLIE KAMIN FAMILY TRUST,2,1,1
14773,4156360007,QN,310 BEACH 20 STREET,08,I5,HEBREW KIND & INFTS H,2,1,1
14774,4157090152,QN,10-59 BEACH 22 STREET,04,S1,"TULLOCH, VANTROY S",2,1,1
14775,4157740093,QN,24-12 DEERFIELD ROAD,01,A1,"BRUNNER, ROBERT L",2,1,1
14776,4159160033,QN,330 BEACH 69 STREET,02,C0,ABRAHAM DOMINGO,2,1,1
14777,4160420062,QN,4-21 BEACH 68 STREET,01,B1,"HAMLIN, JOAN",2,1,1
14778,4160510043,QN,69-28 HESSLER AVENUE,01,A1,"EL, AMIRA",2,1,1
14779,4160530031,QN,411 BEACH 69 STREET,02,C0,"ROBERT, ANDREW R",2,1,1
14780,4161690123,QN,162 BEACH 97 STREET,02,C0,UNAVAILABLE OWNER,2,1,1
14781,4161740042,QN,1-83 BEACH 101 STREET,11,V0,183 BEACH 101ST STREET CONDO LLC,2,1,1
14782,4161950021,QN,531 BEACH 127 STREET,01,A1,"MURRAY, JAMES",2,1,1
14783,4162280070,QN,172 BEACH 119 STREET,02,C2,ROCK HEIGHTS LLC,2,1,1
14784,4162880022,QN,141-16 CRONSTON AVENUE,01,A1,"STEPHAN-RIGGS, SUZANNE M",2,1,1
14785,4163190064,QN,182 BEACH 146 STREET,01,A3,JOSEPH & ARLENE GAMBINO,2,1,1
14786,5000490089,SI,196 BEECHWOOD AVENUE,01,B2,"LOO, CHI CHUNG",2,1,1
14787,5001490149,SI,83 PELTON AVENUE,01,A1,PAULA C TARTER,2,1,1
14788,5001810041,SI,382 NORTH BURGHER AVENUE,01,A2,VERONICA C GAMBON,3,2,1
14789,5001850548,SI,2015 RICHMOND TERRACE,06,F1,MORAN SHIPYARD CORP,3,2,1
14790,5001980102,SI,68 BARKER STREET,01,B2,MARK WASHINGTON,2,1,1
14791,5002250024,SI,268 MYRTLE AVENUE,01,A1,CASSERLY EUGENE P,2,1,1
14792,5002880023,SI,657 OAKLAND AVENUE,01,A1,JOHN KEMPF,2,1,1
14793,5003680047,SI,7 SAWYER AVENUE,01,A1,JEANNIE WONG,2,1,1
14794,5003780152,SI,83 COALE AVENUE,01,B1,COSCIA JOHN B,2,1,1
14795,5004390001,SI,315 NEAL DOW AVENUE,01,A1,"LENZA, DENISE",2,1,1
14796,5005100019,SI,95 WAVE STREET,01,B2,JAMES LUNDQUIST,2,1,1
14797,5005150006,SI,304 VAN DUZER STREET,01,A1,CANU NANCY,2,1,1
14798,5005690005,SI,98 ST PAULS AVENUE,01,B2,"CHIN, GLORIA",3,2,1
14799,5005780088,SI,118 WARD AVENUE,01,A1,JANE ADLER,2,1,1
14800,5005790073,SI,186 WARD AVENUE,01,B9,"QUARTEY, DANIEL",2,1,1
14801,5006110100,SI,580 VAN DUZER STREET,02,C0,"NDF HOLDING, LLC",2,1,1
14802,5006220107,SI,982A VAN DUZER STREET,10,G0,GEORGE S ALIOTTA,2,1,1
14803,5007240040,SI,50 WHEELER AVENUE,01,A1,DAWO ONYECHE,2,1,1
14804,5007450023,SI,106 MARTIN AVENUE,01,B1,SOOK HEE OH AKA SOOK,2,1,1
14805,5008380156,SI,56 EMERSON AVENUE,01,A3,"ZUNCE, SHPETIM",2,1,1
14806,5008560018,SI,116 VISTA AVENUE,01,A1,"BIUNDO, JERRY",2,1,1
14807,5008590033,SI,16 OAKDALE AVENUE,01,A3,BORRIELLO DANIEL,2,1,1
14808,5008670109,SI,68 CIRCLE ROAD,01,A3,UNAVAILABLE OWNER,2,1,1
14809,5010130050,SI,98 JEWETT AVENUE,10,G1,"98 REALTY, LLC",2,1,1
14810,5010320047,SI,2 ALBION PLACE,01,B2,GARY PALLADINO,2,1,1
14811,5010380023,SI,1042 POST AVENUE,01,B3,"LUCERO, NELSON R",2,1,1
14812,5010610011,SI,141 HAGAMAN PLACE,01,A1,PATRICIA WHELAN,2,1,1
14813,5010820030,SI,183 SHARPE AVENUE,01,A1,"FAIRWEATHER, KESSERINE",2,1,1
14814,5010950019,SI,165 TREADWELL AVENUE,01,A1,"RODRIGUEZ, ANA B",2,1,1
14815,5011240002,SI,113 INNIS STREET,01,A1,"SANDY, FIORELA",2,1,1
14816,5011600009,SI,87 SIMONSON AVENUE,01,A1,JOSEPH ALOHAN,2,1,1
14817,5011600097,SI,68 LAKE AVENUE,01,A1,"GBORZEO, EMMANUEL",2,1,1
14818,5011710010,SI,41 RONALD AVENUE,01,A2,DANIEL MC CANN,2,1,1
14819,5011830219,SI,510 MELYN PLACE,01,A1,"BRADY, DARREN",2,1,1
14820,5012720047,SI,19 HOLLAND AVENUE,01,B2,"GRINBERG MANAGEMENT & DEVELOPMENT, LLC",2,1,1
14821,5014780169,SI,144 WILLOWBROOK ROAD,01,A5,"NG, KIM",2,1,1
14822,5014810144,SI,24 DEVENS STREET,01,B2,"YEGOROVA, YELENA",2,1,1
14823,5015170033,SI,60 SUMNER AVENUE,01,A2,"MCGILL, JODI ANN",2,1,1
14824,5016110031,SI,29 ASTOR AVENUE,01,A9,FARID R. ASSEL,2,1,1
14825,5016440008,SI,56 DOMAIN STREET,01,A5,DE SALVATORE MARY W,2,1,1
14826,5018650089,SI,2173 GULF AVENUE,06,E1,FRANK LIQUORI LLC,8,7,1
14827,5022420080,SI, RICHMOND ROAD,04,S2,UNAVAILABLE OWNER,2,1,1
14828,5022620011,SI,51 AULTMAN AVENUE,01,A1,"YAN, LI",2,1,1
14829,5026360066,SI,166 MELVIN AVENUE,01,A5,"O'NEIL, CHRIS",2,1,1
14830,5027800055,SI,19 MEREDITH AVENUE,01,A1,LONGO BARBARA,2,1,1
14831,5028640009,SI,450 HOME AVENUE,01,B2,RICHARD CHAPMAN,2,1,1
14832,5028770142,SI,15 NUNLEY COURT,01,A1,DAMIAN WOODWARD,2,1,1
14833,5029720054,SI,196 ST MARYS AVENUE,01,B1,"LI, YONG ZHENG",2,1,1
14834,5029720062,SI,178 ST MARYS AVENUE,01,A1,NAGENDRUDU BURRA,2,1,1
14835,5030030109,SI,60 MERLE PLACE,01,B2,MCERLEAN ROBERT,2,1,1
14836,5032680050,SI,12 LINWOOD AVENUE,01,A2,ROBERT SPARANDERA,2,1,1
14837,5032890052,SI,157 WILSON STREET,01,A1,"AVSHALUMOVA, INNA",2,1,1
14838,5032920046,SI,31 ATLANTIC AVENUE,01,A1,ROBERT FABOZZI,2,1,1
14839,5033530061,SI,29 RUTH PLACE,01,A9,"WARD , MICHELE",2,1,1
14840,5035660032,SI,42 HAMDEN AVENUE,02,C0,"SALARIS , YOLANDA",2,1,1
14841,5037280021,SI,400 HAMDEN AVENUE,01,A5,RONNIE GUTERMAN,2,1,1
14842,5038210017,SI,312 MORELAND STREET,01,A1,MEZZANO FAMILY IRREVOCABLE TRUST DTD 6/2 6/2019,2,1,1
14843,5038470022,SI,12 IONA STREET,01,A1,ANGELA TROIA IRREVOCABLE TRUST,2,1,1
14844,5040010001,SI,2838 HYLAN BOULEVARD,02,C9,2862 HYLAN BOULEVARD CO LLC,46,45,1
14845,5040490005,SI,101 EBBITTS STREET,01,B2,THOMAS JAMES SATTLE,2,1,1
14846,5040860003,SI,125 CEDAR GROVE AVENUE,02,C0,F CINA,3,2,1
14847,5040880007,SI,178 ROMA AVENUE,01,A5,"D'ELLIA, JOSEPH",2,1,1
14848,5044360028,SI,160 WEST CEDARVIEW AVE,01,A3,ALEXANDER KAZDAN,2,1,1
14849,5044780603,SI,23 SABLE LOOP,01,A5,STEVEN LEON,2,1,1
14850,5051560087,SI,246 CLEVELAND AVENUE,01,A2,JOSEPH F CISEK,2,1,1
14851,5051950089,SI,40 WATERSIDE PARKWAY,01,A2,WILLIAM D KLIPPEL,2,1,1
14852,5052770045,SI,163 DAVID STREET,01,B2,"CUCCHIARA, CHRISTINA",2,1,1
14853,5052970059,SI,12 RIDGECREST AVENUE,01,A2,N TARANTINO,2,1,1
14854,5054940299,SI,640 ARTHUR KILL ROAD,05,K1,STATEN ISLAND MY BUSI,2,1,1
14855,5055260022,SI,3453 RICHMOND AVENUE,04,O8,"ARISTA CONCEPTS, LLC",2,1,1
14856,5055850083,SI,4569 AMBOY ROAD,05,K1,JEFFREY INC,2,1,1
14857,5056550020,SI,1048 ARTHUR KILL ROAD,01,B9,ZHAOWEN HUANG,2,1,1
14858,5067750203,SI,387 SHARROTT AVENUE,01,A1,"PETERSON, RUSSEL JR",2,1,1
14859,5069120019,SI,250 PARKWOOD AVENUE,01,A1,"GIOIOSA, MARIE E",2,1,1
14860,5070320068,SI,39 HEMLOCK STREET,01,B9,"CARLOTTI , ANN MARIE",2,1,1
14861,5074870050,SI,3010 VETERANS ROAD WEST,05,K6,"SAVO PLAZA, LLC",2,1,1
14862,5075720060,SI,145 RICHMOND VALLEY ROAD,01,B3,"TELMANY, MARK",2,1,1
14863,5075840033,SI,4934 ARTHUR KILL ROAD,01,B2,ADJ REAL ESTATE HOLDINGS LLC,2,1,1
14864,5077640041,SI,489 PAGE AVENUE,11,V0,NELLO DEVELOPMENT CORP,2,1,1
14865,5077750027,SI,26 DINTREE LANE,01,A1,"SETTE, GRACE",2,1,1
14866,5078260258,SI,7030 HYLAN BOULEVARD,01,A1,TOTTENVILLE DENTAL MA,2,1,1
14867,5078380051,SI,211 SPRAGUE AVENUE,01,A0,"U.S. BANK TRUST, N.A., TRUSTEE",2,1,1
14868,5078870042,SI,304 MANHATTAN STREET,01,B2,"CAMPANELLA, NICHOLAS A",2,1,1
14869,5078990001,SI,7448 AMBOY ROAD,05,O2,7448 AMBOY ROAD LLC,2,1,1
14870,5079960027,SI,171 ELLIS STREET,01,A5,"KEENEY, JOSEPH D",2,1,1
14871,5080220001,SI,183 WOOD AVENUE,01,B3,"TOTH, PAUL",2,1,1
14872,5080220011,SI,163 WOOD AVENUE,01,A1,THOMAS LONG,2,1,1
14873,5080430048,SI,219 WOOD AVENUE,01,A1,MURDOCCA ROCCO,2,1,1
14874,1004810010,MN,21 CLEVELAND PLACE,04,C7,21 CLEVELAND PLACE CORPORATION,2,1,1
14875,1005880029,MN,296 BLEECKER STREET,05,K2,"HOT POTATO LLC,",2,1,1
14876,1006170044,MN,224 WEST 13 STREET,02,C5,"UNITED GREENWICH, LLC",2,1,1
14877,1007340010,MN,439 WEST 36 STREET,06,E1,"439 WEST 36TH STREET, LLC",2,1,1
14878,1008950011,MN,111 EAST 39 STREET,02,C5,111 PARK LEXINGTON LLC,2,1,1
14879,1010440010,MN,345 WEST 53 STREET,02,C4,345 WEST 53RD LLC,2,1,1
14880,1011980045,MN,32 WEST 85 STREET,01,A9,"S & J INDUSTRIES, LLC",2,1,1
14881,1014050006,MN,105 EAST 70 STREET,05,O2,VISITING NURSE SERVICE OF NY INC,2,1,1
14882,1014050045,MN,162 EAST 71 STREET,01,A5,"CHATEAU FALCONVIEW, LLC",2,1,1
14883,1014290103,MN,203 EAST 74 STREET,04,D6,203 E 74,2,1,1
14884,1015920001,MN,97 EAST END AVENUE,09,Q1,NYC DEPARTMENT OF PARKS AND RECREATION,5,4,1
14885,1017050001,MN,2158 1 AVENUE,09,Q1,NYC DEPARTMENT OF PARKS AND RECREATION,2,1,1
14886,1017540103,MN,2107 5 AVENUE,01,B1,DAVID HAY,2,1,1
14887,2023790019,BX,430 EAST 158 STREET,01,B2,BB 430 E 158 BX LLC,2,1,1
14888,2025770056,BX,461 WALES AVENUE,02,C1,CROTONA DEVELOPMENT GROUP INC.,2,1,1
14889,2026910039,BX,1033A REV JAMES POLITE AVE,01,B1,LA ALMITA CORP.,2,1,1
14890,2030870001,BX,2302 HUGHES AVENUE,02,C0,"ALBANO, NICHOLAS",2,1,1
14891,2032370156,BX,2519 SEDGWICK AVENUE,01,A1,RAMIREZ CIPRIAN,2,1,1
14892,2032510401,BX,3201 JEROME AVENUE,07,Y9,NYC TRANSIT AUTHORITY,8,7,1
14893,2032630264,BX,3926 ORLOFF AVENUE,01,B1,"PIMENTEL, CARLOS",2,1,1
14894,2033530056,BX,3135 WEBSTER AVENUE,02,C0,31-35 WEBSTER AVENUE,3,2,1
14895,2034560051,BX,1934 O'BRIEN AVENUE,01,B3,"RIVERA, RAQUEL",2,1,1
14896,2034940018,BX,426 ST LAWRENCE AVENUE,01,A9,"MELENDEZ, GLORIA M",2,1,1
14897,2035000023,BX,428 BOLTON AVENUE,02,C0,CRUZ-CORTES MARIA,2,1,1
14898,2036930050,BX,2267 STORY AVENUE,01,A1,"DODDY, JOHN P",2,1,1
14899,2038140073,BX,2137 NEWBOLD AVENUE,01,B2,"AKHTER, SHAMIMA",2,1,1
14900,2038300017,BX,2316 ELLIS AVENUE,02,C0,"OQUEDO, JULIA",2,1,1
14901,2038320074,BX,2323 NEWBOLD AVENUE,01,B3,"CHOWDHURY, NAYMUL K",2,1,1
14902,2038840024,BX,1377 WHITE PLAINS ROAD,02,C0,PANTOJA VICTOR,2,1,1
14903,2039850023,BX,1511 OVERING STREET,01,B2,OVERING LLC,2,1,1
14904,2040230011,BX,1643 TAYLOR AVENUE,01,B1,"SAINTIL, KATY",2,1,1
14905,2040510057,BX,1833 HOLLAND AVENUE,01,B1,"RAHMAN, FATEMA",2,1,1
14906,2040540003,BX,815 MORRIS PARK AVENUE,04,S9,815 MORRIS PARK AVE CORP.,2,1,1
14907,2040770006,BX,2633 EAST TREMONT AVENUE,05,K9,"PEP BOYS-MANNY, MOE& JACK OF DELAWARE, I NC",3,2,1
14908,2040930010,BX,1661 RADCLIFF AVENUE,01,B1,"YANG, JOHN HUA",2,1,1
14909,2041080003,BX,1080 MORRIS PARK AVENUE,04,S2,THE BORGIA FAMILY TRUST IV,2,1,1
14910,2041080006,BX,1086 MORRIS PARK AVENUE,04,S9,1088 MORRIS PARK CORP.,4,3,1
14911,2041690029,BX,1723 CROSBY AVENUE,04,C7,1723 CROSBY AVENUE LLC,2,1,1
14912,2042300054,BX,1925 MULFORD AVENUE,01,B1,FRESELLA REALTY,2,1,1
14913,2042740045,BX,1902 WILLIAMSBRIDGE ROAD,05,K1,1916 WILLIAMSBRIDGEROAD    .,2,1,1
14914,2043170033,BX,610 PELHAM PARKWAY SOUTH,07,G3,LEEMILTS PETROLEUM INC,2,1,1
14915,2045470050,BX,2915 HOLLAND AVENUE,01,A1,HOLLAND AVENUE 29 CORP.,2,1,1
14916,2045520040,BX,2941 RADCLIFF AVENUE,02,C0,"POLANCO, WILSON",2,1,1
14917,2046540024,BX,644 EAST 220 STREET,02,C0,"CABRERA, EVELYN",2,1,1
14918,2046620049,BX,748 EAST 215 STREET,02,C0,"KEITA, KANDE",2,1,1
14919,2047090040,BX,3642 LACONIA AVENUE,08,M1,GOSPEL TRUMPET CHURCH OF GOD INC,2,1,1
14920,2047160006,BX,1108 EAST 222 STREET,01,B2,"RODRIGUEZ , MICHELLE  K",2,1,1
14921,2047360027,BX,3321 SEYMOUR AVENUE,01,B1,ANNA WILLIAMS,2,1,1
14922,2047780004,BX,3151 EDSON AVENUE,01,A2,"DIXON, YVONNE D",3,2,1
14923,2048660015,BX,969 EAST 230 STREET,02,C0,"BOUKIA, FABRICE",2,1,1
14924,2048670071,BX,966 EAST 232 STREET,01,B1,"CUNNINGHAM, AUSTIN",2,1,1
14925,2048780063,BX,1036 EAST 232 STREET,02,C0,"ADJOKATCHER-AKWADA,MIKE",2,1,1
14926,2048780079,BX,4171 LACONIA AVENUE,01,A5,JOHN O MCGEE,2,1,1
14927,2048850055,BX,3404 ELY AVENUE,01,A1,RAMIREZ ROBERTO,2,1,1
14928,2050750004,BX,4503 CARPENTER AVENUE,01,B3,CYRUS  ANDREW,2,1,1
14929,2050810036,BX,4546 RICHARDSON AVENUE,02,C0,"SOWKEY, NADIRA",3,2,1
14930,2052730036,BX,3 REEDS MILL LANE,01,A2,D & G BEN CORPORATION,2,1,1
14931,2053870040,BX,2893 WELLMAN AVENUE,01,B3,"SURIANELLO, MICHAEL J",2,1,1
14932,2053910040,BX,1441 GILLESPIE AVENUE,02,C0,"ZHUO, YING",2,1,1
14933,2054150108,BX,1508 LIBRARY AVENUE,01,A1,LEONARD HORVATH,2,1,1
14934,2054220026,BX,3066 OTIS AVENUE,01,B1,"AQUINO, ALEIDA A",2,1,1
14935,2054390051,BX,501 EDISON AVENUE,05,K1,PAT501 LLC,2,1,1
14936,2055050024,BX,142 MEAGHER AVENUE,01,A5,BRESCIA DENISE YOUNG,2,1,1
14937,2055290599,BX,3079 FERN PLACE,01,A1,"KURZ, ROBERT",2,1,1
14938,2055297501,BX,24 PENNYFIELD AVENUE,02,R2,UNAVAILABLE OWNER,2,1,1
14939,2056430079,BX,285 MINNIEFORD AVENUE,01,B9,"TAVERAS, WILFREDO",2,1,1
14940,2056440158,BX,140 REVILLE STREET,01,A1,"BOWEN, TISHA",2,1,1
14941,2056440194,BX,186 DITMARS STREET,01,A2,WOODS ROSETTA,2,1,1
14942,2056510165,BX,90 BEECH TREE LANE,01,A2,CAROTENUTO RAYMOND,2,1,1
14943,3003190031,BK,129 COLUMBIA STREET,02,C3,GREG O'CONNELL BENEFIT TRUST,2,1,1
14944,3003330015,BK,266 DEGRAW STREET,02,C0,266 DEGRAW ST LLC,2,1,1
14945,3003730038,BK,115 LUQUER STREET,02,C0,115-117 LUQUER REALTY LLC,3,2,1
14946,3004780038,BK,45 GARNET STREET,01,B9,LOUIS DEMATTEO JR,2,1,1
14947,3005310036,BK,90 PIONEER STREET,01,B9,ADAM C ARMSTRONG,2,1,1
14948,3005450015,BK,157 PIONEER STREET,06,E1,TOBIO & TOBIO LLC,2,1,1
14949,3005460014,BK,123 PIONEER STREET,01,A9,"KRONE, BENJAMIN",2,1,1
14950,3006390132,BK,164 20 STREET,05,O2,164 20TH LLC,2,1,1
14951,3006720023,BK,144 30 STREET,02,C0,"GIUNTA, JOHN",2,1,1
14952,3007220032,BK,268 42 STREET,06,F2,"RENCHIB, LLC",2,1,1
14953,3007500065,BK,729 46 STREET,02,C0,"CHEN, CHANG YAO",2,1,1
14954,3007900014,BK,320 50 STREET,01,B9,"MORENO, DAMIANA",2,1,1
14955,3008980024,BK,330 21 STREET,01,B3,"BLUE, JESSICA",2,1,1
14956,3010320033,BK,538 3 AVENUE,07,G4,SHAD LLC,2,1,1
14957,3010490032,BK,328 15 STREET,01,B2,"SATURDAY, PAMELA",2,1,1
14958,3012110075,BK,961 BERGEN STREET,02,C1,961 BERGEN STREET LLC,2,1,1
14959,3012860015,BK,1422 PRESIDENT STREET,02,C0,"GUREVITCH, NECHAMA D",2,1,1
14960,3012900059,BK,321 CROWN STREET,01,B9,321 CROWN HOLDINGS LLC,2,1,1
14961,3012950063,BK,291 MONTGOMERY STREET,01,B1,"TAFFE, NIGEL",2,1,1
14962,3013300023,BK,374 LEFFERTS AVENUE,01,B1,"HAIDER, JAFAR",2,1,1
14963,3013360006,BK,63 SCHENECTADY AVENUE,07,G4,WOLF,2,1,1
14964,3013460010,BK, DEAN STREET,07,U7,NYC TRANSIT AUTHORITY,2,1,1
14965,3014030070,BK,1717 PRESIDENT STREET,04,O8,CONGREGATION OHR MENACHEM,2,1,1
14966,3014030072,BK,1711 PRESIDENT STREET,01,B1,1711 PRESIDENT ST LLC,2,1,1
14967,3014070054,BK,1565 CARROLL STREET,01,B1,"LIBEROW, MENDY",2,1,1
14968,3014180024,BK,672 CROWN STREET,01,B1,"BARBER, ELI",2,1,1
14969,3015760001,BK,45 VAN SINDEREN AVENUE,06,E1,2465 ATLANTIC LLC,2,1,1
14970,3017630003,BK,221 SPENCER STREET,02,C1,221 SPENCER STREET HOLDINGS LLC,2,1,1
14971,3017780007,BK,977A BEDFORD AVENUE,08,I9,MARC-SCOT MEATS INC,2,1,1
14972,3018610070,BK,119 HERKIMER STREET,02,C0,"SAMUEL, JENNIFER P",2,1,1
14973,3022030007,BK,33 HEWES STREET,08,W2,CONG. KAHAL ADATH KR,2,1,1
14974,3028290026,BK,131 KINGSLAND AVENUE,04,S3,131 KINGSLAND LLC,2,1,1
14975,3029250037,BK,1039 GRAND STREET,07,G5,GRAND MORGAN EQUITIES LLC,2,1,1
14976,3029280020,BK,414 MASPETH AVENUE,06,E9,MASPETH REALTY CO,3,2,1
14977,3034010006,BK,1561 BROADWAY,04,K4,SNY RLTY CORP,3,2,1
14978,3034190027,BK,338 ELDERT STREET,02,C1,338 ELDERT LLC,2,1,1
14979,3036380012,BK,1431 LINDEN BOULEVARD,08,N2,HEARTSHARE ST. VINCENTS SERVICES,2,1,1
14980,3036410011,BK,1115 THOMAS S BOYLAND ST,01,B2,"NEDD, ALWYNN",2,1,1
14981,3037170005,BK,173 WILLIAMS AVENUE,01,B2,NYC HOUSING PRESERVATION AND DEVELOPMENT,2,1,1
14982,3038100014,BK,517 BRADFORD STREET,01,B1,TURNER WILBERT,2,1,1
14983,3039530001,BK,191 ASHFORD STREET,01,B2,"ESPINAL, YANERIS",3,2,1
14984,3039710014,BK,325 LINWOOD STREET,01,B2,"PERSAUD, MEENAWATIE",2,1,1
14985,3039850009,BK,375 CLEVELAND STREET,01,B1,"PORTER, MICHAEL",2,1,1
14986,3039990030,BK,2365 PITKIN AVENUE,02,C4,"TORRES, LETICIA S",2,1,1
14987,3040130002,BK,425 BARBEY STREET,01,B1,"WASHINGTON, CONSTANCE T",2,1,1
14988,3040170132,BK,414 ELTON STREET,01,A5,"GILL, ISMAY",2,1,1
14989,3040660014,BK,980 BLAKE AVENUE,01,A5,"PEREZ, VIRGENMINA",2,1,1
14990,3041650001,BK,379 EUCLID AVENUE,01,B3,ANNA BHAGWANDIN,2,1,1
14991,3042670004,BK,559 PINE STREET,01,B1,REL ASSOCIATES LLC,2,1,1
14992,3043060016,BK,662 SCHENCK AVENUE,01,B2,WILLIAMS SALOME,2,1,1
14993,3044780012,BK,466 MONTAUK AVENUE,01,A1,WILLIAM ACEVEDO,2,1,1
14994,3046310078,BK,199 EAST 95 STREET,02,C3,199 E 95TH LLC,2,1,1
14995,3046460014,BK,304 EAST 92 STREET,02,C3,CLIVE H SNAGG & MAGDALENE C SNAGG FAMILY  TRUST,2,1,1
14996,3047030030,BK,244 EAST 56 STREET,01,A5,"REID, OLIVE A",2,1,1
14997,3047320011,BK,572 EAST 48 STREET,01,B2,"THORNTON, GEORGE  W",2,1,1
14998,3048040057,BK,593 RUTLAND ROAD,02,C1,RUTLAND RESIDENCE LLC,2,1,1
14999,3050730034,BK,1223 CHURCH AVENUE,04,S9,E MILLER REALTY LLC,3,2,1
15000,3050840084,BK,123 LINDEN BOULEVARD,04,D6,123  LINDEN LLC,2,1,1
15001,3051750017,BK,466 WESTMINSTER ROAD,01,B3,"KOZAK, THOMAS",2,1,1
15002,3053540007,BK,212 BEVERLEY ROAD,01,A1,CYRIL B THOMAS,2,1,1
15003,3053570076,BK,401 EAST 5 STREET,02,C0,"KATZ, MARK",2,1,1
15004,3053710059,BK,515 EAST 2 STREET,01,B2,"RUPP, JUDAH",2,1,1
15005,3053880057,BK,641 EAST 4 STREET,02,C0,"HOSSAIN, AKBOR",2,1,1
15006,3054060006,BK,4211 17 AVENUE,01,A1,"FRIEDMAN, PAUL",2,1,1
15007,3054120005,BK,787 EAST 5 STREET,01,B2,DAVID & M LLC,2,1,1
15008,3054340021,BK,1636 45 STREET,01,B3,FASTEN ARON,2,1,1
15009,3054340067,BK,1651 46 STREET,01,A9,"KAUFMAN, HERSHEL",2,1,1
15010,3054550054,BK,1743 50 STREET,01,B1,"RAAB, CHAIM",2,1,1
15011,3054620072,BK,1929 51 STREET,01,A5,"KESTENBAUM, SHAINDY",2,1,1
15012,3054690020,BK,1944 51 STREET,01,A5,MOSHE HEIMFELD,2,1,1
15013,3054730018,BK,1728 52 STREET,01,B2,52ND STREET IRREVOCABLE TRUST,2,1,1
15014,3054750062,BK,1935 53 STREET,01,A9,EISIKOVIC MAX,2,1,1
15015,3054780041,BK,1684 53 STREET,01,A1,RETEK ZEV,2,1,1
15016,3054810027,BK,1948 53 STREET,01,B9,"SPUTZ, YAKOV Y",2,1,1
15017,3055310024,BK,1644 62 STREET,01,B3,"EL-KHATIB, MOHAMMED",2,1,1
15018,3056180012,BK,1414 45 STREET,01,B2,THE CHAIM AND SARAH KAUFMAN TRUST,2,1,1
15019,3056610069,BK,1107 53 STREET,02,C0,HONIG JANET,2,1,1
15020,3056820031,BK,1162 55 STREET,01,A1,"BAUER, ESTHER",2,1,1
15021,3056830020,BK,1232 55 STREET,01,B1,"KESTENBAUM, SHOLEM",2,1,1
15022,3057480036,BK,1435 65 STREET,06,E9,"HUANG, JIAN BIN",2,1,1
15023,3057660061,BK,1159 OVINGTON AVENUE,02,C0,LEE MINDY,2,1,1
15024,3060440042,BK,8610 4 AVENUE,04,S2,SUE JACK REALTY LLC,2,1,1
15025,3060630008,BK,8905 RIDGE BOULEVARD,01,B3,BRENDEN J CONROY,2,1,1
15026,3060890018,BK,119 GELSTON AVENUE,01,B3,"BITTAN, NEIL",2,1,1
15027,3061030031,BK,380 92 STREET,04,D7,10000 REALTY,2,1,1
15028,3061420030,BK,197 DAHLGREN PLACE,01,A5,PATRICK J O'DWYER,2,1,1
15029,3063130026,BK,8111 17 AVENUE,02,C0,"NERI, LUCIA",2,1,1
15030,3063460034,BK,2066 85 STREET,01,B2,2066 85 ST BK LLC,2,1,1
15031,3063920006,BK,1435 BATH AVENUE,01,B2,FAHMI D TAIEM,2,1,1
15032,3064260055,BK,8798 15 AVENUE,01,B1,"LEE, PATTI Y",2,1,1
15033,3065200059,BK,1069 EAST 7 STREET,01,A1,MATALON ALBERT,2,1,1
15034,3065240032,BK,1150 EAST 2 STREET,01,B1,"BEITEL, BINYAMIN",2,1,1
15035,3065340041,BK,1182 EAST 9 STREET,01,B2,"KHEZRIE, JOYCE",2,1,1
15036,3065400016,BK,1318 EAST 5 STREET,01,A5,STEVEN INDICH,2,1,1
15037,3065610015,BK,2420 63 STREET,01,A9,"HU, RUI HUAN",2,1,1
15038,3065620044,BK,1564 DAHILL ROAD,01,B3,RAUL CARAZO,2,1,1
15039,3065720009,BK,920 AVENUE M,01,B1,"PUENTES, CHRISTINA",2,1,1
15040,3065770080,BK,1443 WEST 8 STREET,01,B1,CHO K SZE,2,1,1
15041,3065880039,BK,1556 EAST 7 STREET,02,C0,"MOCHON, ISAAC",2,1,1
15042,3066100079,BK,1637 EAST 3 STREET,01,B2,SERUYA  DAVID,2,1,1
15043,3066390056,BK,1753 EAST 7 STREET,01,A9,"SHREM, ISAAC",2,1,1
15044,3066640039,BK,1789 EAST 7 STREET,01,B2,"DEPAOLO, WILLIAM",2,1,1
15045,3066880042,BK,790 RUGBY ROAD,01,A1,"FERHOLT, SARAH R",2,1,1
15046,3066960033,BK,864 EAST 13 STREET,01,B1,STURM IZAAK,3,2,1
15047,3067220035,BK,1172 EAST 12 STREET,01,B1,MODE GROUP INC.,2,1,1
15048,3067240069,BK,1143 EAST 13 STREET,01,B1,TIBOR WEISS,2,1,1
15049,3067320018,BK,1228 EAST 13 STREET,01,A5,"WEITZNER, SHMUEL",2,1,1
15050,3068260027,BK,1946 EAST 21 STREET,01,A2,"SHOUELA, ISAAAC",2,1,1
15051,3068330043,BK,2719 AVENUE S,01,A1,"MISHAN, MARC",2,1,1
15052,3068330059,BK,1873 EAST 27 STREET,01,A1,"BAILEY, DAVID",2,1,1
15053,3069570058,BK,3841 MAPLE AVENUE,01,A1,MARK SILBER,2,1,1
15054,3070240034,BK,5115 SURF AVENUE,01,A1,"DEXTER, MICHAEL",2,1,1
15055,3071040215,BK,1941 EAST 1 STREET,01,A3,ALBERT AYAL,2,1,1
15056,3071080038,BK,2072 OCEAN PARKWAY,01,A1,ALICE TAWIL,2,1,1
15057,3071350040,BK,2178 EAST 9 STREET,01,B1,HABIB SAADIA,2,1,1
15058,3071530060,BK,2271 EAST 1 STREET,01,B3,JACK NAFTALI,2,1,1
15059,3071560036,BK,2316 EAST 5 STREET,01,B1,"ESQUENAZI, SAMUEL",2,1,1
15060,3071570089,BK,2251 EAST 5 STREET,01,B1,"TOBY 2251, LLC",2,1,1
15061,3071700065,BK,224 AVENUE W,01,B1,"ZHENG, JIANHE",2,1,1
15062,3071830028,BK,2315 OCEAN PARKWAY,01,A1,"JAMMAL, DAVID",2,1,1
15063,3071830033,BK,2333 OCEAN PARKWAY,02,C0,MOURAD SHASHO,2,1,1
15064,3071840005,BK,712 AVENUE W,01,A5,"NAKASH, SALIM",2,1,1
15065,3071840057,BK,47 LANCASTER AVENUE,01,B1,"ISRAEL, SOLOMON",2,1,1
15066,3072050051,BK,2569 STILLWELL AVENUE,06,E1,TK LAND HOLDINGS LLC,2,1,1
15067,3072930064,BK,1957 EAST 14 STREET,01,A1,COHEN ISAAC,2,1,1
15068,3073170079,BK,2009 HOMECREST AVENUE,01,B2,RAYMOND LEVY,2,1,1
15069,3073660048,BK,2167 BATCHELDER STREET,01,A5,ERIC KA WAI LEUNG,2,1,1
15070,3073720012,BK,2216 HOMECREST AVENUE,01,A1,EDITTE HAMADANI,2,1,1
15071,3073820181,BK,2215 EAST 24 STREET,01,B2,"NG NG, CHI KUEN",2,1,1
15072,3074300072,BK,2765 CONEY ISLAND AVENUE,05,O5,"MVLM FAMILY, LLC",2,1,1
15073,3075710077,BK,874 EAST 26 STREET,01,A9,SHMUEL E SKAIST,2,1,1
15074,3075860047,BK,2214 AVENUE I,01,A3,"TESSLER, ARON",2,1,1
15075,3075860069,BK,952 EAST 23 STREET,01,A1,NAAVA KATLOWITZ,2,1,1
15076,3075950004,BK,3115 AVENUE J,01,A5,KATHERINE TODD,2,1,1
15077,3076020074,BK,1194 EAST 21 STREET,01,A1,"LIEBERMANN, ALAIN",2,1,1
15078,3076040013,BK,1149 EAST 22 STREET,01,A1,D & G WEISS FAMILY TRUST,2,1,1
15079,3076270069,BK,1160 EAST 28 STREET,01,A1,YEHUDA LEVI,2,1,1
15080,3076460033,BK,1229 EAST 28 STREET,01,A1,"BRAUN, ISAAC",2,1,1
15081,3077050061,BK,1658 EAST 33 STREET,01,B1,YAACOBI RAM,2,1,1
15082,3077190053,BK,1714 EAST 37 STREET,01,A9,JOHN J LAINO JR,2,1,1
15083,3078440070,BK,2058 SCHENECTADY AVENUE,01,A1,SINCLAIR MICHAEL,2,1,1
15084,3078810030,BK,1429 EAST 56 STREET,01,A9,QI DEBRAH,2,1,1
15085,3079270033,BK,805 EAST 51 STREET,01,A9,805 EAST 51ST STREET MANAGEMENT INC.,2,1,1
15086,3080140001,BK,7702 FLATLANDS AVENUE,07,G5,SPC FLATLANDS LLC,2,1,1
15087,3081470067,BK,9725 FARRAGUT ROAD,02,C0,JAMAL WILLIAMS,2,1,1
15088,3081860049,BK,257 CONKLIN AVENUE,01,A1,"NETTLES, PANSY",3,2,1
15089,3082630014,BK,1441 EAST 98 STREET,01,B2,"ORTIZ-MERCADO, LIZEIDA",2,1,1
15090,3084080053,BK,2057 EAST 65 STREET,01,A9,FRANK THOMAS,2,1,1
15091,3086420057,BK,2558 EAST 65 STREET,01,B2,"KALIKA, ROMAN",2,1,1
15092,3086560015,BK,2221 MILL AVENUE,01,A3,"KHRAPKO, IGOR",2,1,1
15093,3086960140,BK,3025 WEST 12 STREET,09,P6,3025 REALTY INC.,4,3,1
15094,3087430042,BK,215 EXETER STREET,01,A3,"FALIKMAN, TRUSTEE, SVETLANA",2,1,1
15095,3087530041,BK,114 KENSINGTON STREET,01,A5,UNAVAILABLE OWNER,2,1,1
15096,3087870001,BK,2700 VOORHIES AVENUE,01,A1,"BARANCHUK, OKSANA",2,1,1
15097,3087910009,BK,2824 VOORHIES AVENUE,01,A9,"RIAD, VOLHA",2,1,1
15098,4003210006,QN,33-42 9 STREET,05,O2,33-42 REALTY CORP.,2,1,1
15099,4003640006,QN,37-25 21 STREET,07,G2,"YARDLEY ASSOCIATES, LLC",2,1,1
15100,4005700016,QN,23-11 31 AVENUE,03,D1,"23-11/13 31ST AVE.,",3,2,1
15101,4005820004,QN,33-10 29 STREET,02,C0,"HUANG, LING DAI",2,1,1
15102,4005890002,QN,30-15 BROADWAY,04,C7,MOKOS FAMILY LIMITEDPARTNERSHIP,2,1,1
15103,4007200018,QN,28-19 46 STREET,01,B1,2819 46TH STREET REALTY LLC,2,1,1
15104,4007840045,QN,21-28 45 STREET,01,A5,"SAVRANSKY, YEVGENY",2,1,1
15105,4008570039,QN,21-14 28 STREET,02,C0,"SHIAMILI, GALATIA NICOLAOU",2,1,1
15106,4008820036,QN,20-31 21 STREET,01,B1,CAROL D'ANGELO,2,1,1
15107,4008900158,QN,23-29 19 STREET,01,A5,"SURILAS, DONISSIOS",2,1,1
15108,4011720017,QN,32-32 77 STREET,01,A5,ELEANOR S CANTUBA,2,1,1
15109,4012490018,QN,33-24 77 STREET,03,D3,PROVUDENT ALPINE PARTNERS,5,4,1
15110,4013050046,QN,40-36 74 STREET,04,S4,"RAHMANIA PROPERTIES, LLC",2,1,1
15111,4017190036,QN,104-15 34 AVENUE,01,B3,"PADILLA , SEGUNDO",2,1,1
15112,4017470169,QN,35-29 105 STREET,02,C0,BAO YUN SHI,2,1,1
15113,4017740030,QN,107-18 37 DRIVE,04,D7,107-18 37TH DRIVE LLC,2,1,1
15114,4017740059,QN,104-29 38 AVENUE,02,C3,"CAJAMARCA GOMEZ, LUIS F",2,1,1
15115,4017760133,QN,39-12 108 STREET,04,S3,"HERAS, CRUZ A",2,1,1
15116,4018540019,QN,90-42 52 AVENUE,02,C0,"YE, YAN",2,1,1
15117,4019440006,QN,103-20 53 AVENUE,04,S3,TAVERAS FRANKLIN,3,2,1
15118,4019530023,QN,55-26 VAN DOREN STREET,02,C0,"MUNZO, HERMAN",2,1,1
15119,4019840030,QN,104-66 ROOSEVELT AVENUE,04,K4,"FERREIRA, APOLINAR A",2,1,1
15120,4020050025,QN,108-52 49 AVENUE,01,B3,"PITA, EDUARDO",2,1,1
15121,4021080052,QN,99-29 62 DRIVE,01,A1,"KATANOFF, LOLITA",2,1,1
15122,4022220020,QN,108-30 70 AVENUE,01,A1,"KANDCHOROV, AARON",2,1,1
15123,4022300055,QN,110-21 JEWEL AVENUE,01,A3,"GONSALVES, LEONARD P",2,1,1
15124,4022640058,QN,112-47 QUEENS BOULEVARD,05,K1,"WONGTAITONG-QUEENS BOULEVARD,",3,2,1
15125,4023290125,QN,48-04 59 PLACE,02,C0,"SANTOS, LORENZO",2,1,1
15126,4024020021,QN,68-45 JAY AVENUE,01,B1,"LAM, VY",2,1,1
15127,4024070035,QN,53-15 68 STREET,02,C0,"DALY, DANIEL",2,1,1
15128,4024080006,QN,66-12 52 DRIVE,01,A5,"TZOROS, GEORGE",2,1,1
15129,4024720045,QN,51-82 CODWISE PLACE,01,B2,ANGELA LIU,2,1,1
15130,4024840076,QN,52-70 73 STREET,01,A5,"YU, ZHUO ZUO",2,1,1
15131,4025370001,QN,54-45 44 STREET,10,G7,54-45 44TH STREET HOLDINGS LLC,2,1,1
15132,4026740049,QN,58-56 MASPETH AVENUE,02,C0,"CHAVARRHA, ADOLFO",2,1,1
15133,4027530297,QN,64-49 59 AVENUE,01,A2,"ALTHAUSEN, PETER",2,1,1
15134,4027790018,QN,68-11 59 ROAD,02,C3,"SMARKUCKI, WIESLAW",3,2,1
15135,4028340069,QN,59-11 71 STREET,01,A1,ROBERT HINES,2,1,1
15136,4034070001,QN,589 ONDERDONK AVENUE,04,S5,FRATELLI MANAGEMENT II LLC,3,2,1
15137,4034740015,QN,58-48 CATALPA AVENUE,04,S2,58-50 CAT LLC,2,1,1
15138,4035140056,QN,60-15A CATALPA AVENUE,01,B2,"MATO, MAQO",2,1,1
15139,4037050014,QN,69-26 MYRTLE AVENUE,04,C7,"VACCARO, TRUSTEE, CHARLES J",2,1,1
15140,4037320235,QN,82-30 CYPRESS HILLS STREET,09,Z8,MACHPELAH CEMETERY,3,2,1
15141,4038140037,QN,77-56 78 STREET,01,B2,MARIA C REINHARDT,2,1,1
15142,4038790018,QN,81-51 WOODHAVEN BOULEVARD,02,C2,LINDA CALLAHAN,2,1,1
15143,4039400042,QN,121-16 5 AVENUE,02,C0,"LAU, PIK YUK",2,1,1
15144,4039530044,QN,126-10 6 AVENUE,01,A2,SCHWAB  GLEN,2,1,1
15145,4039680033,QN,124-09 9 AVENUE,01,B3,"RAMIREZ-COLLADO, CARMEN M",2,1,1
15146,4040040052,QN,11-10 128 STREET,01,B1,"SALAMA, FAHD F",2,1,1
15147,4044140098,QN,140-05 32 AVENUE,11,V0,Z AND H II REAL ESTATE LLC,2,1,1
15148,4046150018,QN,14-11 BURTON STREET,01,A1,"PARPIS, JOHN",2,1,1
15149,4049210005,QN,29-01 167 STREET,01,A5,"GANDELMAN, URIEL",3,2,1
15150,4049490081,QN,33-21 PRINCE STREET,06,E1,"GIULIANA BELLA, LLC",2,1,1
15151,4049490082,QN,33-19 PRINCE STREET,06,E1,THE MIDDLE WAY F8 LLC,2,1,1
15152,4049920037,QN,33-32 MURRAY LANE,01,A1,RUDOLPH R ACAMPORA,2,1,1
15153,4050370005,QN, LAWRENCE STREET,07,U7,LIRR,2,1,1
15154,4052050003,QN,146-04 45 AVENUE,04,S2,F&S BROADWAY HOLDING LLC,2,1,1
15155,4052770016,QN,158-06 NORTHERN BOULEVARD,05,O7,"NORTHERN BOULEVARD ASSOCIATES,",2,1,1
15156,4054210043,QN,43-24 164 STREET,01,A1,KEITH UM,2,1,1
15157,4054870049,QN,47-36 158 STREET,01,A1,"WANG, HSIAO-MEI",2,1,1
15158,4055810047,QN,171-33 BAGLEY AVENUE,01,A1,171-33 BAGLEY AVENUE LLC,2,1,1
15159,4060760040,QN,33-27 200 STREET,01,A5,"CANEVARI, NANCY",2,1,1
15160,4061420050,QN,35-09 FRANCIS LEWIS BLVD,05,K6,PHYLLIS REALTY CO,2,1,1
15161,4061560017,QN,35-22 208 STREET,01,A1,LUPOWITZ DAVID,2,1,1
15162,4063030028,QN,40-25 215 PLACE,01,A1,HOUSE NEXT DOOR LLC,2,1,1
15163,4063270017,QN,43-03 221 STREET,01,A1,"CHAN, JESSE",2,1,1
15164,4063990059,QN,138-03 64 AVENUE,01,A5,"PACE, ROBERT",2,1,1
15165,4068440030,QN,162-16 73 AVENUE,01,B3,"LIN, SHU QIN",2,1,1
15166,4072270029,QN,176-02 UNION TURNPIKE,07,G4,MUKTI 17802 LLC,2,1,1
15167,4072400036,QN,179-18 KILDARE ROAD,01,A3,"SHLOMO, SHLOMI",2,1,1
15168,4074740175,QN,45-45 220 PLACE,01,A1,"BARDONE, KATHERINE",2,1,1
15169,4075020018,QN,50-29 CLOVERDALE BOULEVARD,01,A2,JEWISH CENTER OF BAYS,2,1,1
15170,4080050180,QN,241-07 JAMAICA AVENUE,05,K2,PRITAM PROPERTIES,2,1,1
15171,4081400110,QN,41-59 GLENWOOD STREET,01,A1,"HE, CHRISTINA",2,1,1
15172,4081490002,QN,39 ROAD,07,U7,LIRR,2,1,1
15173,4086520018,QN,244-28 88 DRIVE,01,A2,"JIN, ORONIC OREAN",2,1,1
15174,4086680037,QN,252-04 87 DRIVE,01,A1,"MAISONET, JOHN",2,1,1
15175,4088600049,QN,85-43 85 STREET,01,B2,SINGH JAINARINE,2,1,1
15176,4090200005,QN,86-08 ATLANTIC AVENUE,02,C1,8608 10 LLC,2,1,1
15177,4090410032,QN,95-20 97 STREET,01,B3,"MARAJ, DHARYL",2,1,1
15178,4091860030,QN,102-41 86 ROAD,01,B3,"ARZOMAND, SHAMSUL Z",2,1,1
15179,4092330079,QN,84-20 118 STREET,01,A1,"CYPERSTEIN, AARON I",2,1,1
15180,4092510027,QN,85-18 131 STREET,01,A1,RAWATTIE SOMAI,2,1,1
15181,4092820040,QN,86-43 130 STREET,01,B3,FATIMA VERAS,2,1,1
15182,4093370016,QN,87-20 130 STREET,01,B2,"PRIETO, PHULMATIE",2,1,1
15183,4093380056,QN,88-22 132 STREET,02,C0,"A CUNA, NOCILJA M.R.A.",2,1,1
15184,4093540019,QN,89-28 129 STREET,01,B3,"BAEZ, HEIDY E",2,1,1
15185,4093970012,QN,94-18 112 STREET,01,A1,AGOSTINI EVELYN,2,1,1
15186,4094360038,QN,94-51 118 STREET,01,B1,"SINGH, PARDUMAN",2,1,1
15187,4094830030,QN,97-28 VAN WYCK EXPRESSWAY,07,G4,FANTASY OIL CORP,3,2,1
15188,4095510045,QN,113-03 109 AVENUE,01,B1,"PEARAYLALL, JAIPAUL",2,1,1
15189,4096040032,QN,107-52 125 STREET,01,B3,"GUIADEEN, GANESH",2,1,1
15190,4096530001,QN,125-01 82 AVENUE,08,Z1,NYC DEPARTMENT OF CORRECTIONS,4,3,1
15191,4096750014,QN,89-18 146 STREET,01,B1,"AZEEM, FAZIL",3,2,1
15192,4097070008,QN,150-14 87 AVENUE,01,B3,FAZLUL KABIR,2,1,1
15193,4097910037,QN,161-01 84 DRIVE,01,A1,"LIAO, QINGRONG",2,1,1
15194,4098460010,QN,164-11 HIGHLAND AVENUE,02,C1,"164-11 HIGHLAND AVENUE QUEENS, LLC",2,1,1
15195,4099190003,QN,182-41 89 AVENUE,02,C3,SEAN M MOHAN,2,1,1
15196,4099580053,QN,184-48 HENLEY ROAD,01,A2,"WALKER, TERRY",2,1,1
15197,4100100038,QN,97-23 REMINGTON STREET,02,C0,"SINGH, DEBITREE",2,1,1
15198,4100190053,QN,138-45 LLOYD ROAD,01,A1,"GHOSH, ARINDAM K",2,1,1
15199,4101630070,QN,104-46 165 STREET,01,A1,"TAMIM INTERNATIONAL USA, INC",2,1,1
15200,4101850150,QN,109-48 167 STREET,01,A1,"BENNETT, NICOLA",2,1,1
15201,4101930022,QN,110-34 166 STREET,01,A1,"NICHOLS, MARLON HENRY",2,1,1
15202,4102410050,QN,105-46 172 STREET,01,B3,ALCUT WOLFE,2,1,1
15203,4104390039,QN,189-11 KEESEVILLE AVENUE,01,A1,EULA M WILLIAMS,2,1,1
15204,4104990072,QN,190-11 HILLSIDE AVENUE,03,D1,190-11 HILLSIDE LLC,2,1,1
15205,4105560073,QN,90-50 207 STREET,01,A1,QADAR A. SYED,2,1,1
15206,4107240084,QN,94-15 SPRINGFIELD BLVD,01,A1,HOLDER RUSSEL,2,1,1
15207,4107410164,QN,222-01 JAMAICA AVENUE,04,O8,222-01 JAMAICA AVENUE LLC,2,1,1
15208,4107840010,QN,97-31 219 STREET,01,A1,"SINGH, KHEMNARINE UDAI",2,1,1
15209,4108500029,QN,99-19 203 STREET,01,A1,"MASSA, SABRINA",2,1,1
15210,4108780089,QN,99-62 211 STREET,01,A1,MEALING SARAH B,2,1,1
15211,4109400109,QN,200-26 HOLLIS AVENUE,04,S2,ANDREE FAUSTIN,2,1,1
15212,4109830010,QN,112-31 FRANCIS LEWIS BLVD,01,B1,"AKBARI, MOMEN",2,1,1
15213,4109960038,QN,113-25 201 STREET,01,A1,YVETTE SCREVEN,2,1,1
15214,4110170023,QN,114-36 201 STREET,01,A5,"REID, TIFFANIE  A",2,1,1
15215,4110380055,QN,115-22 198 STREET,01,A1,"RAMDYHAN, RENRICK",2,1,1
15216,4110660012,QN,116-43 194 STREET,01,A1,RICHARD THOMPSON,2,1,1
15217,4110720014,QN,116-33 200 STREET,01,A1,JEAN SONNY LOUIS,3,2,1
15218,4111310015,QN,210-17 113 AVENUE,01,A1,BRIERRE PATRICK,2,1,1
15219,4113490016,QN,132-22 87 STREET,01,A1,"REDOUANE, SED",2,1,1
15220,4114820021,QN,110-29 107 STREET,01,B2,"ASCHER, IRIS",2,1,1
15221,4116420018,QN,114-22 116 STREET,01,B1,"NABI, GEORGE",3,2,1
15222,4116840044,QN,116-43 127 STREET,01,A1,"GUEVARA, MICHAEL",2,1,1
15223,4116930001,QN,128-01 ROCKAWAY BOULEVARD,06,E1,"128-13 ROCKAWAY BLVD REALTY, LLC",2,1,1
15224,4117780100,QN,131-50 134 STREET,01,B3,"MULTANI, KULVIR",2,1,1
15225,4117820011,QN,133-53 123 STREET,01,B2,EDILIO COLLADO,2,1,1
15226,4119630025,QN,111-34 LIVERPOOL STREET,01,A1,"MARAJH, KEVIN",2,1,1
15227,4120380063,QN,142-51 123 AVENUE,01,B3,"SINGH, SHERWIN C",3,2,1
15228,4120600272,QN,142-31 SUTTER AVENUE,01,B3,"RAMROOP, RENOLD N",2,1,1
15229,4120700101,QN,128-15 145 STREET,01,A1,"LOPEZ, LIZETTE",3,2,1
15230,4120840177,QN,133-13 VAN WYCK EXPRESSWAY,01,A1,"SAFIE, ABDOOL ASIF",3,2,1
15231,4121780223,QN,112-60 DILLON STREET,01,B2,"WONG, DENISE",2,1,1
15232,4121810013,QN,160-08 111 AVENUE,01,A1,"SIMPSON, AVERY",2,1,1
15233,4122120028,QN,150-42 120 AVENUE,01,B3,VILLAGE PLAZA HOMES INC,2,1,1
15234,4125260126,QN,176-06 126 AVENUE,01,B2,"FLEMING, SHEREE",2,1,1
15235,4126380051,QN,118-09 203 STREET,01,A5,"CLEMENT, GREGOIRE",2,1,1
15236,4126790001,QN,195-02 120 AVENUE,01,A2,"FRANCOIS, PATRICK",2,1,1
15237,4127020089,QN,186-09 NASHVILLE BOULEVARD,01,B3,"DAUGHTRY, LILLY",2,1,1
15238,4127040028,QN,188-10 122 AVENUE,01,A1,"MILLER, DORA L",2,1,1
15239,4127800075,QN,119-18 221 STREET,01,A2,JOSEPH M BRANCH JR,2,1,1
15240,4129230021,QN,217-06 132 AVENUE,02,C0,BRIAN MAYERS,3,2,1
15241,4129350035,QN,131-06 226 STREET,01,A5,SELMA LERTOLA,2,1,1
15242,4129860045,QN,178-43 CRANDALL AVENUE,01,A1,ROBERT R ALLEN,2,1,1
15243,4135950009,QN,249-03 MEMPHIS AVENUE,01,B2,"KHAN, JAVID A",2,1,1
15244,4136600017,QN,254-12 CRAFT AVENUE,02,C0,ROBERTS ANCILLA,2,1,1
15245,4137500168,QN,147-79 EDGEWOOD STREET,01,B3,"DORSAINVILLE, MARIE ALTA",2,1,1
15246,4153120002,QN,810 SHAD CREEK ROAD,01,A2,"CIAVARELLA, FRANK",2,1,1
15247,4154640010,QN,205 EAST 9 ROAD,01,B2,"KITTLE, BRIAN",4,3,1
15248,4155600044,QN,18-30 CORNAGA AVENUE,08,M1,GREATER NY CP/7TH-DAY/AD,2,1,1
15249,4156060030,QN,2-09 SEAGIRT AVENUE,01,A2,"KENNER, BORUCH",2,1,1
15250,4156640100,QN,13-61 GIPSON STREET,01,A1,"KHANZADA, NASIR J",2,1,1
15251,4157340075,QN,25-50 BESSEMUND AVENUE,01,A1,"MAYEFSKY, BINYAMIN",2,1,1
15252,4160810097,QN,328 BEACH 70 STREET,01,A1,"WATLER, DAVID MARK",2,1,1
15253,4161660426,QN,112-01 BEACH CHANNEL DRIVE,07,G4,"GTY-CPG(QNS/BX)LEASING,INC.",2,1,1
15254,4162440069,QN,5-50 BEACH 133 STREET,01,B3,S MOULE,2,1,1
15255,4162550001,QN,4-68 BEACH 133 STREET,01,B3,CINCOTTA CHRISTOPHER,2,1,1
15256,4162630058,QN,432 BEACH 141 STREET,01,A1,"COSENTINO, TARA",2,1,1
15257,4162940054,QN,426 BEACH 144 STREET,01,A1,ROBERT PALOMBO,2,1,1
15258,4163090020,QN,144-04 ROCKAWAY BEACH BLVD,01,A1,"GUY, MATTHEW J.",2,1,1
15259,4163150075,QN,1-84 BEACH 142 STREET,01,A1,"EVANGELISTA, PETER",2,1,1
15260,5000580051,SI,20 HARVARD AVENUE,01,A1,CLARENCE ALSTON,2,1,1
15261,5001010647,SI,63 CONYINGHAM AVENUE,01,A1,FRANCIOSA GERARD,2,1,1
15262,5001490116,SI,144 DAVIS AVENUE,01,B3,"BOVA, THERESA",2,1,1
15263,5002150062,SI,310 CLOVE ROAD,01,A1,"MALDONADO, LEONARDO",2,1,1
15264,5002250021,SI,274 MYRTLE AVENUE,01,A1,"WHORTON, KEVIN",2,1,1
15265,5002380150,SI,1185 FOREST AVENUE,01,B2,RAMAZAN BILALI,2,1,1
15266,5002400063,SI,61 EAST CHESHIRE PLACE,01,A1,"BEEBER, CARLA",2,1,1
15267,5002490019,SI,16 GREENWOOD AVENUE,01,B2,DANIEL P BLAINE,2,1,1
15268,5003130014,SI,12 PURCELL STREET,01,A1,"RATEL, MICHAEL",2,1,1
15269,5004660059,SI,366 DEMOREST AVENUE,01,A2,"CARLUCCI, MATTHEW",2,1,1
15270,5004750068,SI,312 CRYSTAL AVENUE,01,A2,"NGUYEN, DUNG",2,1,1
15271,5005180040,SI,162 WRIGHT STREET,01,B2,THOMAS GARPESTAD,2,1,1
15272,5005280048,SI,704 BAY STREET,04,S2,704 BAY ST. CORP.,2,1,1
15273,5005290032,SI,26 BROAD STREET,04,S2,"PG BROAD STREET, LLC",2,1,1
15274,5006020047,SI,18 GLENWOOD AVENUE,01,A1,"COLVETT, LARRY D",2,1,1
15275,5006600008,SI,40 OSWEGO STREET,01,B2,"FODERA, JOHN C",2,1,1
15276,5007320052,SI,243 BYRNE AVENUE,01,A2,"TRBACI, ERMIRA",2,1,1
15277,5007770035,SI,268 KELL AVENUE,01,A1,BARRY FLEISCHMANN,2,1,1
15278,5008690319,SI,8 SOPHIA LANE,01,A3,GONG LIN & XUESU,2,1,1
15279,5009440027,SI,34 WALDEN AVENUE,01,B2,"VENDITTO, CHRIS  R",3,2,1
15280,5010220020,SI,126 PARK AVENUE,01,A1,KEVIN C BURKE,2,1,1
15281,5010290052,SI,924 POST AVENUE,01,B2,SHALABI ABDELNASER,2,1,1
15282,5010340039,SI,101 ANDERSON AVENUE,01,B3,"OYEKANMI, ADEBOLA A",2,1,1
15283,5010440157,SI,158 DECKER AVENUE,01,A1,"ARIAS, EVELYN",2,1,1
15284,5010500100,SI,110 CATHERINE STREET,01,B2,"LEHMAN, JACK",2,1,1
15285,5010760030,SI,41 SHARPE AVENUE,01,B2,ANTHONY ROCCO,2,1,1
15286,5010800024,SI,18 HARRISON AVENUE,01,A1,JEWEL MALAVE,2,1,1
15287,5011320104,SI,21 LINDA COURT,01,A5,"U.S. BANK TRUST N.A., AS TRUSTEE FOR LSF 9 MASTER",2,1,1
15288,5011580082,SI,62 HOUSMAN AVENUE,01,A1,LORRAINE ZAZULA,2,1,1
15289,5011830005,SI,1881 FOREST AVENUE,07,G3,GETTY PETROLEUM MARKETING INC,2,1,1
15290,5011860013,SI,87 VAN NAME AVENUE,01,A1,"NUNEZ, ARTEMIO JR",2,1,1
15291,5012130043,SI,65 UNION AVENUE,01,B2,PEDRO FORTOSO,2,1,1
15292,5012160052,SI,222 VAN PELT AVENUE,01,B2,"TAYLOR, CYNTHIA",2,1,1
15293,5015970200,SI,321B HILLMAN AVENUE,01,A5,"MELO, JOSEPH M",2,1,1
15294,5016050134,SI,183 KIRSHON AVENUE,01,A2,"AMARASHINGHE, PATHIRANAGE",2,1,1
15295,5028400030,SI,120 TOWNSEND AVENUE,01,B3,DARIN GERVAIS,2,1,1
15296,5030030010,SI,172 HOPE AVENUE,01,B2,"LIU, BIZHONG",2,1,1
15297,5030057501,SI, NARROWS ROAD NORTH,02,R3,NAME NOT ON FILE,103,102,1
15298,5030230045,SI,18 NARROWS ROAD SOUTH,01,B2,PATRICIA DESMOND TRUST DTD 12/8/14,2,1,1
15299,5030400083,SI,71 RODERICK AVENUE,01,B1,"MARRACCINO, ROBERT",2,1,1
15300,5030720152,SI,133 SCHOOL ROAD,01,B3,"MERONE, LANA",2,1,1
15301,5032540019,SI,254 KENSINGTON AVENUE,01,A2,DAVID AUILES,2,1,1
15302,5033310018,SI,224 ATLANTIC AVENUE,01,A5,EILEEN M BROWN,2,1,1
15303,5035350097,SI,19 STOBE AVENUE,01,B9,"COSTELLO, SALVATORE J",2,1,1
15304,5035600020,SI,211 HULL AVENUE,01,A2,"KARPUZI, BESIM",2,1,1
15305,5035880035,SI,60 EDISON STREET,01,B2,"ZARKHIN, YAROSLAV",2,1,1
15306,5035920090,SI,69 FREMONT AVENUE,01,A5,HARRY RYAN,2,1,1
15307,5036160031,SI,251 BANCROFT AVENUE,01,A2,"BOBISH, DEL P",2,1,1
15308,5041970037,SI,100 2 STREET,01,B2,DEBRA MORRI,2,1,1
15309,5042220042,SI,80 CODDINGTON AVENUE,01,A1,"DMITRIYEVA, NATALYA",2,1,1
15310,5042740119,SI,142 PETER AVENUE,01,B3,STEPHANIE GARFALO,2,1,1
15311,5043020093,SI,3014 RICHMOND ROAD,05,K1,KANG ASSOCIATES LLC,2,1,1
15312,5044040027,SI,48 CENTER STREET,01,A3,"BOLAND, CHRISTOPHER M",2,1,1
15313,5044370001,SI,203 CENTER STREET,02,C0,"SHARON, ARIE",2,1,1
15314,5045830221,SI,128 TANGLEWOOD DRIVE,01,A5,JOSEPH T YACCA,2,1,1
15315,5051570023,SI,276 CLEVELAND AVENUE,01,A2,"FITZPATRICK, JOSEPH M",2,1,1
15316,5052930050,SI,155 RIDGECREST AVENUE,01,A2,MARIE L DREWS-D'ANGELO,2,1,1
15317,5053780112,SI,4539 HYLAN BOULEVARD,01,A1,DAVID ISAKESEN,2,1,1
15318,5054080043,SI,4677 HYLAN BOULEVARD,05,K5,MOUDATSOS MICHAEL,2,1,1
15319,5054340018,SI,72 MARGARET STREET,01,B2,"DAVID, ANTHONY",2,1,1
15320,5055150152,SI,188 ELTINGVILLE BLVD,01,B3,"BARBELLA, FRANK",2,1,1
15321,5055310009,SI,3409 RICHMOND AVENUE,01,A2,DAVID N FERGUSON,2,1,1
15322,5056920043,SI,18 CROWN AVENUE,01,A5,SYLVIA SBLANO,2,1,1
15323,5060850130,SI,15 DAHLIA STREET,01,B2,JOSEPH DI VITA,2,1,1
15324,5062350053,SI,193 SHELDON AVENUE,01,B2,"NIERENBERG, STEVEN",2,1,1
15325,5065430018,SI,1297 HUGUENOT AVENUE,01,A1,"MOSCOSO, CHRISTINE",2,1,1
15326,5066990074,SI,346 SEGUINE AVENUE,05,O7,STATEN ISLAND UNVRST HSPTL,2,1,1
15327,5069060053,SI,353 ASHLAND AVENUE,01,B2,GENNADY KLEYN,2,1,1
15328,5070670090,SI,39 ST LUKES AVENUE,05,HB,JOHN VINCENT SCALIA,2,1,1
15329,5075780232,SI,72 MADSEN AVENUE,01,A1,"CUCCARO, JOHN",2,1,1
15330,5078380056,SI,199 SPRAGUE AVENUE,01,B2,ANNA ROTONDO,2,1,1
15331,5078570001,SI, BILLOP AVENUE,09,Q1,NYC DEPARTMENT OF PARKS AND RECREATION,2,1,1
15332,5078610015,SI,360 LORETTO STREET,01,A1,"UCHYTEL OLEKSIY REVOCABLE, LIVING TRUST",2,1,1
15333,5078880013,SI,248 BRIGHTON STREET,01,A5,"SANTELMO, JO ANNE",2,1,1
15334,5080450030,SI,227 YETMAN AVENUE,01,B2,"LAZZARA, GIOVANNI",2,1,1
15335,5080460057,SI,366 CRAIG AVENUE,01,A1,CARMINE&A MANGINO,2,1,1
15336,1002830070,MN,158 EAST BROADWAY,04,C7,"WEILGUS PROPERTIES,",3,2,1
15337,1004150067,MN,139 ORCHARD STREET,05,H9,ALLEN STREET OWNER LLC,2,1,1
15338,1004850037,MN,460 BROOME STREET,05,O5,460-26 BROOME STREET LLC,2,1,1
15339,1005430047,MN,140 WEST 4 STREET,04,C7,MERRIMAKER CORP,2,1,1
15340,1005560048,MN,120 EAST 12 STREET,08,H8,NEW YORK UNIVERSITY,2,1,1
15341,1005760054,MN,23 WEST 12 STREET,02,C3,TRACY J LEEDS,2,1,1
15342,1006190070,MN,226 WEST 4 STREET,04,C7,228 W 4TH OWNERS CORP,2,1,1
15343,1006330006,MN,717 WASHINGTON STREET,02,C6,WASHINGTON W 11TH ST OWN CP,7,6,1
15344,1006420067,MN,79 JANE STREET,01,B1,FREDERICK DANIEL GABEL JR. 2002 ANNUNITY  TRUST,2,1,1
15345,1008000005,MN,253 7 AVENUE,08,M1,UNITED CHURCH OF CHRIST,2,1,1
15346,1008300053,MN,14 WEST 29 STREET,04,C7,LGF ENTERPRISES,2,1,1
15347,1008890029,MN,153 EAST 33 STREET,04,S3,153 EAST 33RD ST FAMILY LIMITED PARTNERS HIP,2,1,1
15348,1010320101,MN,355 WEST 41 STREET,04,C7,MOLLANEY LLC C/O SAND,2,1,1
15349,1010440006,MN,353 WEST 53 STREET,02,C6,351 353 TENANTS CORP,2,1,1
15350,1019670060,MN,423 WEST 127 STREET,05,O2,NEIGHBORHOOD EIGHTH AVENUE LLC,3,2,1
15351,1019880200,MN,1540 AMSTERDAM AVENUE,09,Q1,NYC DEPARTMENT OF PARKS AND RECREATION,2,1,1
15352,1021310013,MN,562 WEST 175 STREET,04,C7,470 AUDUBON AVE CORP,2,1,1
15353,2023700024,BX,500 EAST 166 STREET,05,K1,ORTIZ FELIPE,2,1,1
15354,2025210015,BX,1380 PLIMPTON AVENUE,07,G4,LEEMILTS PETROLEUM INC,2,1,1
15355,2026990013,BX,956 ROGERS PLACE,01,B2,"GARCIA, VICTOR",2,1,1
15356,2027680145,BX,558 TIFFANY STREET,07,G2,"TST ASSOCIATES HOLDING,    .",3,2,1
15357,2028070079,BX,2001 CRESTON AVENUE,01,A9,"2001 CRESTON, LLC",2,1,1
15358,2028220012,BX,1694 WALTON AVENUE,03,D1,MNJS LLC,2,1,1
15359,2030860018,BX,2254 HUGHES AVENUE,01,A1,"2254 HUGHES AVENUE REAL ESTATE, LLC",2,1,1
15360,2030910017,BX,650 EAST FORDHAM ROAD,04,K4,"NBA APARTMENTS, LLC",3,2,1
15361,2032630039,BX,3854 BAILEY AVENUE,02,C0,CHENG STEPHEN SHAO CH,2,1,1
15362,2033080051,BX,253 EAST 202 STREET,03,D9,NINCILA PROPERTIES LLC,3,2,1
15363,2033830084,BX,319 EAST 234 STREET,01,A1,"HEENAN, LAMBERT",2,1,1
15364,2034970055,BX,417 LELAND AVENUE,01,A1,"ACOSTA, FRANKLIN",2,1,1
15365,2036120022,BX,2117 VIRGIL PLACE,02,C0,BARCLAY BROWNSTONES DEVELOPMENT LLC,2,1,1
15366,2037620042,BX,1241 ST LAWRENCE AVENUE,04,S2,"GUAMAN SHAMBI, SAUL  A",2,1,1
15367,2037670069,BX,1255 WHITE PLAINS ROAD,01,A2,AYALA DOMINGO,2,1,1
15368,2037990144,BX,1067 OLMSTEAD AVENUE,02,C0,"PALACIOS, GILBERT",2,1,1
15369,2038020054,BX,2059 POWELL AVENUE,01,B2,"FERNANDEZ, GUILLERMINA",3,2,1
15370,2038770060,BX,1327 TAYLOR AVENUE,01,B2,"CAMPOS , PEDRO F",3,2,1
15371,2038900067,BX,1417 FTELEY AVENUE,02,C0,"RAMIREZ, CESAR",2,1,1
15372,2039320165,BX,2042 MCGRAW AVENUE,04,S3,2042 MCGRAW LLC,2,1,1
15373,2040080030,BX,459 MORRIS PARK AVENUE,04,D7,1186 REALTY LLC,2,1,1
15374,2041000003,BX,1056 VAN NEST AVENUE,01,B9,LOUIS LOMBARDI,3,2,1
15375,2041580045,BX,1633 EDISON AVENUE,02,C0,"ZHANG , XIAO XIA",2,1,1
15376,2042470025,BX,2056 CONTINENTAL AVENUE,01,B1,SERRANO BENJAMIN,2,1,1
15377,2043320043,BX,2134 TOMLINSON AVENUE,01,B3,"GUNI, NDOC",3,2,1
15378,2045150022,BX,2803 BOSTON ROAD,07,G2,TJC OPERATIONS INC,2,1,1
15379,2045170003,BX,979 ALLERTON AVENUE,05,K1,ALLERTON PLAZA LLC,2,1,1
15380,2045640050,BX,2786 SEXTON PLACE,01,A1,"FUENTES, WALTER",2,1,1
15381,2046010003,BX,731 NORTH OAK DRIVE,01,B3,"ELLIS, DESMOND",2,1,1
15382,2047170024,BX,1450 OAKLEY STREET,02,C0,"TETTEH, JOSEPH N JR",2,1,1
15383,2047560036,BX,1835 BURKE AVENUE,01,A5,HILDA PIAZZA,2,1,1
15384,2047620024,BX,1381 EAST GUN HILL ROAD,05,K2,HAWTHORNES ESTATE INC,2,1,1
15385,2048240069,BX,666 EAST 223 STREET,02,C0,BROWN JOAN,2,1,1
15386,2048380022,BX,753 EAST 224 STREET,02,C1,JOE ROD CORP,2,1,1
15387,2048420009,BX,761 EAST 228 STREET,01,B1,"OBI, RAPHAEL",2,1,1
15388,2048540025,BX,845 EAST 229 STREET,01,A1,"DE LOS SANTOS, CECILIA",2,1,1
15389,2049490126,BX,4067 BOSTON ROAD,07,G9,"VIENI, MARIE",2,1,1
15390,2049570057,BX,3919 MURDOCK AVENUE,01,A1,"RICHARDS, OMARI",2,1,1
15391,2049740070,BX,3966 PROVOST AVENUE,06,F9,COUNTY ASPHALT INC,4,3,1
15392,2049910032,BX,4046 BELL AVENUE,01,A1,"BROWN, DIANA RHONDA",2,1,1
15393,2052800040,BX,3525 CONNER STREET,07,G2,3525 CONNER STREET LLC,2,1,1
15394,2053270016,BX,1110 CLARENCE AVENUE,01,B9,"ACEVEDO, CHRISTIAN O",2,1,1
15395,2053270018,BX,1112 CLARENCE AVENUE,01,B9,"DEMARTINO, TINA",2,1,1
15396,2053350021,BX,2906 WATERBURY AVENUE,01,B3,ZEKIROSKI ALTN,2,1,1
15397,2053660008,BX,1352 MERRY AVENUE,02,C0,UNAVAILABLE OWNER,2,1,1
15398,2053730048,BX,2839 CODDINGTON AVENUE,01,A1,"GARCIA-MONTAS, ALEJANDRO  A",2,1,1
15399,2053880040,BX,2885 ZULETTE AVENUE,01,A1,"MICHIALIS, VASILIOS",2,1,1
15400,2054280048,BX,833 LOGAN AVENUE,01,A1,"EDUARDO, DOMENICO",2,1,1
15401,2054320038,BX,757 LOGAN AVENUE,01,A1,"ISIDORO, ARACELI",2,1,1
15402,2054410014,BX,526 LOGAN AVENUE,02,C0,"XIAO, BIN",2,1,1
15403,2055430066,BX,848 REVERE AVENUE,01,B1,"IOCOVELLO, ELIZABETH",2,1,1
15404,2055460061,BX,858 SWINTON AVENUE,01,B3,"CAI, XU LONG",2,1,1
15405,2056250065,BX,30 PILOT STREET,03,D1,KRAMLUAP REALTY LLC C,2,1,1
15406,2056260162,BX,71 REYNOLDS STREET,01,B1,"MATOS, RENE",2,1,1
15407,2056260190,BX,44 PELL PLACE,01,A2,"TROMBETTA, MARGUERITE",2,1,1
15408,2056460027,BX,469 MINNIEFORD AVENUE,01,A1,"AMIR, ROSEMARIE",2,1,1
15409,2056490120,BX, HIGH ISLAND,,Z9,CBS RADIO EAST INC.,7,6,1
15410,3002110001,BK,27 HICKS STREET,08,W1,NYC DEPARTMENT OF EDUCATION,2,1,1
15411,3002610043,BK,34 GARDEN PLACE,01,A9,"KELLEHER , DENIS P",2,1,1
15412,3003770014,BK,142 LUQUER STREET,02,C0,"VAN RHYN, HELEN",2,1,1
15413,3006430053,BK,219 22 STREET,01,B9,"MACKIEWICZ, MARCIN",2,1,1
15414,3006460048,BK,722 5 AVENUE,04,S5,722 5TH AVENUE LLC,2,1,1
15415,3007080026,BK,346 39 STREET,06,E2,AAA- ARROW REALTY INC,2,1,1
15416,3008080066,BK,521 53 STREET,02,C0,"RODRIGUEZ, DOLORES",3,2,1
15417,3008970055,BK,271 22 STREET,01,B3,MOHAMMAD KHALID,2,1,1
15418,3011540021,BK,624 GRAND AVENUE,02,C0,"DELBRIDGE, CATHERINE L.",2,1,1
15419,3011640035,BK,210 PARK PLACE,03,D1,"210 PARK PLACE HOLDINGS, LLC",2,1,1
15420,3012780015,BK,1386 UNION STREET,01,A4,"LIEBERMAN, MENACHEM M",2,1,1
15421,3012910014,BK,1266 CARROLL STREET,01,B3,DARRYL DUNCAN,2,1,1
15422,3012990016,BK,432 CROWN STREET,01,A4,"TAIT, CYNTHIA",3,2,1
15423,3013000019,BK,518 CROWN STREET,01,B1,"SHOLOM Y. DEITSCH, AS TRUSTEE",2,1,1
15424,3013100053,BK,485 EMPIRE BOULEVARD,01,B9,"GARELIK, CHANA",2,1,1
15425,3014070019,BK,1572 PRESIDENT STREET,01,A5,LEVERTOV SAUL,2,1,1
15426,3014620123,BK,1674 PROSPECT PLACE,01,B2,"CAMPBELL, TREVOR",2,1,1
15427,3015210161,BK,309 SUMPTER STREET,01,B2,"ZHANG, HAN  J",2,1,1
15428,3016990047,BK,525 HERKIMER STREET,01,B3,THADDEUS RUSSELL,2,1,1
15429,3018980023,BK,823 KENT AVENUE,01,A9,"CRUZ, JISEL",2,1,1
15430,3023130022,BK,217 NORTH 8 STREET,02,C0,"NUNZIATA, JAMES",2,1,1
15431,3024640033,BK,405 BROADWAY,04,S3,BEIS JOEL OHEL FEIGEINC,2,1,1
15432,3027470003,BK,626 LORIMER STREET,02,C0,"BADAMO, ANDREW J",2,1,1
15433,3027510013,BK,18 SKILLMAN AVENUE,02,C2,"18 SKILLMAN AVE., LLC",2,1,1
15434,3031970041,BK,1135 WILLOUGHBY AVENUE,01,B2,GIOMELO LLC,2,1,1
15435,3032530016,BK,18 STOCKHOLM STREET,02,C0,18 STOCK LLC,2,1,1
15436,3033500022,BK,140 PALMETTO STREET,02,C2,DANIEL PROPERTIES NY LLC,2,1,1
15437,3033670033,BK,548 EVERGREEN AVENUE,01,B2,JESSIE JOHNSON,2,1,1
15438,3035680021,BK,255 LEGION STREET,01,B1,"HAIGLER, DEVORAH",2,1,1
15439,3037150025,BK,148 HINSDALE STREET,06,F5,148 HINSDALE LLC,2,1,1
15440,3037200004,BK,215 SHEFFIELD AVENUE,01,B2,JACQUELINE C DESHONG,2,1,1
15441,3039920028,BK,126 MILFORD STREET,01,B9,"BEATO, ANA",2,1,1
15442,3043820026,BK,920 ELTON STREET,01,B2,"WALKER, CLINTON",2,1,1
15443,3044740052,BK,221 AMBER STREET,01,B3,"WILDWOOD CONSTUCTION,",2,1,1
15444,3045530001,BK,854 WORTMAN AVENUE,08,Z3,U S POSTAL SERVICE,2,1,1
15445,3046520035,BK,306 EAST 98 STREET,02,C3,PAUL RONNEY,2,1,1
15446,3046690062,BK,404 EAST 95 STREET,02,C0,ALABA RUFAI,2,1,1
15447,3047220057,BK,973 UTICA AVENUE,01,B1,"LINDERMAN, GEORGE",2,1,1
15448,3047380045,BK,521 EAST 53 STREET,01,A5,THOMAS EGERTON JR.,2,1,1
15449,3047560051,BK,614 ROCKAWAY PARKWAY,01,B1,"TAYLOR, BARBARA",2,1,1
15450,3047820077,BK,1371 SCHENECTADY AVENUE,01,B1,"ST. AIME, EDRICE",2,1,1
15451,3048740049,BK,217 EAST 37 STREET,01,B1,"BHOLAI, AMIRAH",2,1,1
15452,3048760055,BK,205 EAST 39 STREET,01,B2,"TOOTSIE REALTY, INC",2,1,1
15453,3048780015,BK,128 EAST 42 STREET,01,B2,"MARTIN, EVANS I.",2,1,1
15454,3049380027,BK,465 EAST 38 STREET,01,B2,"ASHTON, BEVETA",2,1,1
15455,3051010026,BK,571 OCEAN AVENUE,04,D6,NORTH OCEAN MANAGEMENT LLC,2,1,1
15456,3052060001,BK,2002 DITMAS AVENUE,08,M1,PILGRIM WESLEYAN CHURCH INC,2,1,1
15457,3052220016,BK,651 EAST 22 STREET,01,A1,CLARENCE A ROBERTSON,3,2,1
15458,3053130031,BK,47 CHURCH AVENUE,07,G2,ARSLAN REALTY CORP,4,3,1
15459,3053250037,BK,252 EAST 3 STREET,01,A1,"RUBINSTEIN, NOAM J",2,1,1
15460,3053320049,BK,113 DAHILL ROAD,01,B1,"CARRRERA, AVELARDO",2,1,1
15461,3053450017,BK,1428 40 STREET,01,B1,ASHER KORENBLU,2,1,1
15462,3053720063,BK,531 EAST 3 STREET,01,B2,"WOLFSON, YITZCHOK A",2,1,1
15463,3053950025,BK,660 EAST 2 STREET,01,A1,"OESTREICHER, SHLOIME",2,1,1
15464,3054000038,BK,706 EAST 7 STREET,01,B2,"FINKELSTIEN, YITZCHAK VELUEL",2,1,1
15465,3054370031,BK,1658 46 STREET,01,B1,"1658 HOMES, LLC",2,1,1
15466,3054450052,BK,1869 48 STREET,01,B1,ARON LEFKOWITZ,2,1,1
15467,3054480041,BK,1676 48 STREET,01,B2,JEROME MUSKAL,2,1,1
15468,3054580019,BK,1532 50 STREET,01,B1,SALOMON LIPSCHUTZ,2,1,1
15469,3054890037,BK,1672 55 STREET,01,A1,"LOEWY, EDWARD",2,1,1
15470,3054960064,BK,1529 58 STREET,02,C0,"ROTH, SOLOMON",2,1,1
15471,3054980006,BK,5711 17 AVENUE,01,A9,"ENGEL, SHERMAN",2,1,1
15472,3056187501,BK,1454 45 STREET,02,R3,NAME NOT ON FILE,2,1,1
15473,3056450049,BK,5020 10 AVENUE,01,B1,"KLEINBERGER, YITTA",2,1,1
15474,3056630033,BK,1366 52 STREET,08,M1,CONGREGATION YETEV LEV 11TH AVE.,2,1,1
15475,3056740013,BK,1036 54 STREET,01,B1,"PERLMAN, JOSEPH",2,1,1
15476,3056740058,BK,1033 55 STREET,01,B1,HIRSCH RACHEL,2,1,1
15477,3056760057,BK,1243 55 STREET,08,M3,CONG CHAISEK SCHLOMO,2,1,1
15478,3056900071,BK,1213 57 STREET,02,C0,"SMILOW, MARTIN",2,1,1
15479,3057627503,BK,1429 67 STREET,02,R3,UNAVAILABLE OWNER,3,2,1
15480,3057760064,BK,1425 BAY RIDGE AVENUE,02,C0,"LUO, WEI QIANG",2,1,1
15481,3058480015,BK,122 67 STREET,01,B1,"CASSAMASSINO, MATTHEW J",2,1,1
15482,3058730063,BK,471 OVINGTON AVENUE,01,A1,"LUK, DAVID",2,1,1
15483,3060170009,BK,8303 3 AVENUE,04,S2,8303 THIRD AVENUE,2,1,1
15484,3061650035,BK,1170 70 STREET,01,B1,FOON KENNETH T,2,1,1
15485,3062180051,BK,2059 BAY RIDGE PARKWAY,01,B2,"CHEN, BI FANG",2,1,1
15486,3062400058,BK,2047 77 STREET,02,C0,"LIN, KOUK CHUN",2,1,1
15487,3062410023,BK,2138 76 STREET,01,B1,"CURTO, PIETRO",2,1,1
15488,3064110022,BK,121 BAY 26 STREET,02,C2,121 BAY 26 STREET LLC,2,1,1
15489,3064290027,BK,193 BAY 11 STREET,02,C0,"XIE, ZONG MING",2,1,1
15490,3064600243,BK,1590 INDEPENDENCE AVENUE,01,A5,"MANCINO, GLORIA",2,1,1
15491,3064850084,BK,1597 INDEPENDENCE AVENUE,01,B1,"ZHONG, XIAO XIA",3,2,1
15492,3065200021,BK,956 EAST 8 STREET,01,A1,"JEMAL, MICHAEL",2,1,1
15493,3065210067,BK,965 EAST 8 STREET,01,A3,"SAADA, PHILIP",2,1,1
15494,3065330016,BK,1134 EAST 8 STREET,01,B2,VICTOR TAWIL,2,1,1
15495,3065420021,BK,1316 EAST 7 STREET,01,B2,"RAHMEY, STEPHEN S",2,1,1
15496,3066100080,BK,1633 EAST 3 STREET,01,B2,TARANTO JOSEPH G,2,1,1
15497,3066140014,BK,1514 EAST 8 STREET,01,B1,"PANIGEL, ISAAC",2,1,1
15498,3066160011,BK,1514 EAST 10 STREET,01,B1,"MIZRAHI, SHALOM",2,1,1
15499,3066810490,BK,1925 EAST 5 STREET,01,A3,"DANA, EDWARD",2,1,1
15500,3067220036,BK,1174 EAST 12 STREET,01,A1,HERMAN MALKIE,2,1,1
15501,3067230057,BK,1179 EAST 12 STREET,01,B1,DANIEL GRAND,2,1,1
15502,3067290069,BK,1176 EAST 19 STREET,01,A3,PINCHAS FRUCHTHANDLER,2,1,1
15503,3067500072,BK,1461 EAST 12 STREET,01,A9,GINSBURG CHANIE,2,1,1
15504,3067500086,BK,1429 EAST 12 STREET,01,B2,GILBERT MELECH,2,1,1
15505,3067610050,BK,1411 AVENUE P,01,A1,"HEFFEZ, NELLY",2,1,1
15506,3067700012,BK,1516 EAST 24 STREET,08,M1,CONGREGATION BNEI AHARON,2,1,1
15507,3068690053,BK,8630 26 AVENUE,02,C0,"LAU, SAMSON",2,1,1
15508,3069100036,BK,220 BAY 43 STREET,02,C0,"LEUNG, CHI TUNG",3,2,1
15509,3070220068,BK,2849 WEST 16 STREET,01,B3,"MATHAI, MONACHAN",2,1,1
15510,3070230063,BK,2839 WEST 15 STREET,02,C3,"AMRAM, EYAL",2,1,1
15511,3070370040,BK,4598 BEACH 46 STREET,08,Y4,USPS,2,1,1
15512,3070510001,BK,2928 MERMAID AVENUE,08,W1,NYC DEPARTMENT OF EDUCATION,2,1,1
15513,3071040182,BK,2024 EAST 2 STREET,01,A3,"SITT, RALPH",2,1,1
15514,3071070071,BK,2089 EAST 4 STREET,01,A1,"FRANCO, RICHARD",2,1,1
15515,3071080028,BK,2054 OCEAN PARKWAY,01,B1,2054 OCEAN PARKWAY LLC,2,1,1
15516,3071080061,BK,2127 EAST 5 STREET,01,B2,"DWECK, RALPH I",2,1,1
15517,3071300057,BK,2215 EAST 3 STREET,01,B1,"SCHEMO, JUDAH",2,1,1
15518,3071830008,BK,620 AVENUE W,01,A7,"SHAMMA, JOSEPH",2,1,1
15519,3071980028,BK,2474 EAST 3 STREET,01,B3,"SILVER, SHIMON",2,1,1
15520,3072000014,BK,450 AVENUE X,01,B2,"SAKAL, IEZAK",2,1,1
15521,3072910104,BK,1946 EAST 13 STREET,01,A1,"YAZDI, FARADJ",2,1,1
15522,3072910142,BK,1963 HOMECREST AVENUE,01,A1,"SALMAN, SIGAL",2,1,1
15523,3073530055,BK,2595 OCEAN AVENUE,01,B2,"WU, BIXIAN",2,1,1
15524,3074180060,BK,2455 EAST 16 STREET,01,A9,MARGIE GOMEZ AS TRUSTEE,3,2,1
15525,3075870054,BK,920 EAST 24 STREET,01,A1,ROBERT LOEWY,2,1,1
15526,3075900031,BK,933 EAST 26 STREET,01,B2,BOTKNECHT HESHY,2,1,1
15527,3076050038,BK,1015 EAST 23 STREET,01,A1,"HOFFMAN , ABRAHAM  J",2,1,1
15528,3076240076,BK,3294 BEDFORD AVENUE,01,B2,CHIRAZI 2014 IRREVOCABLE TRUST,2,1,1
15529,3076560004,BK,1500 EAST 21 STREET,01,A3,"DALEZMAN, MICHAEL",2,1,1
15530,3076590079,BK,1376 EAST 24 STREET,01,A1,KNOBEL JEFFREY,2,1,1
15531,3076610070,BK,1368 EAST 26 STREET,01,A1,"WEISER, MICHAEL",2,1,1
15532,3076790057,BK,1414 EAST 26 STREET,01,A1,"BERKOWITZ, ANDREW",2,1,1
15533,3077150060,BK,1740 EAST 33 STREET,01,A5,"THURM, SAMUEL",2,1,1
15534,3077180033,BK,1725 EAST 35 STREET,01,A9,"SANTIAGO, EVELYN",2,1,1
15535,3077320017,BK,1137 EAST 48 STREET,01,A9,NURSE YOLANDA,2,1,1
15536,3077720069,BK,1786 SCHENECTADY AVENUE,01,A1,RAYMONDE NOEL,2,1,1
15537,3077910056,BK,1870 TROY AVENUE,01,B2,"HAMILTON, MARY",2,1,1
15538,3078420031,BK,4408 FLATLANDS AVENUE,01,A1,"SALVACRUZ, NOBLETO",2,1,1
15539,3078780069,BK,1536 EAST 54 STREET,01,A9,"BOONE, SHEENA",2,1,1
15540,3078800075,BK,1454 EAST 56 STREET,01,A9,"BOCCHINO, MICHAEL",2,1,1
15541,3079020017,BK,1465 EAST 57 STREET,01,A9,"CALIXTE, STANLEY JR",2,1,1
15542,3079880063,BK,650 EAST 84 STREET,02,C0,"JULMICE , GIRAUD",2,1,1
15543,3079940008,BK,8905 GLENWOOD ROAD,04,K4,"WALLACE, DEAN",2,1,1
15544,3081710005,BK,10211 GLENWOOD ROAD,04,S2,MATT & JOY REALTY LLC,2,1,1
15545,3081710006,BK,10209 GLENWOOD ROAD,01,B3,"ROMAIN, JOY",2,1,1
15546,3081810051,BK,87 CONKLIN AVENUE,02,C0,GAM 87-89 CONKLIN LLC,5,4,1
15547,3083800002,BK,5817 AVENUE T,05,K2,BASIN REALTY LLC,2,1,1
15548,3084080011,BK,1514 EAST 66 STREET,01,A9,"KENIGSBERG, AARON",2,1,1
15549,3085240002,BK,3821 AVENUE T,01,A5,CHARLES SEIDEMAN,2,1,1
15550,4000260004,QN,45-40 VERNON BOULEVARD,06,F1,"CSC 4540 PROPERTY CO, LLC",4,3,1
15551,4005520027,QN,21-28 31 AVENUE,02,C2,31 AVE,2,1,1
15552,4006360030,QN,36-10 36 AVENUE,01,B3,SOFIA KAMMAS,2,1,1
15553,4006530090,QN,25-78 38 STREET,03,D1,"33-06 REALTY, LLC",2,1,1
15554,4007737501,QN,45-03 20 ROAD,02,R6,UNAVAILABLE OWNER,2,1,1
15555,4008200107,QN,23-79 35 STREET,01,B3,MAUREEN MCMANUS LIVING TRUST,2,1,1
15556,4008710020,QN,20-44 CRESCENT STREET,02,C9,CENTAL ASTORIA,7,6,1
15557,4010860016,QN,23-14 93 STREET,01,B1,"CALLE, CLAUDIO F",2,1,1
15558,4011600027,QN,32-34 60 STREET,02,C0,"ZOU, ZHENG WEI",2,1,1
15559,4012580019,QN,34-30 72 STREET,01,B3,HENG FA ASSOCIATES LLC,2,1,1
15560,4012820130,QN,70-52 BROADWAY,01,B1,IMPRESS TELEFILM INC,2,1,1
15561,4012950001,QN,39-61 63 STREET,01,B2,"PARK, JOHN YOUN YOUNG",2,1,1
15562,4013550036,QN,44-12 74 STREET,02,C0,VINCENT QUAN,2,1,1
15563,4013730038,QN,25-62 100 STREET,01,A5,JOSE N. MERCHAN,2,1,1
15564,4016410001,QN,102-05 DITMARS BOULEVARD,05,H3,KAR HOTEL OWNER LLC,2,1,1
15565,4017120007,QN,97-14 NORTHERN BOULEVARD,04,S2,GA WAH LLC,2,1,1
15566,4017240034,QN,109-15 34 AVENUE,01,B3,VICTOR PRADO,3,2,1
15567,4017770001,QN,37-05 108 STREET,05,K1,"RODRIQUEZ, ELOISA C",3,2,1
15568,4017830007,QN,38-11 111 STREET,02,C2,1908 BAY RIDGE REALTY LLC,2,1,1
15569,4019400023,QN,52-08 103 STREET,01,B1,"HU, XIAO QIONG",2,1,1
15570,4019940012,QN,50-02 108 STREET,04,S3,"FEDERICI, ANTHONY",2,1,1
15571,4020100001,QN,109-18 54 AVENUE,08,M1,CONG INDEPENDENT CHEV,3,2,1
15572,4021080049,QN,99-35 62 DRIVE,01,A1,KHAIMOVA ADINO,2,1,1
15573,4023800022,QN,54-23 65 PLACE,01,A1,"AVILA, MARIA C",2,1,1
15574,4023890001,QN,65 PLACE,02,C0,GOLDEN WINNER LLC,2,1,1
15575,4024560010,QN,51-39 69 STREET,04,S3,"AGNESINI, GARY",2,1,1
15576,4026450014,QN,61-63 55 STREET,01,B2,JORGE CALDERON,2,1,1
15577,4026570060,QN,59-41 MAURICE AVENUE,06,E1,"LEE, ALEX",2,1,1
15578,4026700048,QN,57-51 57 ROAD,01,A1,"57-51 57TH ROAD, LLC",2,1,1
15579,4026760047,QN,57-58 58 PLACE,01,B2,"MONROE, KATHLEEN",2,1,1
15580,4026940073,QN,59-59 GRAND AVENUE,01,A1,"CAICEDO, NATASHA",2,1,1
15581,4027410046,QN,60-71 59 DRIVE,01,A2,ZHI JUN WANG,2,1,1
15582,4027690051,QN,62-07 62 ROAD,01,B2,"CIOLEK, MAREK",2,1,1
15583,4027790075,QN,68-03 60 AVENUE,01,A5,MICHAEL J. VASTARELLI,2,1,1
15584,4028280037,QN,59-01 69 STREET,05,O7,DELLACORTE REAL ESTATE LLC,3,2,1
15585,4029000007,QN,84-14 60 ROAD,02,C0,"CHAU, KIM PHUNG",2,1,1
15586,4030320098,QN,72-01 66 ROAD,01,B2,CIRO LABARBERA,2,1,1
15587,4030410017,QN,65-27 79 STREET,01,B2,"LIN, XIAO MING",2,1,1
15588,4030700017,QN,66-43 79 PLACE,01,B3,"MOLONEY, BRIAN",2,1,1
15589,4033170015,QN,80-49 PARK LANE,01,A3,"CHOUDRI, QAISER",2,1,1
15590,4033380070,QN,84-03 CUTHBERT ROAD,03,D3,"FANT ORGANIZATION,    .",2,1,1
15591,4034270056,QN,18-11 HIMROD STREET,01,A2,"VELASQUEZ, JOSE E",2,1,1
15592,4034360034,QN,508 SENECA AVENUE,02,C1,SENECA AVENUE REALTY LLC,2,1,1
15593,4034960037,QN,64-16 60 PLACE,10,G0,"NADIR, ABDELGHAFER",2,1,1
15594,4035490102,QN,16-11 WEIRFIELD STREET,06,F9,MAIALE JOSEPH,3,2,1
15595,4035590019,QN,57-35 COOPER AVENUE,01,B3,"COLON, CARLOS B",2,1,1
15596,4037700030,QN,67-12 75 STREET,01,B1,"S   TIS, SOTIRIOS",2,1,1
15597,4037890086,QN,69-00 78 STREET,01,B3,"KEHOE , DONNA M",2,1,1
15598,4038170007,QN,77-27 79 PLACE,01,B3,"WERTHMULLER, THOMAS A",2,1,1
15599,4040180028,QN,137-15 14 AVENUE,01,A1,"BAJRAMI, BESNIK",2,1,1
15600,4040520021,QN,14-14 118 STREET,01,B2,"KOUMIS, ELIAS",2,1,1
15601,4044520050,QN,145-59 5 AVENUE,01,A1,"FILIPOS, TEDDY",2,1,1
15602,4046570016,QN,147-11 23 AVENUE,02,C0,"HIGGGINS, THOMAS",3,2,1
15603,4046600016,QN,149-16 14 AVENUE,04,S3,NJH PROPERTIES II LLC,2,1,1
15604,4049770023,QN,137-10 NORTHERN BOULEVARD,05,O5,CIAMPA REALTY II LLC,2,1,1
15605,4050550007,QN,149-13 SANFORD AVENUE,02,C0,"KWOK, HI MING",2,1,1
15606,4051020059,QN,132-15 POPLE AVENUE,01,B1,"HO, MEEMEE",2,1,1
15607,4051780055,QN,152-20 PECK AVENUE,01,B1,"CHEN, WAI YUEN",2,1,1
15608,4052100041,QN,46-27 ROBINSON STREET,01,A1,MARY C. BREE 2013 IRREVOCABLE TRUST,2,1,1
15609,4053580016,QN,40-26 194 STREET,02,C0,"WANG, QIN FU",2,1,1
15610,4054260078,QN,43-78 169 STREET,01,A3,"SHAN, TIANCHENG",2,1,1
15611,4054400063,QN,45-46 162 STREET,04,S3,GOOD FIELD REALTY LLC,2,1,1
15612,4055550042,QN,46-27 197 STREET,01,B9,KARAMOUZIS SOTIRIOS,2,1,1
15613,4058070052,QN,23-63 207 STREET,01,A0,SUPPLEMENTAL NEEDS TRUST FBO JEFFREY BRO SI,2,1,1
15614,4058650135,QN,16-36 BELL BOULEVARD,02,C0,"DROSINOS, MARIA",2,1,1
15615,4059770011,QN,26-41 202 STREET,01,A2,V TESTANI,2,1,1
15616,4060080095,QN,217-14 24 AVENUE,09,Q9,A REAL YYZ L.P.,2,1,1
15617,4060750017,QN,33-24 200 STREET,01,A5,BLIEKA  EDWARD P,2,1,1
15618,4061560031,QN,207-09 36 AVENUE,01,A1,"ISAAKIDIS, EVDOXIA",2,1,1
15619,4062400010,QN,38-19 214 PLACE,01,B3,"CHEN, XIU ZHEN",2,1,1
15620,4063150131,QN,41-25 218 STREET,01,B2,"TUFFY, MICHAEL  A",2,1,1
15621,4063770011,QN,138-12 58 AVENUE,01,B1,"SING MAN CHAN, AS TRUSTEE OF THE SUPPLEM ENTAL",2,1,1
15622,4070250009,QN,164-46 81 AVENUE,01,A1,"CHACKO, INDIRA",2,1,1
15623,4071920056,QN,75-65 179 STREET,01,A1,"ISKHAKOV, YAKOB",2,1,1
15624,4072780040,QN,82-41 189 STREET,01,A1,"SUFRIN , MICHELLE",2,1,1
15625,4080990124,QN,42-30 235 STREET,08,P2,AMERICAN LEGION POST 103 LITTLE    NECK  DOUGLAS,2,1,1
15626,4082460067,QN,54-31 BROWVALE LANE,01,A2,"JENG, DYLAN",2,1,1
15627,4082510009,QN,252-50 BRATTLE AVENUE,01,A1,PANTELATOS NICHOLAS,2,1,1
15628,4082730007,QN,25518 UPLAND ROAD,01,A1,"LAU, MAN-KEUNG",2,1,1
15629,4082740135,QN,260-01 HORACE HARDING EXPRE,07,G4,"BSM MANAGEMENT, LLC.",2,1,1
15630,4083060086,QN,245-84 63 AVENUE,01,B3,HARRY KALOGIANNIS,2,1,1
15631,4083510001,QN,58-54 256 STREET,01,B3,JEROME LEVINE,2,1,1
15632,4086490016,QN,87-60 254 STREET,01,A1,"MENDOZA, EDWIN",2,1,1
15633,4087880024,QN,84-36 259 STREET,01,A0,"SMITH, NICHOLAS",2,1,1
15634,4088870026,QN,85-46 96 STREET,01,A1,"RODRIGUEZ, GISELE",2,1,1
15635,4089640018,QN,80-52 90 AVENUE,01,B3,"DEOPERSAUD, GANESH",2,1,1
15636,4089740023,QN,89-26 WOODHAVEN BOULEVARD,01,B3,"MONTES, GIRLIE",2,1,1
15637,4090380055,QN,94-31 95 STREET,01,A1,"RANGEL, ADA M",2,1,1
15638,4092350029,QN,84-48 120 STREET,01,A1,KALMAN EPSTEIN,2,1,1
15639,4092480042,QN,84-76 127 STREET,07,U9,NYC DEPARTMENT OF ENVIRONMENTAL PROTECTION,2,1,1
15640,4092880041,QN,86-89 102 STREET,01,B3,"OSORIO, WILMARK",2,1,1
15641,4093630008,QN,89-40 135 STREET,08,I6,"JAMAICA HOSPITAL NURSING HOME COMPANY, I NC.",2,1,1
15642,4093930037,QN,94-17 109 STREET,01,B2,"GOMES, MABEL",2,1,1
15643,4094090011,QN,97-12 108 STREET,10,G0,"RAGHUBIR, DENNIS",3,2,1
15644,4094470054,QN,94-15 131 STREET,01,A1,"LOAKNAUTH, GANESH",2,1,1
15645,4094820039,QN,134-15 97 AVENUE,01,B3,MAUREEN LATCHMAN,3,2,1
15646,4094860013,QN,101-20 LEFFERTS BOULEVARD,05,O7,IBRAHIM & GEORGES MEMORIAL REALTY CORP,2,1,1
15647,4095060068,QN,103-33 102 STREET,01,B2,"BHAGROO, KAMLA",2,1,1
15648,4095070062,QN,103-39 103 STREET,01,B2,"BALKISSOON, NAJENDRA",2,1,1
15649,4095450001,QN,107-02 107 AVENUE,01,B3,"DEENA, DINDIAL",3,2,1
15650,4095670039,QN,103-06 131 STREET,08,M1,RICHMOND HILL/CON/JEW/WI,2,1,1
15651,4095670053,QN,103-13 130 STREET,01,B3,"PERSAUD, NARINDRA",2,1,1
15652,4097530006,QN,90-23 153 STREET,01,B2,GLADYS ZAVALA,2,1,1
15653,4098280001,QN,172-41 90 AVENUE,02,C0,A & U ESTATE CORP.,2,1,1
15654,4099520021,QN,85-19 AVON STREET,01,A1,"STEFANAKIS, NIKI MARATOS",2,1,1
15655,4099560079,QN,86-29 ETON STREET,01,A1,ALBERT PILLAY,2,1,1
15656,4100120020,QN,139-15 101 AVENUE,04,S3,139-15 101 LLC,2,1,1
15657,4100430020,QN,144-27 105 AVENUE,02,C0,"PAGUAY, LUIS H",2,1,1
15658,4100700149,QN,142-13 109 AVENUE,01,B3,"ORTIZ, JAMIE",2,1,1
15659,4102160022,QN,176-15 93 AVENUE,01,A5,GERALDINE E GREENE,2,1,1
15660,4102260089,QN,104-23 169 STREET,01,B2,AMERICAN DREAM BUILDERS CORP,2,1,1
15661,4102330229,QN,173-37 104 AVENUE,01,A1,JOBITY PAMELA,2,1,1
15662,4102380024,QN,169-02 105 AVENUE,01,A1,LEONARD MARTAIN,2,1,1
15663,4102520069,QN,106-18 RUSCOE STREET,01,B1,"MIHA, MD RAFIQUIL ISLAM",2,1,1
15664,4102930011,QN,111-12 177 STREET,01,B3,"MORALES, GUILLERMO A",2,1,1
15665,4103710022,QN,104-20 186 STREET,01,B3,"IDIERU-JIYO, REBECCA",2,1,1
15666,4104000022,QN,188-16 QUENCER ROAD,01,A1,"AUGUSTINE, MARCEL",2,1,1
15667,4104280012,QN,188-26 KEESEVILLE AVENUE,01,B3,"BURRELL, MICHAEL",2,1,1
15668,4104430019,QN,188-09 JAMAICA AVENUE,04,S2,"MUNNA, JAIPRAKASH",2,1,1
15669,4105740044,QN,89-14 210 STREET,01,B3,"CRUZ-GONZALEZ, EVELYN",2,1,1
15670,4106310001,QN,92-02 215 PLACE,01,A1,AHMAD R SHAFFEE,2,1,1
15671,4106700046,QN,88-10 213 STREET,01,A1,"BALQUIN, LUIS A",2,1,1
15672,4107100043,QN,91-11 218 PLACE,01,B3,NONATO R. SALUD,2,1,1
15673,4108620012,QN,100-27 195 STREET,02,C0,"WILLIAMS, CHERYL",2,1,1
15674,4109090033,QN,104-47 205 PLACE,01,B3,"RAHMAN, KHANDAKER M",2,1,1
15675,4110530059,QN,210-25 NASHVILLE BOULEVARD,01,B1,"MOHAMED, SAADIA",2,1,1
15676,4110680080,QN,116-27 196 STREET,01,A2,"BRANCH, JOSEPH JR.",2,1,1
15677,4110990027,QN,104-23 214 STREET,01,A1,"TOUSSIANT, ANNOLIO",2,1,1
15678,4111380047,QN,213-24 112 AVENUE,01,B3,"LEWIS, DAVON J",2,1,1
15679,4111900044,QN,223-11 109 AVENUE,01,A1,"BROWN, ERICK",2,1,1
15680,4112240014,QN,225-17 112 ROAD,01,A1,FUENTES JOHNNY,2,1,1
15681,4112350049,QN,219-36 MURDOCK AVENUE,01,A5,HORTENSIA D ROSA,2,1,1
15682,4112360041,QN,219-17 114 AVENUE,01,A1,MARVA BREWSTER,2,1,1
15683,4113140019,QN,115-84 233 STREET,01,A1,BEVERLY BETHUNE,2,1,1
15684,4116510016,QN,114-18 125 STREET,01,A1,WILFRED JOHN,2,1,1
15685,4116810025,QN,125-15 ROCKAWAY BOULEVARD,05,GW,ROCKAWAY BOULEVARD REALTY LLC,2,1,1
15686,4117860001,QN,127-19 135 AVENUE,08,M1,THE ROMAN CATHOLIC CHURCH OF ST. ANTHONY  OF PADUA,2,1,1
15687,4117890016,QN,133-33 130 STREET,01,A0,S MONACO,2,1,1
15688,4117900011,QN,133-31 130 PLACE,01,B1,"NEMORIN, HENRY C.",2,1,1
15689,4119900054,QN,145-38 115 AVENUE,01,A1,"STELZ, BIBI",2,1,1
15690,4120140075,QN,117-48 142 PLACE,01,A1,G LEAPER,2,1,1
15691,4120140079,QN,117-54 142 PLACE,01,A1,"SIMMS, BRENDA M",2,1,1
15692,4120270050,QN,119-02 147 STREET,01,A1,W FOSTER,2,1,1
15693,4120380035,QN,142-54 122 AVENUE,01,A1,"142ND TOLIN, LLC",2,1,1
15694,4120500250,QN,123-27 146 STREET,01,B3,ROBINSON VERA,2,1,1
15695,4120580214,QN,140-11 130 AVENUE,01,B2,"LEON, NORMAN",2,1,1
15696,4120750126,QN,131-26 140 STREET,01,A1,LITTON MTG SERV CNTINC,2,1,1
15697,4121810017,QN,160-18 111 AVENUE,01,B3,"MARTE, MARGARITA R",2,1,1
15698,4122120022,QN,150-34 120 AVENUE,01,A2,"DASENT-VERSAILLES, KADIR",2,1,1
15699,4122760078,QN,161-25 130 AVENUE,01,B3,"STANLEY, SEEDAT",2,1,1
15700,4123890070,QN,120-14 MERRILL STREET,01,B3,VILLAGE PLAZA HOMES INC.,2,1,1
15701,4124580421,QN,187-04 120 AVENUE,02,C9,HP MONTAUK APARTMENTS HOUSING DEVELOPMEN T FUND COM,27,26,1
15702,4124620019,QN,178-14 BAISLEY BOULEVARD,01,B3,NYC HOUSING AUTHORITY,2,1,1
15703,4124860144,QN,178-11 SELOVER ROAD,10,G0,"PATEL, NARENDRA",2,1,1
15704,4125770034,QN,137-48 172 STREET,01,A0,"GREENE, LAVERN C",2,1,1
15705,4125970101,QN,169-10 144 AVENUE,01,A2,"NELSON, JEAN",2,1,1
15706,4126350035,QN,205-03 118 AVENUE,01,A5,"MORRIS, JACQUELINE",2,1,1
15707,4127300007,QN,193-10 NASHVILLE BOULEVARD,01,A1,"OGARRO, BETTY SIFFORD",2,1,1
15708,4130420118,QN,184-40 EDGEWOOD AVENUE,01,A1,"WILLIAMS, CHRISTINEA",2,1,1
15709,4132240007,QN,243-07 136 AVENUE,01,A1,"FAJARDO, JYNO F",3,2,1
15710,4133410034,QN,145-77 FARMERS BOULEVARD,04,S1,14577 PRABHOO PROPERTY INC,2,1,1
15711,4134360076,QN,147-34 224 STREET,01,B2,DELIGHT HOLDING LLC,2,1,1
15712,4134990026,QN,144-20 230 STREET,01,A2,BLACKSHEAR JAMES,2,1,1
15713,4136130016,QN,139-21 246 STREET,01,A1,"MARIKO, MAMADOU",2,1,1
15714,4136270060,QN,142-37 HOOK CREEK BOULEVARD,01,B3,HOOK CREEK GARDENS LLC,2,1,1
15715,4136560044,QN,149-42 WELLER LANE,01,B2,"PIERRE-FLERIDOR, SAINTE  A",2,1,1
15716,4153130035,QN,41 WEST 10 ROAD,01,B2,FRANCAVILLA MARY K,2,1,1
15717,4154790016,QN,14-14 CROSS BAY BOULEVARD,01,A2,"BARR, MICHAEL",2,1,1
15718,4155710088,QN,7-36 MADOR COURT,01,A1,"BRESSLER, BARRY",2,1,1
15719,4159150033,QN,3-20 BEACH 68 STREET,01,B2,SANCHEZ JAIME,2,1,1
15720,4160250007,QN,65-31 BAYFIELD AVENUE,01,A2,CASTRO  MARIAH,2,1,1
15721,4161120001,QN,245 BEACH CHANNEL DRIVE,08,W1,NYC DEPARTMENT OF PARKS AND RECREATION,2,1,1
15722,4161210004,QN,210 BEACH 88 STREET,06,E7,KEN MAR INDUSTRIES INC,2,1,1
15723,4161510018,QN,305 BEACH 95 STREET,06,E9,"MADELAINE CHOCOLATENOVELTIES, INC",3,2,1
15724,4162380071,QN,138 BEACH 129 STREET,01,B2,"WAITZMAN, RONALD",2,1,1
15725,4162770029,QN,157 BEACH 132 STREET,01,B3,"MARTINO, VICTOR J",2,1,1
15726,4162780008,QN,133-03 ROCKAWAY BEACH BLVD,01,B1,"SUTERA , KIM",2,1,1
15727,5000170027,SI,73 MONROE AVENUE,02,C3,MARYANN RICCA,2,1,1
15728,5000340001,SI,100 BROOK STREET,07,Y6,NYC DEPARTMENT OF SANITATION,2,1,1
15729,5000640072,SI,23 CORTELYOU PLACE,01,A1,NYS MENTAL RETARDATIO,2,1,1
15730,5000720043,SI,72 CLINTON AVENUE,02,C0,LIBRIZZI LEONARD,2,1,1
15731,5000780220,SI,181 BARD AVENUE,01,A1,F W CAMOIA,2,1,1
15732,5001140083,SI,49 OXFORD PLACE,01,B2,"ROSS, RONALD D",2,1,1
15733,5001790074,SI,423 CARY AVENUE,01,B2,"NONON, ALINE",2,1,1
15734,5002000010,SI,89 BODINE STREET,01,B2,"LOPEZ, MARIO MORENO",2,1,1
15735,5002190094,SI,197 MYRTLE AVENUE,01,A1,NIGRO GINO,2,1,1
15736,5002220015,SI,329 TAYLOR STREET,01,A1,"VALENTE, BARBARA",2,1,1
15737,5002860090,SI,15 JONES PLACE,01,A1,"BERGIN, KATIE E",2,1,1
15738,5003320148,SI,1 FAIRVIEW AVENUE,01,A1,"LACH, MARY ANN J",2,1,1
15739,5003540085,SI,28 MUNDY AVENUE,01,B3,EDWARD H ENGELSON,2,1,1
15740,5003640002,SI,192 COLLEGE AVENUE,01,A1,"CUSMANO, JOHN",2,1,1
15741,5004080005,SI,143 DICKIE AVENUE,01,B2,ANNETTE SPOTO,2,1,1
15742,5004110001,SI,181 LATHROP AVENUE,01,A1,"TROIANO, WILLIAM  A",2,1,1
15743,5004340024,SI,262 CLINTON B FISK AVE,01,A1,"BACH, KENNETH T",3,2,1
15744,5004580078,SI,64 WATCHOGUE ROAD,01,A1,CHARLES DALTON,2,1,1
15745,5005360006,SI,463 VAN DUZER STREET,01,A1,JOSEPH CARROLL,2,1,1
15746,5005360068,SI,23 TARGEE STREET,01,A1,JANET DALBERO,2,1,1
15747,5005820020,SI,36 MARION AVENUE,01,A1,CASTANGNA RICHARD,2,1,1
15748,5007220018,SI,12 QUINLAN AVENUE,01,A5,ABDELAZIZ DESOOKY,2,1,1
15749,5007620018,SI,188 CLERMONT PLACE,01,A0,"GONZALEZ- LAZO, HECTOR",2,1,1
15750,5007800056,SI,263 KELL AVENUE,01,A5,STEVEN KLEIN,2,1,1
15751,5008800007,SI,16 BUTTONWOOD ROAD,01,A3,"RUSI, VIDIOLA",2,1,1
15752,5009480046,SI,81 BEACON AVENUE,01,B3,"SITARAS, NIKOLAOS P",2,1,1
15753,5010170015,SI,68 NEW STREET,01,B9,"CAVALIERI, VINCENZO",2,1,1
15754,5010270061,SI,74 SIMONSON PLACE,01,A1,74 SIMONSON PLACE LLC,2,1,1
15755,5010370032,SI,70 ALBION PLACE,01,B2,THE HOME FACTORY LLC,2,1,1
15756,5010420093,SI,406 JEWETT AVENUE,01,A1,"NEW YORK PENTECOSTAL ASSEMBLY, STATEN IS LAND",3,2,1
15757,5010500058,SI,31 CORNELL STREET,01,B2,MASMO PROPERTIES INC.,2,1,1
15758,5010960040,SI,160 TREADWELL AVENUE,01,B2,GEORGE ANTOINE,3,2,1
15759,5011600109,SI,92 LAKE AVENUE,01,A5,CRYSTAL CRUZ,2,1,1
15760,5011700038,SI,273 GRANITE AVENUE,01,A1,"ALVARADO, HECTOR A",3,2,1
15761,5011760068,SI,374 WALKER STREET,01,A5,"IRIZARRY, DAVID M",2,1,1
15762,5012770201,SI,14 MACORMAC PLACE,01,A2,ROBERT DUDLEY,2,1,1
15763,5013180133,SI,92 HOLLAND AVENUE,01,A2,92 HOLLAND AVE HOLDING CORP.,3,2,1
15764,5014980015,SI,1303 RICHMOND AVENUE,05,O7,LIN DR. CHANG CHYI,2,1,1
15765,5015080100,SI,32 TREMONT AVENUE,01,A2,"MARIANO, GUISEPPE",2,1,1
15766,5015220074,SI,248 HAWTHORNE AVENUE,01,A1,"CHEN, QIU HUA",2,1,1
15767,5022480057,SI,81 ST GEORGE ROAD,01,A1,ROBERT GALIFI,2,1,1
15768,5023060124,SI,83 MEISNER AVENUE,01,A1,DR HAROLD EICHLER,2,1,1
15769,5026370042,SI,21 ALBERTA AVENUE,02,C3,"ANZALONE, RUDY",2,1,1
15770,5028200095,SI,1 EDGEWATER STREET,05,O3,ONE EDGEWATER EQUITIES LLC,2,1,1
15771,5028250008,SI,1071 BAY STREET,05,K1,1071 BAY STREET LLC,2,1,1
15772,5028440001,SI,409 TOMPKINS AVENUE,04,S4,"DAM  REALTY HOLDING, LLC",4,3,1
15773,5028460205,SI,34 ORMOND PLACE,01,B2,"TENEMPAGUAY, ANGEL",2,1,1
15774,5029670027,SI,213 ST MARYS AVENUE,01,B3,"DOLAN, HELENA MARCONDES",2,1,1
15775,5030020013,SI,184 BELAIR ROAD,01,B2,CONSTANCE LABETTI,2,1,1
15776,5030020052,SI,43 BEETHOVEN STREET,01,A1,INDEPENDENT LIVING ASSOC INC,2,1,1
15777,5030710108,SI,28 SUMMER STREET,01,A5,JOSEPH CARFI,2,1,1
15778,5030870100,SI,35 LANDIS AVENUE,01,B2,SCOTT HERKERT,2,1,1
15779,5031040030,SI,76 MAJOR AVENUE,01,A2,"KHABBAZ, JOSEPH",2,1,1
15780,5031210211,SI,11 FATHER CAPODANNO BL,01,A5,"LIN, LIHUA",2,1,1
15781,5032250046,SI,2187 CLOVE ROAD,01,A1,"CHAN, RONALD C",2,1,1
15782,5032970052,SI,101 DELAWARE AVENUE,01,A1,JAMES BESIGNANO,2,1,1
15783,5033400009,SI,126 HENRY PLACE,01,A1,LEONARD INGRAVALLO,3,2,1
15784,5035860037,SI,164 BEDFORD AVENUE,01,A1,"BECK, CHRISTOPHER",2,1,1
15785,5035960029,SI,42 GREELEY AVENUE,01,A3,"OTTERBECK, MICHAEL",2,1,1
15786,5036030044,SI,128 LINCOLN AVENUE,05,K1,ANGELO REONEGRO,2,1,1
15787,5036170041,SI,246 BANCROFT AVENUE,01,A2,"CONSTANTIN, STEVEN P",2,1,1
15788,5036230007,SI,102 OTIS AVENUE,01,B3,"SUN, CHENG JUN",2,1,1
15789,5036560006,SI,1854 HYLAN BOULEVARD,05,K5,"1854 HYLAND , LLC.",2,1,1
15790,5037060050,SI,451 NAUGHTON AVENUE,01,B2,"VERRENGIA, LORETTA",2,1,1
15791,5040580076,SI,272 WEED AVENUE,01,B2,"CEKOVIC, ISUF M",2,1,1
15792,5040760022,SI,6 ROMA AVENUE,01,A1,"KOERBER, PATRICK",2,1,1
15793,5042910036,SI,55 WHITEHALL STREET,01,A3,"FANIZZA, ANTHONY",2,1,1
15794,5046590031,SI,84 ACORN STREET,01,A1,RICHARD A CANINO,2,1,1
15795,5054500022,SI,496 ARTHUR KILL ROAD,07,G4,MILL & JAY REALTY LLC,2,1,1
15796,5055110001,SI,68 ELTINGVILLE BLVD,01,A1,"KHURSHUDYAN, MILADA",2,1,1
15797,5060170986,SI,124 ROLLING HILL GREEN,09,Q3,ROLLING ESTATES HOMEOWNERS ASSOC,2,1,1
15798,5062280031,SI,144 EDGEGROVE AVENUE,01,A1,VINCENT FALCONE,2,1,1
15799,5062390019,SI,676 WOODROW ROAD,01,A1,"VINCENT ROCCANOVA, JR",2,1,1
15800,5063210011,SI,11 ALVINE AVENUE,01,A1,"UNGER, NANCY E",2,1,1
15801,5065520036,SI,228 ARBUTUS AVENUE,01,A1,"228 ARBUTUS REALTY, LLC",2,1,1
15802,5069060039,SI,321 FOSTER ROAD,01,A1,ANTHONY BURNS,2,1,1
15803,5070400279,SI,15 MILLENNIUM LOOP,01,A5,"SPARACINO, JACK S.",2,1,1
15804,5075840099,SI,110 SOUTH BRIDGE STREET,05,H4,100-110 SOUTH BRIDGE LLC,3,2,1
15805,5076640356,SI,6458 AMBOY ROAD,01,A1,"ZIOGAS, ALLISON PAIGE",2,1,1
15806,5078840055,SI,401 BRIGHTON STREET,01,A1,"FOGELSTROM, DAVID",2,1,1
15807,5078890013,SI,422 SLEIGHT AVENUE,01,B2,SALERNO GARY,2,1,1
15808,5080200069,SI,119 BARNARD AVENUE,01,A1,"SMALL, JOSEPH M",3,2,1
15809,5080240001,SI,183 YETMAN AVENUE,01,A1,"ALBENESA, ANNMARIE",2,1,1
15810,5080440019,SI,251 LEE AVENUE,01,A1,GARY GRANDSTAFF,2,1,1
15811,1002750003,MN,72 HENRY STREET,07,T9,NYC DEPARTMENT OF SANITATION,3,2,1
15812,1003540034,MN,126 RIVINGTON STREET,04,C7,"NICHOLAS T. DONOVAN, TRUSTEE",2,1,1
15813,1007310043,MN,419 9 AVENUE,04,S3,419 NINTH AVENUE LLC,2,1,1
15814,1008020036,MN,777 AVENUE OF THE AMER,04,D6,777 SIXTH AVENUE OWNER LLC,2,1,1
15815,1008180027,MN,11 WEST 16 STREET,08,P9,"CENTER FOR JEWISH HISTORY, INC.",3,2,1
15816,1008300008,MN,53 WEST 28 STREET,04,K4,"51-55 W 28TH STREET, LLC",2,1,1
15817,1008320049,MN,4 WEST 31 STREET,05,H3,WOLCOTT HOTEL CO,2,1,1
15818,1009980050,MN,134 WEST 46 STREET,04,S5,WEST 46TH STREET PARTNERS LLC,2,1,1
15819,1015450025,MN,1581 1 AVENUE,04,S4,"M & W FRITSCH,    .",2,1,1
15820,1019400061,MN,2526 8 AVENUE,04,C7,276 WEST 135 ST ASSOC LP,4,3,1
15821,1021390001,MN,161 FT WASHINGTON AVENUE,08,I1,PRESBYTERIAN HSP CITY NY,2,1,1
15822,1022150411,MN,9 FT CHARLES PLACE,01,A1,"HIDALGO, LEANDRO",2,1,1
15823,2025220039,BX,1311 PLIMPTON AVENUE,01,B1,TELPHA DANNY A,2,1,1
15824,2025990128,BX,863 EAST 141 STREET,06,E7,327 REALTY LLC,3,2,1
15825,2029330008,BX,1324 FRANKLIN AVENUE,11,V0,1318-1324 FRANKLIN LIMITED PARTNERSHIP,2,1,1
15826,2032720001,BX,2600 SOUTHERN BOULEVARD,09,Q1,NYC DEPARTMENT OF PARKS AND RECREATION,26,25,1
15827,2033090084,BX,279 EAST 203 STREET,03,D9,"279 E. 203 ST.,    .",2,1,1
15828,2033230055,BX,3276 JEROME AVENUE,07,G4,MOSHOLU PETROL REALTY LLC,2,1,1
15829,2033320007,BX,3040 HULL AVENUE,02,C1,3040 REALTY CORP,2,1,1
15830,2033480025,BX,3344 PERRY AVENUE,01,A1,MARIANO NEWMAN,2,1,1
15831,2034540039,BX,262 UNDERHILL AVENUE,01,A9,AZE MATH,2,1,1
15832,2036900044,BX,2251 LAFAYETTE AVENUE,01,A1,"RODRIGUEZ, MARK",2,1,1
15833,2037360073,BX,1121 COLGATE AVENUE,02,C2,J.A.N.N. INC.,2,1,1
15834,2037650054,BX,1247 THIERIOT AVENUE,01,A1,CARMEN CRUZ,2,1,1
15835,2037690040,BX,1253 BRONX RIVER AVENUE,02,C3,"CHAUDHRY, ABDUL R",2,1,1
15836,2037730069,BX,1217 BOYNTON AVENUE,01,B1,1217 BOYNTON LLC,2,1,1
15837,2037920076,BX,1943 POWELL AVENUE,01,B1,"KARIM, RIFAT",2,1,1
15838,2038450017,BX,2416 BUTLER PLACE,01,B2,"INLALL, INDRAWATTIE S",2,1,1
15839,2038620050,BX,1483 EAST 172 STREET,01,B1,"LUTCHMAN, KISHAN",2,1,1
15840,2039640025,BX,1439 DORIS STREET,02,C1,BALLAGH PROPERTIES LLC,2,1,1
15841,2039780013,BX,2456 GLEBE AVENUE,01,A1,"MORALES, DANILO",2,1,1
15842,2040780004,BX,1511 SILVER STREET,01,B2,"CRUZ, CRYSTAL",2,1,1
15843,2040890007,BX,1578 YATES AVENUE,01,A1,THE JENNIE ORABONA IRREVOCABLE TRUST,2,1,1
15844,2042620029,BX,1907 MATTHEWS AVENUE,02,C0,"OBEID, YAHAY     AHMED",2,1,1
15845,2042670063,BX,975 RHINELANDER AVENUE,02,C0,GOOD PROPERTIES 975 LLC,2,1,1
15846,2043650036,BX,2226 ESPLANADE,06,E1,"LEVY, JEROME H",2,1,1
15847,2044450036,BX,902 ALLERTON AVENUE,04,S3,ALLERTON PARTNERS 902 LLC,2,1,1
15848,2044470011,BX,2514 COLDEN AVENUE,01,B3,MARCIAL RAMIREZ,2,1,1
15849,2044470021,BX,2550 COLDEN AVENUE,02,C3,"DURGAJ, PAULIN",2,1,1
15850,2044600042,BX,2429 THROOP AVENUE,01,A1,"PAGAN, ASTOR",2,1,1
15851,2044760058,BX,2561 FENTON AVENUE,01,A1,"STRUTINSKIY, MAKSIM",2,1,1
15852,2045270020,BX,2738 BOUCK AVENUE,01,B1,"LIRIANO, ROSA",2,1,1
15853,2046070045,BX,3291 BRONXWOOD AVENUE,01,A1,CAMACHO GARDENIA,2,1,1
15854,2046510042,BX,3780 WILLETT AVENUE,01,A9,"DELACRUZ, JOSE",2,1,1
15855,2046600053,BX,762 EAST 213 STREET,11,V0,762 E. 213 LLC,2,1,1
15856,2046620046,BX,744 EAST 215 STREET,01,B2,744 E. 215 LLC,2,1,1
15857,2046660084,BX,764 EAST 219 STREET,01,B2,"SMITH, COLLEEN",2,1,1
15858,2046890070,BX,960 EAST 219 STREET,01,B3,MUSTAFA BASIM A,2,1,1
15859,2047280049,BX,3456 KINGSLAND AVENUE,02,C0,"MORAN, OSCAR",2,1,1
15860,2048430075,BX,754 EAST 230 STREET,01,B2,"MARTIN, JOEL",2,1,1
15861,2048520029,BX,817 EAST 227 STREET,02,C2,GIVAN2  LLC,2,1,1
15862,2048550057,BX,812 EAST 231 STREET,02,C1,231ST STREET HOUSING DEVELOPMENT FUND CO MPANY INC.,2,1,1
15863,2049520001,BX,1600 EAST 233 STREET,05,O7,233RD STREET REALTYCORP.,2,1,1
15864,2049610022,BX,3952 SETON AVENUE,01,B2,"BRIDGETT, GEORGE L",2,1,1
15865,2050070037,BX,4233 GUNTHER AVENUE,01,A1,CASE ANGELA,2,1,1
15866,2050120040,BX,4228 WICKHAM AVENUE,01,A1,"TABB, CONSTANCE",2,1,1
15867,2050820017,BX,4626 MATILDA AVENUE,02,C0,"MCDONALD, TIFFANY P",2,1,1
15868,2051160015,BX,719 EAST 243 STREET,01,A1,"GARCIA, MARIA",2,1,1
15869,2051410440,BX,98 CO-OP CITY BOULEVARD,,Z9,RIVERBAY CORPORATION,10,9,1
15870,2051417501,BX,2219 GIVAN AVENUE,04,RR,UNAVAILABLE OWNER,2,1,1
15871,2052730010,BX,4038 BOSTON ROAD,07,G2,CHARLES MONACO,2,1,1
15872,2052730029,BX,2227 HOLLERS AVENUE,01,A2,"FERREIRA, MARCO",3,2,1
15873,2053500035,BX,2758 LATTING STREET,01,A5,"ROSE, NATASHA",2,1,1
15874,2053970009,BX,1433 HOBART AVENUE,01,A1,KENNETH M. KEARNS,2,1,1
15875,2054130041,BX,1618 KENNELLWORTH PLACE,01,A1,"RIVERA, SANDRA",2,1,1
15876,2054240029,BX,2962 BARKLEY AVENUE,01,B3,"D'ANNUCCI, ROSEMARIE T",2,1,1
15877,2054720032,BX,801 VINCENT AVENUE,01,A5,"LONG, ROBIN",3,2,1
15878,2055200033,BX,3081 PRENTISS AVENUE,09,Q7,N Y TENNIS CLUB INC,3,2,1
15879,2055310113,BX,3552 EAST TREMONT AVENUE,04,K4,3552 E TREMONT AVE LLC,2,1,1
15880,2057020001,BX,210 WEST 230 STREET,03,D3,NYC HOUSING AUTHORITY,2,1,1
15881,2059060331,BX,3720 INDEPENDENCE AVENUE,03,D4,UNAVAILABLE OWNER,2,1,1
15882,3001080022,BK,175 CONCORD STREET,01,B9,MAI PHAM,3,2,1
15883,3003820001,BK,327 HAMILTON AVENUE,07,G3,PISA HOLDING CORP,2,1,1
15884,3004720001,BK,469 COURT STREET,08,M1,ST MARYS RC CH,3,2,1
15885,3004890001,BK,595 SMITH STREET,06,E1,"CF SMITH, LLC",3,2,1
15886,3005150061,BK,118 CONOVER STREET,07,T2,PORT AUTHORITY OF NY AND NJ,14,13,1
15887,3005300036,BK,80 VISITATION PLACE,01,B9,MARY IOVINE,2,1,1
15888,3005950050,BK,183 VAN DYKE STREET,02,C2,175 VAN DYKE STREET LLC,2,1,1
15889,3006490026,BK,214 23 STREET,02,C2,"AMERICAN REALTY AIJ 214, LLC",2,1,1
15890,3006650045,BK,215 29 STREET,01,B9,"JABER, HANI",2,1,1
15891,3006730050,BK,195 31 STREET,01,B9,FRANK S. MANGONE,2,1,1
15892,3007840072,BK,515 50 STREET,02,C0,LEUNG CHAI KWONG,2,1,1
15893,3008780055,BK,603 18 STREET,01,B2,603 18 LLC,2,1,1
15894,3008990027,BK,274A 22 STREET,01,B9,"ERM REALTY SERVICES, LLC",2,1,1
15895,3010390035,BK,114 14 STREET,01,B1,"DEGN, GREGG",2,1,1
15896,3010400013,BK,136 14 STREET,07,G9,"SHERIFF DEVELOPMENT HOLDINGS, LLC",3,2,1
15897,3010417502,BK,155 15 STREET,03,R4,UNAVAILABLE OWNER,2,1,1
15898,3012240070,BK,637 PROSPECT PLACE,02,C3,"JAMES, TIMOTHY  A",3,2,1
15899,3012310035,BK,662 PROSPECT PLACE,01,B2,BINYARD ALBERTA,3,2,1
15900,3012710018,BK,736 EASTERN PARKWAY,04,S1,"736 EASTERN, LLC.",2,1,1
15901,3012850063,BK,1319 CARROLL STREET,01,A4,"PALACE, DAVID",2,1,1
15902,3012870021,BK,1000 CARROLL STREET,02,C3,"TAYLOR, WILMA",2,1,1
15903,3012980058,BK,547 MONTGOMERY STREET,01,B1,FAIGY PIEKARSKI,2,1,1
15904,3013140006,BK,1751 BEDFORD AVENUE,05,K1,120 EMPIRE BOULEVARDCORP,2,1,1
15905,3013690024,BK,1592 PROSPECT PLACE,02,C3,"WELCH, JAY",2,1,1
15906,3013740036,BK,1552 PARK PLACE,01,A9,"HARTNETT, TODD",2,1,1
15907,3013740039,BK,1564 PARK PLACE,04,S3,BUFFALO PARK HOLDING CO LLC,2,1,1
15908,3013980001,BK, ROCHESTER AVENUE,09,Q1,NYC DEPARTMENT OF PARKS AND RECREATION,2,1,1
15909,3014090015,BK,1708 PRESIDENT STREET,01,B1,JOHNSON VILMA L,2,1,1
15910,3014190026,BK,750 CROWN STREET,02,C3,BAIT ADIR LLC,2,1,1
15911,3014200009,BK,800 CROWN STREET,02,C3,800 CROWN STREET ASSOCIATES LLC,3,2,1
15912,3015340032,BK,290 MAC DOUGAL STREET,01,A9,DEBORAH KILPATRICK-JONES AS TRUSTEE,2,1,1
15913,3015710019,BK,1392 HERKIMER STREET,01,B3,"BEST, PHILLIP  C",2,1,1
15914,3017040061,BK,901 HERKIMER STREET,02,C2,BEDSTUY RESIDENCE LLC,2,1,1
15915,3017710011,BK,88 HART STREET,02,C1,WEBGOLD PROPERTIES LLC,2,1,1
15916,3017850001,BK,689 MARCY AVENUE,03,D3,MARCY UPREAL LLC,2,1,1
15917,3018170094,BK,143 MADISON STREET,02,C0,STEPHAUN HILL,2,1,1
15918,3018870082,BK,128 CLINTON AVENUE,02,C0,"DELGADO, JOSEPH P",3,2,1
15919,3019410002,BK,293 FRANKLIN AVENUE,02,C0,293 FRANKLIN LLC,2,1,1
15920,3019460013,BK,365 WASHINGTON AVENUE,02,C0,"TERREE RANDALL, TRUSTEE",3,2,1
15921,3020200077,BK,1041 ATLANTIC AVENUE,06,F4,"1045 ATLANTIC, LLC",2,1,1
15922,3022200069,BK,237 RUTLEDGE STREET,04,S2,RUTLEDGE PROPERTY TRUST,2,1,1
15923,3023200014,BK,180 NORTH 8 STREET,02,C2,"ZDRODOWSKI, HENRYK",2,1,1
15924,3023210002,BK,541 DRIGGS AVENUE,02,C0,541 DRIGGS PARTNERS LLC,2,1,1
15925,3024490011,BK,318 SOUTH 4 STREET,02,C3,HASIM MONOWARA B,2,1,1
15926,3024910001,BK,25 PAIDGE AVENUE,06,F8,25 PAIDGE LLC,9,8,1
15927,3024960013,BK,136 DUPONT STREET,02,C2,"PITULA, ANIELA",2,1,1
15928,3026500015,BK,103 NEWEL STREET,01,A9,SCHRODER ALFRED,3,2,1
15929,3027630037,BK,99 DEVOE STREET,01,B9,PHILIP A MANNA,2,1,1
15930,3027830018,BK,206 POWERS STREET,01,B2,206 POWERS MANAGEMENT LLC,2,1,1
15931,3027880014,BK,696 GRAND STREET,04,S2,696 GRAND STREET LLC,2,1,1
15932,3028100001,BK,546 MORGAN AVENUE,07,G3,PG SINGH ENTERPRISES LLC,2,1,1
15933,3029300012,BK,1283R GRAND STREET,06,F9,CHARLES J KING INC,6,5,1
15934,3033480010,BK,1389 BROADWAY,11,V1,"1389 BBB, L.P.",2,1,1
15935,3035360044,BK,640 SARATOGA AVENUE,01,B1,JAMAL WILLIAMS,2,1,1
15936,3035520024,BK,161 GRAFTON STREET,02,C0,"OSO, YEMI  E",2,1,1
15937,3037730148,BK,454 VERMONT STREET,01,A5,LORNA CAMPBELL,2,1,1
15938,3039160028,BK,90 NORWOOD AVENUE,01,B2,VENTURA WILFREDO,2,1,1
15939,3039880034,BK,366 SHEPHERD AVENUE,01,B2,"JP SHEPHERD, INC",2,1,1
15940,3040080019,BK,874 GLENMORE AVENUE,01,B2,3 V ARP LLC,2,1,1
15941,3040540028,BK,296 ATKINS AVENUE,01,B1,"WARD, JAMES",2,1,1
15942,3040760116,BK,555 SCHENCK AVENUE,01,A5,"PEARSON, ALMA",2,1,1
15943,3041890041,BK,903 GLENMORE AVENUE,02,C0,"HAWKINS, RAYMONT",2,1,1
15944,3045980069,BK,53 EAST 95 STREET,02,C3,"DUTTON, NATASHA",2,1,1
15945,3046720054,BK,379 ROCKAWAY PARKWAY,02,C3,"MAIGNAN, NANCY LISA",2,1,1
15946,3047060046,BK,100 EAST 59 STREET,01,A9,SHERWYN BECKLES,2,1,1
15947,3047220009,BK,5022 SNYDER AVENUE,01,B2,"ELLERBE, TOYIA",2,1,1
15948,3047360027,BK,554 EAST 52 STREET,01,A9,"PIERREVILLE , ANETTE JAMES",2,1,1
15949,3049350028,BK,1200 BROOKLYN AVENUE,01,B2,"DEJESUS, ANNA E",2,1,1
15950,3050440033,BK,336 FENIMORE STREET,01,B1,"RICHARDSON, LYNETTE",2,1,1
15951,3051010037,BK,250 EAST 21 STREET,01,B2,THE BRENDA V DOW & FITZHERBERT T DOW LIV ING TRUST,2,1,1
15952,3051110038,BK,1528 NOSTRAND AVENUE,04,S9,NOSTRAND 1528 REAL ESTATE LLC,3,2,1
15953,3051530006,BK,1016 CORTELYOU ROAD,04,S2,S & G PITKIN ASSOCIATES LLC,2,1,1
15954,3052870034,BK,830 GREENWOOD AVENUE,01,B3,"ODAY, FRANCIS JAMES",2,1,1
15955,3053320050,BK,109 DAHILL ROAD,01,B1,"CARRERA, AVELARDO",2,1,1
15956,3053710033,BK,546 EAST 3 STREET,01,B1,"STRATIS, TULIA",2,1,1
15957,3053980042,BK,423 AVENUE F,01,B2,PLUTCHOK SHALOM,3,2,1
15958,3054010072,BK,681 EAST 7 STREET,01,B9,"FINKELSTEIN, ABRAHAM",2,1,1
15959,3054120009,BK,773 EAST 5 STREET,01,B2,"GELBARD, JACK",2,1,1
15960,3054490035,BK,1762 48 STREET,01,B2,"WEISS, BARRY",2,1,1
15961,3054560011,BK,1814 49 STREET,02,C0,"HERZKA, GEORGE",2,1,1
15962,3054750044,BK,1977 53 STREET,01,A9,"GROSS, MICHAEL",2,1,1
15963,3054787502,BK,1671 54 STREET,02,R6,UNAVAILABLE OWNER,2,1,1
15964,3055170062,BK,1665 61 STREET,02,C0,EISENBERGER STUART,2,1,1
15965,3056090059,BK,1167 45 STREET,01,B2,DAVID EPSTEIN,2,1,1
15966,3056217504,BK,1155 47 STREET,02,R1,UNAVAILABLE OWNER,2,1,1
15967,3056300055,BK,1455 48 STREET,08,M9,CONGREGATION KAHAL JESASE OF RERESTUR,2,1,1
15968,3056510030,BK,858 51 STREET,01,B1,FHM REALTY LLC,2,1,1
15969,3058210005,BK,6405 7 AVENUE,05,O2,6405 SEVENTH AVENUELLC,2,1,1
15970,3058920024,BK,440 OVINGTON AVENUE,08,W2,EVANG LUTH BETH CONG,2,1,1
15971,3059980051,BK,8126 5 AVENUE,04,S9,"PERKINS, THOMAS",4,3,1
15972,3060460045,BK,77 88 STREET,01,B3,DEMARCO FRANK L,2,1,1
15973,3060530032,BK,26 GATLING PLACE,01,A5,"LYKOUREZOS, OLYMPIA",2,1,1
15974,3062550011,BK,1214 78 STREET,01,B1,"ZHANG, WEN FANG",2,1,1
15975,3062770012,BK,2218 79 STREET,01,B2,LIEBMAN YAFFA,2,1,1
15976,3064260069,BK,8834 15 AVENUE,01,B2,"NAPOLITANO, DONNA",2,1,1
15977,3065060036,BK,993 EAST 3 STREET,01,A1,"GOLD, YEHUDA",2,1,1
15978,3065150074,BK,1027 EAST 2 STREET,01,A5,"KUPFER, STANLEY P",2,1,1
15979,3065300033,BK,1068 EAST 10 STREET,01,B3,"ROSENFELD , DAVID",2,1,1
15980,3065340029,BK,1150 EAST 9 STREET,01,B2,"IMANI, DAN",2,1,1
15981,3065420026,BK,1334 EAST 7 STREET,01,B2,DANIEL M ROTH,2,1,1
15982,3065850022,BK,1520 EAST 4 STREET,01,A3,"AZARBAD, SHLOMO",2,1,1
15983,3065880061,BK,1491 OCEAN PARKWAY,01,B2,"HAMADANI, DAVID",2,1,1
15984,3066090089,BK,1579 EAST 2 STREET,01,A9,"ABRAHAM, EZEKIEL",2,1,1
15985,3066300033,BK,1654 WEST 1 STREET,01,A9,"FAN, LAN QING",2,1,1
15986,3066380033,BK,1746 EAST 7 STREET,01,B3,MORRIS H ABRAHAM,2,1,1
15987,3066390008,BK,720 AVENUE P,01,A1,"MIZRAHI, ERIC",2,1,1
15988,3066600070,BK,1819 EAST 3 STREET,01,A9,"SASSON, JACKLINE",2,1,1
15989,3066660130,BK,2086 CONEY ISLAND AVENUE,04,S2,THE 2086 CONEY ISLAND AVE CORP,2,1,1
15990,3066740031,BK,1866 WEST 6 STREET,02,C0,"WONG, BEN TONG",2,1,1
15991,3066810259,BK,1950 EAST 4 STREET,01,A1,LORAINE COHEN,2,1,1
15992,3066960046,BK,1215 AVENUE I,01,B9,FREEDMAN MALKI,2,1,1
15993,3067500014,BK,1418 EAST 13 STREET,01,B3,SHTAYNBERGER  BERKO,2,1,1
15994,3067510034,BK,1462 EAST 14 STREET,01,B2,"SASSON , YOSEF ARI",2,1,1
15995,3069170055,BK,2849 CROPSEY AVENUE,04,S2,HAYON LLC,2,1,1
15996,3069190085,BK,241 AVENUE Z,01,B1,"CHEN, SHUNA",2,1,1
15997,3070850076,BK,404 APPLEGATE COURT,01,A1,EUGENE YEE,2,1,1
15998,3070980078,BK,2017 WEST 8 STREET,01,B1,"YE, AI YU",2,1,1
15999,3071040224,BK,1921 EAST 1 STREET,01,A1,"LEVY, SUZETTE",2,1,1
16000,3071100056,BK,2131 EAST 7 STREET,01,B1,"MAMROUT, MOUSSA",2,1,1
16001,3071110012,BK,2018 EAST 9 STREET,01,B3,"SUTTON, JACK/NOM",3,2,1
16002,3071110020,BK,2034 EAST 9 STREET,01,B1,"LEVY, ELIE",2,1,1
16003,3071280067,BK,2121 EAST 1 STREET,02,C0,"KREDI, MICHELLE",2,1,1
16004,3071310051,BK,2225 EAST 4 STREET,01,B1,"ZEITOUNE, FORTOUNA",2,1,1
16005,3071330047,BK,2163 OCEAN PARKWAY,01,A9,JACK SHAMAH,2,1,1
16006,3071330054,BK,2141 OCEAN PARKWAY,01,A9,"KASSAB, HAVIV",2,1,1
16007,3071570083,BK,2269 EAST 5 STREET,01,A9,"TEBELE, ABRAHAM A",2,1,1
16008,3071570088,BK,2255 EAST 5 STREET,01,B1,"TINA 2255, LLC",2,1,1
16009,3071750058,BK,2347 WEST 1 STREET,01,B3,"AKIBEH, IBRAHIM",2,1,1
16010,3072150006,BK,426 AVENUE Y,01,A1,V CORDI,2,1,1
16011,3072940003,BK,1512 AVENUE S,01,B1,"POON, JESSICA VENESSA",2,1,1
16012,3073170017,BK,2028 EAST 13 STREET,01,B2,"JARADEH, NOURI",2,1,1
16013,3073430018,BK,2130 EAST 12 STREET,02,C0,YEDID SILYA,2,1,1
16014,3073750064,BK,2217 EAST 14 STREET,01,A2,704 AVENUE W LLC,3,2,1
16015,3074050108,BK,2308 EAST 22 STREET,01,B1,KING PANG YU,2,1,1
16016,3074050407,BK,4366 BEDFORD AVENUE,01,B3,REGINA KOFMAN,2,1,1
16017,3075680025,BK,929 EAST 22 STREET,01,B2,"GREENFELD, SHOLEM",2,1,1
16018,3075940011,BK,2361 NOSTRAND AVENUE,05,O6,E B A REAL ESTATE HOLDING CORP,2,1,1
16019,3076090061,BK,1038 EAST 28 STREET,01,A9,"KOSCHITZKI, FAIGE",2,1,1
16020,3076180007,BK,1818 FLATBUSH AVENUE,04,S1,"KASSAB, MORRIS",2,1,1
16021,3076240015,BK,1173 EAST 24 STREET,01,B2,"AGHBASHOFF, ZOHAR",2,1,1
16022,3076300010,BK,2557 NOSTRAND AVENUE,05,O5,LEBGUTT REALTY LLC,2,1,1
16023,3076440001,BK,2621 AVENUE M,01,A1,ESTHER CYNAMON,2,1,1
16024,3076560031,BK,2022 AVENUE M,08,M1,"KOL TORAH, INC.",2,1,1
16025,3076590027,BK,1341 EAST 23 STREET,01,A1,POLINA BOHM,2,1,1
16026,3076900004,BK,2915 AVENUE P,04,S1,"LOUIE, KENNETH",2,1,1
16027,3076900070,BK,2884 NOSTRAND AVENUE,08,W9,MARC AND ELKA CHEMTOB CHARITABLE FOUNDAT ION,2,1,1
16028,3077910036,BK,4316 AVENUE J,01,B9,"MITCHELL, PAUL",2,1,1
16029,3078310026,BK,1459 EAST 51 STREET,01,B1,GOPIE CRAIG D,2,1,1
16030,3078790059,BK,1464 EAST 55 STREET,01,A9,LORNA HYLTON,2,1,1
16031,3079630073,BK,554 EAST 85 STREET,01,A1,GABRIELLE VERDIEU,2,1,1
16032,3080240007,BK,8705 AVENUE J,01,A2,"CLARKE, HUGH C",2,1,1
16033,3080550036,BK,1111 EAST 89 STREET,04,S1,LAMARTINE DESIR,2,1,1
16034,3080800060,BK,1586 REMSEN AVENUE,02,C0,"RICKETTS, DENNIS",2,1,1
16035,3081730011,BK,663 EAST 104 STREET,01,B2,"GILL, JENNIFER",2,1,1
16036,3082010001,BK,1244 EAST 94 STREET,01,B3,"AMPARO, VIRGINIA L.",2,1,1
16037,3083850074,BK,1456 EAST 64 STREET,01,A9,"SANTOSTEFANO, LOUISE",2,1,1
16038,3086480076,BK,2680 EAST 65 STREET,01,B2,"KRUGLYANSKY, OLEG",2,1,1
16039,3087260043,BK,94 AMHERST STREET,08,M9,TORATH ISRAEL SEPHARDIC  CONGREGATION,2,1,1
16040,3087370017,BK,175 EXETER STREET,01,A3,"KREPOSTMAN, REBECCA",2,1,1
16041,3088850064,BK,4 IRA COURT,01,A1,"DITUCCI-CAPPIELLO, DONNA",2,1,1
16042,3088910488,BK,44 HAZEL COURT,01,A1,"D'AGOSTA, ANTHONY C",2,1,1
16043,4005060024,QN,11-21 30 ROAD,01,B2,"11-21 30TH ROAD MANAGEMENT, LLC",2,1,1
16044,4005150031,QN,12-26 30 AVENUE,03,D1,1222 30 AVE LLC,2,1,1
16045,4005210121,QN,33-22 14 STREET,01,B1,THE MAK FAMILY IRREVOCABLE TRUST,2,1,1
16046,4005700024,QN,30-83 23 STREET,03,D1,TJ ASTORIA CORP,2,1,1
16047,4005830018,QN,34-25 CRESCENT STREET,01,B3,"GARSON, MARGARET",2,1,1
16048,4006370023,QN,36-19 37 STREET,01,B3,BIZGROUP LLC,2,1,1
16049,4006530075,QN,25-38 38 STREET,02,C1,43 STREET REALTY LLC,2,1,1
16050,4006840024,QN,25-55 STEINWAY STREET,04,S2,"DIMILTA , TERESA",2,1,1
16051,4007210010,QN,28-41 47 STREET,01,B3,"LOGIUDICE, ANTHONY",2,1,1
16052,4007300044,QN,46-10 25 AVENUE,02,C0,"PAGANO, MICHAEL",3,2,1
16053,4007350006,QN,49-01 NORTHERN BOULEVARD,07,G4,YEGNUKIAN REALTY CORP,2,1,1
16054,4007860044,QN,43-19 20 ROAD,01,A1,"SPIROU, ATHENA",2,1,1
16055,4008020084,QN,18-70 42 STREET,06,E1,SANDRO ALEXANDER CVECICH IRREV. TRUST DT D 2012,2,1,1
16056,4008820063,QN,20-26 23 STREET,01,B1,VASSILIOU COSTAS,2,1,1
16057,4009450007,QN,19-26 77 STREET,02,C0,DENISE BROCAD,2,1,1
16058,4012140045,QN,37-17 59 STREET,02,C0,"OCHOA, MANUEL E",2,1,1
16059,4013450037,QN,42-28 68 STREET,01,B2,"KARAVITES, KELLY",2,1,1
16060,4013500030,QN,69-60 43 AVENUE,01,B2,6960 REALTY LLC,2,1,1
16061,4015750042,QN,43-45 ELBERTSON STREET,02,C0,"HSU, NANCY W",2,1,1
16062,4016790030,QN,110-26 DITMARS BOULEVARD,01,B3,ELBA BECKHAM,2,1,1
16063,4016990041,QN,10407 NORTHERN BOULEVARD,04,S2,"DOMINGUEZ, GUILLERMO",2,1,1
16064,4017110042,QN,96-03 34 AVENUE,01,B3,"RATTU, AJAY P",2,1,1
16065,4017610011,QN,37-14 99 STREET,01,B2,"DUTAN, JOSE",2,1,1
16066,4017700020,QN,101-14 39 AVENUE,04,C7,ARCH 39 LLC,2,1,1
16067,4018950013,QN,53-33 JUNCTION BOULEVARD,01,A5,SHEW JING TOM,2,1,1
16068,4019400025,QN,52-10 103 STREET,01,B1,"WANG, HAIMIN",2,1,1
16069,4019620012,QN,108-14 OTIS AVENUE,02,C0,"NI, JI FANG",2,1,1
16070,4019620018,QN,109-44 CORONA AVENUE,02,C0,"HUANG, XIU WEI",2,1,1
16071,4020090054,QN,109-33 54 AVENUE,02,C2,CRUZ PERSIO,2,1,1
16072,4020140039,QN,41-04 114 STREET,02,C3,"DUONG, KHAN",2,1,1
16073,4022270004,QN,68-35 110 STREET,01,A3,YADGAROV GAVRIEL,2,1,1
16074,4022290012,QN,110-12 69 AVENUE,01,A1,MICHAEL HORODNICEANU,2,1,1
16075,4022420005,QN,69-09 112 STREET,01,A1,"FULMAN, VLADIMIR",2,1,1
16076,4022950029,QN,50-29 45 STREET,01,A9,CHUA EDWARD A,2,1,1
16077,4023050041,QN,51-32 48 STREET,01,B1,"SINHA, ANUJ",2,1,1
16078,4026380051,QN,60-51 54 PLACE,01,B2,ORTIZ MIGDALIA,2,1,1
16079,4026480012,QN,60-15 55 STREET,02,C0,"ROMERO, JUAN CARLO",2,1,1
16080,4026900106,QN,59-57 56 DRIVE,01,A2,STROCCHIA VITTORIO,2,1,1
16081,4027350045,QN,60-64 60 LANE,01,B2,"GOC, TOMASZ",2,1,1
16082,4027510050,QN,57-38 65 STREET,01,B2,THE DOAK FAMILY TRUST,2,1,1
16083,4027530301,QN,64-41 59 AVENUE,01,A2,"BILELLO, PHILIP",2,1,1
16084,4027570067,QN,62-39 60 ROAD,01,B2,DELRIO  NEFTALI,2,1,1
16085,4027580014,QN,62-28 60 ROAD,01,B2,"CUEVAS, BERNICE",2,1,1
16086,4028750049,QN,85-09 52 AVENUE,01,B2,"OUYANG, ZONGCHENG",2,1,1
16087,4029530109,QN,62-55 69 STREET,01,A5,"POWERS, JAMES J",2,1,1
16088,4029950075,QN,63-15 83 STREET,01,A5,"ZHANG, LI YA",2,1,1
16089,4030260074,QN,64-16 70 STREET,01,B3,"MCCARTHY, JESSICA",2,1,1
16090,4030650023,QN,74-11 METROPOLITAN AVENUE,05,K7,"PROSPEROUS VIEW, LLC",3,2,1
16091,4031440019,QN,85-59 67 AVENUE,01,A5,"AGUDELO, CRISTINA",2,1,1
16092,4031580065,QN,66-30 SAUNDERS STREET,01,B3,"CHEN, EUNICE RUEY YING L",2,1,1
16093,4031770027,QN,70-12 TROTTING COURSE LANE,01,B2,MIGUEL A. CENTENO,2,1,1
16094,4032480004,QN,114 CONTINENTAL AVENUE,01,A3,"CASTALDO, ANGELA",3,2,1
16095,4033230070,QN,130 82 DRIVE,01,A1,"V.K.R.K. FAMILY TRUST OF JANUARY 16, 201 3",2,1,1
16096,4035560019,QN,1624 DECATUR STREET,06,F9,SOLAB HOLDINGS CORP.,3,2,1
16097,4035940038,QN,72-11 64 PLACE,11,V0,CHRIST TABERNACLE,2,1,1
16098,4036080176,QN,65-32 ADMIRAL AVENUE,01,B2,THEODORE BROWNE,2,1,1
16099,4036300017,QN,70-02 CYPRESS HILLS STREET,04,S2,GEORGE TODOROVIC,2,1,1
16100,4038160073,QN,77-54 79 PLACE,01,B3,FREDERICK J PORTH,2,1,1
16101,4041350048,QN,129-15 20 AVENUE,01,B2,"NUNEZ, ETHEL",2,1,1
16102,4041730006,QN,20-39 128 STREET,05,O5,TOPLINE HOLDINGS LLC,2,1,1
16103,4043160008,QN,28-19 119 STREET,06,E9,FERAZZOLI EQUITIES LLC,2,1,1
16104,4044860022,QN,12-28 149 STREET,02,C3,"VARRIANO, GIACOMO",3,2,1
16105,4045430034,QN,154-90 RIVERSIDE DRIVE,01,A1,"CANICATTI, FILLIPA",2,1,1
16106,4045860023,QN,161-12 14 AVENUE,01,A1,LIFE ESTATE OF SILVIA CATSICAS,2,1,1
16107,4046580008,QN,147-06 23 AVENUE,01,B3,"GIAMPINO, MADDALENA",2,1,1
16108,4048530060,QN,29-40 155 STREET,01,A3,"CLINCO, ANTHONY R",2,1,1
16109,4049080030,QN,29-46 164 STREET,01,B1,FLORATOS DIONISIA,2,1,1
16110,4049210010,QN,167-20 29 AVENUE,01,A1,PATRICK REILLY,2,1,1
16111,4049540028,QN,32-04 UNION STREET,04,O8,KATERINA & DIMITRIS ZOUZIAS,2,1,1
16112,4049940024,QN,140-26 34 AVENUE,02,C0,LEAVITT UNION MANAGEMENT CORP.,2,1,1
16113,4050200005,QN,38-13 UNION STREET,05,K2,H RAYLIN CORP,2,1,1
16114,4051400048,QN,43-43 MAIN STREET,05,K1,"TUNG, SUI MAN",2,1,1
16115,4054220006,QN,43-71 164 STREET,01,B2,"MARTELLI BACARELLA, LISA A",2,1,1
16116,4055320009,QN,189-20 46 AVENUE,01,A1,CHEE LEON NG,2,1,1
16117,4055610055,QN,202-13 ROCKY HILL ROAD,01,B2,"GAO, ZHONG",2,1,1
16118,4058030042,QN,23-12 204 STREET,01,A0,"BOLOGNA, PETER",2,1,1
16119,4060490004,QN,2942 210 PLACE,01,A2,MC NALLY PETER J,2,1,1
16120,4061450020,QN,36-30 201 STREET,01,A1,"COSTANZA, AUGUST A",3,2,1
16121,4061540051,QN,36-11 205 STREET,01,A1,MARKIEWICZ DANIEL,2,1,1
16122,4069560034,QN,71-19 168 STREET,01,A1,"MISHPATOVA, RAISA S",2,1,1
16123,4069670057,QN,164-39 76 AVENUE,01,B3,MAY LING YUEN,2,1,1
16124,4072770001,QN,189-10 GRAND CENTRAL PKWY,08,W1,NYC DEPARTMENT OF EDUCATION,2,1,1
16125,4073060016,QN,206-28 45 ROAD,01,B1,"LI, CHEN MING",2,1,1
16126,4073680001,QN,209-08 48 AVENUE,08,M1,LOVE OF CHRIST PRESBYTARIAN,2,1,1
16127,4074510032,QN,200-05 HORACE HARDING EXPWY,07,G4,ANTHONY PANVINI,4,3,1
16128,4076130037,QN,64-72 213 STREET,01,A2,"CHEN, ZHENFENG",2,1,1
16129,4076830030,QN,69-39 224 STREET,01,B1,"WONG, TERENCE",2,1,1
16130,4079990001,QN,93-14 240 STREET,01,A1,TILLMAN CLIFFORD,2,1,1
16131,4080030391,QN,93-20 241 STREET,01,A1,"TOUAF, KAREN",2,1,1
16132,4080300073,QN,15 MANOR ROAD,01,A1,"MODICA, CARMELA C",2,1,1
16133,4081290168,QN,44-10 JESSIE COURT,04,S1,CAIOZZO CARL,2,1,1
16134,4081340094,QN,251-23 43 AVENUE,01,A1,JEAN JACQUES JONATOWSKI,2,1,1
16135,4081480015,QN,39-33 GLENWOOD STREET,01,A1,"WENG, LING FANG",2,1,1
16136,4081620509,QN,248-03 40 AVENUE,01,A1,"STUART, CRAIG",3,2,1
16137,4082510052,QN,52-28 LEITH PLACE,01,A1,STANLEY B SHACK,2,1,1
16138,4082760592,QN,57-02 246 PLACE,01,A2,"WU, CHUNG SHUN",2,1,1
16139,4086490019,QN,87-68 254 STREET,01,B3,"ANSARI, MUHAMMAD  S",2,1,1
16140,4086490020,QN,87-70 254 STREET,01,B3,"BHATTI, GURVINDER S",2,1,1
16141,4088200051,QN,86-40 262 STREET,01,A0,DIANE F. PECHACEK,2,1,1
16142,4088950030,QN,88-42 75 STREET,01,B2,"LI, JOEI CHUN YU",2,1,1
16143,4089050035,QN,76-17 88 AVENUE,04,S2,"ESPINAL, GLORIA",2,1,1
16144,4090840040,QN,84-27 102 AVENUE,01,B1,"HASSAN, ALI",2,1,1
16145,4090870037,QN,86-13 102 AVENUE,01,A9,"SEENATHSINGH, LUANNE",2,1,1
16146,4090980011,QN,101-16 92 STREET,01,B2,"BIENVENIDO, CAPELLAN",2,1,1
16147,4091850008,QN,102-16 85 DRIVE,01,A1,"LIN, ALICE",2,1,1
16148,4091850030,QN,86-02 104 STREET,02,C0,SAU WAN HO,3,2,1
16149,4092740072,QN,86-32 121 STREET,02,C0,MM KHAN HOLDINGS TWO LLC,3,2,1
16150,4093010088,QN,111-05 91 AVENUE,01,B2,"HAMRAJH, PARSRAM",2,1,1
16151,4094240025,QN,101-42 107 STREET,01,B2,FRANKLIN JAPAL,2,1,1
16152,4094360003,QN,118-06 ATLANTIC AVENUE,05,K1,VERRELLI ALDO,2,1,1
16153,4094440044,QN,127-09 95 AVENUE,01,B2,"ALTAMIRANO, HERNAN P",2,1,1
16154,4094810036,QN,97-11 133 STREET,01,B3,"AVILA, JOHN",2,1,1
16155,4094900038,QN,123-21 103 AVENUE,01,A1,"JASWAL, RANJIT",2,1,1
16156,4097430108,QN,147-08 COOLIDGE AVENUE,01,B1,AKILOV FAMILY TRUST,2,1,1
16157,4098540009,QN,84-33 164 STREET,01,B2,"HUSSAIN, FUAD",2,1,1
16158,4098847501,QN,172 HIGHLAND AVENUE,02,R3,JAMAICA ESTE CONDO    #,13,12,1
16159,4100840009,QN,145-50 SHORE AVENUE,01,A1,"ISLAM, MD SHAHIDUL",2,1,1
16160,4101820049,QN,109-39 164 STREET,01,A1,"ZHENG, FANG",2,1,1
16161,4101890008,QN,109-50 MERRICK BOULEVARD,05,K6,"RW 109-50 MERRICK, LLC",2,1,1
16162,4102130019,QN,92-18 173 STREET,01,B2,"ALI, RAFMAN",2,1,1
16163,4102750086,QN,110-25 176 STREET,01,A1,"ATTILIO SANDERS, EILEEN",2,1,1
16164,4103640020,QN,99-20 FARMERS BOULEVARD,02,C1,109 WEST 225TH STREET LLC,12,11,1
16165,4103720031,QN,104-22 187 STREET,01,A1,"CHAMBERS, BEVERLEY",2,1,1
16166,4103910068,QN,190-11 QUENCER ROAD,01,B3,"WILCOX, JACK",2,1,1
16167,4104060090,QN,114-04 OVID PLACE,01,A2,FRANCIS PAULINE V,2,1,1
16168,4104180015,QN,186-30 JORDAN AVENUE,01,A1,"HOWARD A/K/A, NATHANIEL JOSEPH",2,1,1
16169,4105580050,QN,90-20 209 STREET,01,A1,RAJENDRA S PRASHAD,2,1,1
16170,4105790026,QN,88-58 HOLLIS COURT BLVD,10,G0,"DLJ MORTGAGE CAPITAL,INC",2,1,1
16171,4106750037,QN,88-32 216 STREET,01,A1,"JAGROOP, DALE D",2,1,1
16172,4107090022,QN,91-22 218 PLACE,01,A1,"RAMNARAINE, NFN",2,1,1
16173,4108800024,QN,99-39 211 PLACE,01,A1,"YOUNG, ALLAN C",3,2,1
16174,4109500092,QN,190-28 111 AVENUE,01,B2,"SOOKDEO, RAMPERSAUD",2,1,1
16175,4109680090,QN,191-21 112 ROAD,01,B3,"ZAMORA, CARLOS A",2,1,1
16176,4109780038,QN,112-32 203 STREET,01,A1,"CROWDER-CANTY, THOMOSENE",2,1,1
16177,4110150061,QN,114-29 198 STREET,01,A5,"BLIJDEN, IFETAYO A",2,1,1
16178,4110980110,QN,104-41 212 PLACE,01,A1,"FREDERIC, MAX P",2,1,1
16179,4111630020,QN,104-45 SPRINGFIELD BLVD,01,B2,"CASTLE ELITE ENTERPRISES, INC.",2,1,1
16180,4112340102,QN,114-11 SPRINGFIELD BLVD,01,A5,"LEE, RUTH E",2,1,1
16181,4112710087,QN,114-63 227 STREET,01,A1,TYRONE STALLINGS,2,1,1
16182,4112980038,QN,216-08 115 ROAD,01,A1,RUFFIN RUBBIE AKA,2,1,1
16183,4113140071,QN,115-85 232 STREET,01,A1,"LEWIS,     PAUL",2,1,1
16184,4116160023,QN,111-38 112 STREET,01,B2,"RAMLICHAN, REMERA",2,1,1
16185,4116440048,QN,114-33 117 STREET,01,B3,"GANGARAMPANDAY, DIELIPKOEMAR",2,1,1
16186,4117750204,QN,129-27 135 PLACE,01,A1,"SINGH, GURCHARAN",2,1,1
16187,4117900022,QN,133-11 130 PLACE,01,B1,133-09 11 130 PLACE LLC,4,3,1
16188,4119390088,QN,145-22 ARLINGTON TERRACE,02,C0,PEGGY COLE,2,1,1
16189,4119430008,QN,110-26 LIVERPOOL STREET,01,A1,LISA CRAWFORD,2,1,1
16190,4119610039,QN,111-11 145 STREET,01,B3,111 STREET 2015 CORP,2,1,1
16191,4120500042,QN,146-10 123 AVENUE,01,A1,"MURRAY, CASSANDRA",2,1,1
16192,4120700103,QN,128-13 145 STREET,01,B3,"ROBERT, RONALD",2,1,1
16193,4120710004,QN,128-33 INWOOD STREET,01,B2,"KARIM, SHARAZ",2,1,1
16194,4121650039,QN,110-14 GUY R BREWER BLVD,08,M9,BETHEL GOSPEL TABERNACLE INC,3,2,1
16195,4122980026,QN,134-38 160 STREET,01,B1,KEITHA FORBES,2,1,1
16196,4124030063,QN,115-53 172 STREET,01,A1,"PICHARDO, JULIA",2,1,1
16197,4124060101,QN,116-03 MERRICK BOULEVARD,06,E1,BLACKWATCH LLC,3,2,1
16198,4124700022,QN,176-12 BAISLEY BOULEVARD,01,B2,"NELSON, CRAIG P",2,1,1
16199,4126390022,QN,204-15 119 AVENUE,01,B1,JOSEPH FABIEN,2,1,1
16200,4127060010,QN,122-19 LUCAS STREET,01,A1,"OGBURN, NANNIE",2,1,1
16201,4129690005,QN,133-10 FRANCIS LEWIS BLVD,01,A5,BEN AND ALICE HICKMAN,2,1,1
16202,4130520024,QN,141-25 182 STREET,01,B3,"MAYS, ACCOLA",2,1,1
16203,4130890017,QN,144-03 FARMERS BOULEVARD,01,B3,"WRIGHT, HALIMAH",2,1,1
16204,4132750061,QN,175-03 144 DRIVE,01,A5,ASEMOTA DANIEL E,2,1,1
16205,4132900045,QN,145-20 177 STREET,01,A2,"MENG, YAN H",2,1,1
16206,4133480087,QN,146-18 184 STREET,01,A2,"LOVINDEER, LORNA",2,1,1
16207,4134680020,QN,145-77 220 STREET,01,B3,"REID, ANTONETTE",2,1,1
16208,4136720040,QN,257-45 148 ROAD,01,B2,"MCDONALD, JAIME",2,1,1
16209,4141720001,QN,156-39 102 STREET,01,A2,"NOLAN, JOHN J",2,1,1
16210,4141820008,QN,102-16 159 AVENUE,01,B9,"EIERMAN, ROBERT",2,1,1
16211,4150090017,QN,144-42 157 STREET,01,B3,"CLAVIJO, CARLOS H.",2,1,1
16212,4153760045,QN,302 CROSS BAY BOULEVARD,10,G1,CHARLES W HOWARD,2,1,1
16213,4154750001,QN,10-38 CROSS BAY BOULEVARD,01,A1,KENNETH LEHR,2,1,1
16214,4155560030,QN,13-29 DINSMORE AVENUE,01,B2,MARTHA EDOUARD,2,1,1
16215,4155790126,QN,817 CAFFREY AVENUE,01,B3,"EISENBERG, BARUCH",2,1,1
16216,4157100060,QN,11-23 BEACH CHANNEL DRIVE,01,B2,"CIFUENTES, ASUNCION",2,1,1
16217,4157140183,QN,3 HOLLYWOOD COURT,01,A1,"SMITH, CLAUDETTE",2,1,1
16218,4161690051,QN,189 BEACH 96 STREET,01,A1,BEACH 96TH REALTY LLC,2,1,1
16219,4162710018,QN,2-59 BEACH 137 STREET,01,A1,PETER SOSNOWSKI,2,1,1
16220,4162780036,QN,1-43 BEACH 133 STREET,01,B3,"ENGLISH, PETER J",2,1,1
16221,4163040028,QN,325 BEACH 147 STREET,01,A1,"HENRY, BRYAN",2,1,1
16222,4163040045,QN,14716 NEPONSIT AVENUE,01,A1,"BENIN, YURI",2,1,1
16223,5000210040,SI,1 BELMONT PLACE,01,A1,"ROLDAN-SANCHEZ, KIMLEE",2,1,1
16224,5000510209,SI,116 WESTERVELT AVENUE,01,A2,"RAMOS, BRITTANY N",2,1,1
16225,5000660019,SI,37 CASSIDY PLACE,01,B2,"DENNIS, LESLIE",2,1,1
16226,5000700003,SI,87 TYSEN STREET,01,B2,"CHAVEZ, DAVID",2,1,1
16227,5001280042,SI,418 CASTLETON AVENUE,04,S2,CASTLETON PRESERVATION LEAGUE INC.,2,1,1
16228,5001490221,SI,198 DAVIS AVENUE,01,B3,"NUZZO, DAVID",2,1,1
16229,5001500186,SI,3 HOWARD COURT,01,A5,MOHAMED B. ELHATHAT,2,1,1
16230,5001580154,SI,109 NORTH BURGHER AVENUE,01,A1,"ALEXANDER , SHELLY-ANN",2,1,1
16231,5001880088,SI,17 TRINITY PLACE,01,B3,R STRATFORD,2,1,1
16232,5002030041,SI,130 DONGAN STREET,01,A1,VINCENT NICHILO,2,1,1
16233,5002150188,SI,2 DRIPROCK STREET,06,E2,FIDA AND SON CONSTRCUTION CORP,2,1,1
16234,5002180051,SI,102 CAROLINE STREET,01,B3,"MORAN, GREGORIO",2,1,1
16235,5002310041,SI,1053 FOREST AVENUE,01,A5,"HARRINGTON, TIMOTHY",2,1,1
16236,5002380207,SI,1227 FOREST AVENUE,05,K1,SNUG HARBOR BARD-DAVIS ASSOC,2,1,1
16237,5002440010,SI,11 MELROSE AVENUE,01,A1,SJOLANDER LYNN A,2,1,1
16238,5002530106,SI,543 METROPOLITAN AVENUE,01,A1,T & E BLACK,2,1,1
16239,5002920021,SI,20 NUTLY PLACE,01,A1,MICHAEL TROTTA,2,1,1
16240,5003440015,SI,96 SANFORD PLACE,01,A1,JOSEPH V ZERO,2,1,1
16241,5003460093,SI,172 POTTER AVENUE,01,A1,"GOMEZ, YESENIA",2,1,1
16242,5003470035,SI,164 FAIRVIEW AVENUE,01,B2,"PISTILLI, LAURA G",2,1,1
16243,5003700108,SI,11 RAYMOND AVENUE,01,A0,BRIAN KENNEDY,2,1,1
16244,5003880007,SI,85 VELTMAN AVENUE,01,B2,"WENG, JIA FU",2,1,1
16245,5005280045,SI,700 BAY STREET,08,I7,ST VINCENT'S MEDICAL CENTER,2,1,1
16246,5005300043,SI,41 HARRISON STREET,01,B2,KOLAWOLE AKANMU,2,1,1
16247,5006330046,SI,62 OSGOOD AVENUE,01,A1,"VIDALS, ALFONSO",2,1,1
16248,5010430108,SI,58 LEXINGTON AVENUE,01,A1,KARISSA FERGUSON,2,1,1
16249,5010860063,SI,2270 RICHMOND TERRACE,01,A5,ANGEL MONTES,2,1,1
16250,5011440006,SI,57 BOWLES AVENUE,01,B2,JOHN MURRAY,2,1,1
16251,5011610150,SI,150 GRANITE AVENUE,05,O1,PERSON CENTERED CARE SERVICES INC.,2,1,1
16252,5011940088,SI,228 SIMONSON AVENUE,01,A1,ROHAN A. DHARMOSENA,2,1,1
16253,5012570012,SI,233 SOUTH AVENUE,01,A9,TESTAMENTARY TRUST,2,1,1
16254,5014350178,SI,126 GALLOWAY AVENUE,01,B2,"BRUIJ, CHARLES",2,1,1
16255,5014780528,SI,58 HOUSTON LANE,01,A5,JAMES S SMITH,2,1,1
16256,5016570061,SI,82 REGIS DRIVE,01,B9,"CASSO, AUDREY",2,1,1
16257,5020720028,SI,1735 RICHMOND AVENUE,05,K2,"MIKE AND CATHY'S UNICORN, LLC",2,1,1
16258,5021000450,SI,2024 RICHMOND AVENUE,08,M1,IMMANUEL LUTHERAN CHU,7,6,1
16259,5022450035,SI,64 MC CULLY AVENUE,01,A3,"FEYGIN, LAZAR",2,1,1
16260,5022640031,SI,194 NUGENT STREET,01,B2,"MIGLIORE, MICHAEL",3,2,1
16261,5028530056,SI,235 HYLAN BOULEVARD,01,A5,ABDUL AIKAWA,2,1,1
16262,5028560045,SI,241 MARYLAND AVENUE,01,A1,"POVEROMO, ANNA MARIE",2,1,1
16263,5028650081,SI,87 FINGERBOARD ROAD,01,A3,"BERARDI, CHRISTOPHER  D",2,1,1
16264,5029660018,SI,202 CHESTNUT AVENUE,01,A5,MOE GENE,2,1,1
16265,5030400200,SI,565 STEUBEN STREET,01,A2,"VILLARREAL, VICTOR",2,1,1
16266,5031840026,SI,46 COLUMBUS AVENUE,01,A9,HUIMEI CHI,2,1,1
16267,5032470043,SI,65 KENSINGTON AVENUE,01,A2,"LAMPERTI, DOLORES",2,1,1
16268,5032480030,SI,222 MALLORY AVENUE,01,A5,"ZHANG, SHU PIAO",2,1,1
16269,5032690079,SI,40 HICKORY AVENUE,01,A2,"PIGOTT, THOMAS JOSEPH",2,1,1
16270,5033060032,SI,62 SEAVIEW AVENUE,01,A1,"RU LIU, HAI",2,1,1
16271,5034120070,SI,67 PEARSALL STREET,01,A2,CHARLES T. SMITH AND MARY V. SMITH IRREV  TRUST,2,1,1
16272,5037350012,SI,192 MORELAND STREET,01,A5,"TKACHENKO, ROMAN",2,1,1
16273,5038040004,SI,565 LINCOLN AVENUE,01,A1,JOHN MALDONADO,2,1,1
16274,5038340009,SI,667 QUINCY AVENUE,01,A3,MARIAMI LEJAVA,2,1,1
16275,5038730010,SI,812 PATTERSON AVENUE,01,A6,"SALIHI, BUSNIK",3,2,1
16276,5038930105,SI,958 PATTERSON AVENUE,09,Q7,OCEANWOODS CONDOMINIUM,2,1,1
16277,5040650015,SI,28 HETT AVENUE,01,B3,"ZEE CHAN, JACKIE",2,1,1
16278,5040790032,SI,7 WATERSIDE STREET,01,B2,RICHARD MALCHIODI,3,2,1
16279,5055150066,SI,72 BARTLETT AVENUE,01,A2,SUSANNE KULLMAN,2,1,1
16280,5055230034,SI,301 GENESEE AVENUE,01,A1,"JOHANSEN, STEPHANIE",2,1,1
16281,5060500083,SI,407 HUGUENOT AVENUE,01,B1,MICHELE PALAZZO,2,1,1
16282,5062320004,SI,259 JEFFERSON BOULEVARD,04,S1,"PACCHIANO, MARK A",2,1,1
16283,5065840010,SI,82 PRALL AVENUE,01,A1,"DELUZIO, LISA",2,1,1
16284,5066750007,SI,201 SEGUINE AVENUE,01,A1,"CAPUTO, ANTHONY",2,1,1
16285,5066810074,SI,5780 AMBOY ROAD,01,A1,"INZONE, JOSEPH",2,1,1
16286,5066940233,SI,187 TRENTON COURT,01,A1,SANDCASTLE MGMT. COPR,2,1,1
16287,5067500075,SI,104 EXCELSIOR AVENUE,01,B2,MARINOAND ROSA LONGGETTI,2,1,1
16288,5067510011,SI,19 EXCELSIOR AVENUE,01,A0,"ROBERT L. MALLIEN, TRUSTEE",3,2,1
16289,5068350005,SI,678 HUGUENOT AVENUE,01,B2,GURBINDER P SINGH,2,1,1
16290,5068750065,SI,795 LAMONT AVENUE,01,B2,"THREE BOBBES,LLC",2,1,1
16291,5077750126,SI,44 OTTAVIO PROMENADE,01,A3,"GENTILE, TRUSTEE, JOHN",2,1,1
16292,5078210001,SI,25 JOLINE AVENUE,01,A1,KONSTANTINOS & IRENE TSOUKAS,3,2,1
16293,5078410045,SI,141 SPRAGUE AVENUE,01,B3,MIGNOSI JOSEPH,2,1,1
16294,5078930010,SI,374 SLEIGHT AVENUE,01,A1,GLEN A MIDBO,2,1,1
16295,5080030006,SI,5477 ARTHUR KILL ROAD,01,B2,PATRICIA & VICTOR YANNOTTA,2,1,1
16296,5080340041,SI,27 HALE STREET,01,A1,GRACE M THAISZ,2,1,1
16297,5080440059,SI,222 WOOD AVENUE,01,A1,"TEPEDINO, VINCENT MICHAEL",2,1,1
16298,1000390001,MN,82 WALL STREET,05,O6,"88 WALL STREET LLC, A DELAWARE LLC",2,1,1
16299,1003860008,MN,51 AVENUE B,04,S2,45-51 AVENUE B LLC,2,1,1
16300,1005400036,MN,171 BLEECKER STREET,04,C7,171 BLEECKER ST. CORP,2,1,1
16301,1005810054,MN,16 CLARKSON STREET,08,W3,NYC DEPARTMENT OF EDUCATION,2,1,1
16302,1007340016,MN,429 WEST 36 STREET,06,E9,EXG 430W37LLC,2,1,1
16303,1007990003,MN,229 7 AVENUE,03,D9,"GS CHELSEA PROPERTY OWNER, LLC",3,2,1
16304,1008590060,MN,32 EAST 30 STREET,04,K4,"33 EAST 29TH STREET NY OWNER, LLC",2,1,1
16305,1010180057,MN,256 WEST 47 STREET,05,J4,CLARENCE PROPERTY LL,2,1,1
16306,1010960026,MN,605 WEST 48 STREET,04,K4,605 WEST 48TH ST. LLC,2,1,1
16307,1011860059,MN,321 WEST 78 STREET,03,D4,321 WEST 78TH STREET CORP,2,1,1
16308,1012000019,MN,21 WEST 86 STREET,04,D7,BREWSTER 2016 LLC,2,1,1
16309,1012950033,MN,622 3 AVENUE,05,O4,622 THIRD AVE. CO. LLC,2,1,1
16310,1013850001,MN,895 5 AVENUE,08,P7,THE FRICK COLLECTION,3,2,1
16311,1020250016,MN,233 WEST 139 STREET,01,A4,"MYERS, JANE L",2,1,1
16312,1021140026,MN,520 WEST 156 STREET,02,C1,WEST 156 HOLDING LLC,2,1,1
16313,1022150439,MN,118 WEST 227 STREET,02,C0,"HERRERA, DOMITILA RAMALE",2,1,1
16314,1022260041,MN,186 SHERMAN AVENUE,08,W1,NYC SCHOOL CONSTRCTION AUTHORTY,2,1,1
16315,2023070010,BX,362 EAST 146 STREET,04,S2,"YENGHY, LLC",2,1,1
16316,2023400116,BX,2660 PARK AVENUE,04,K4,"FBL REALTY, LLC",2,1,1
16317,2024780030,BX,80 MCCLELLAN STREET,03,D1,ANNAL  MANAGEMENT CO LTD,2,1,1
16318,2025650054,BX,746 EAST 137 STREET,01,B1,ARENA JOHN,2,1,1
16319,2025950001,BX,106 LOCUST AVENUE,,Z9,NYC DEPARTMENT OF GENERAL SERVICES,6,5,1
16320,2026140038,BX,1191 BOSTON ROAD,03,D1,BOSTON ROAD II HOUSING DEVELOPMENT FUND  CORPORATIO,2,1,1
16321,2027070049,BX,762 BECK STREET,02,C0,"WILLOUGHBY, AARON J",2,1,1
16322,2027590045,BX,1365 BRUCKNER BOULEVARD,07,G9,U-HAUL INTNL INC,2,1,1
16323,2027690134,BX,520 LONGFELLOW AVENUE,06,E1,J.J. & A. REALTY CORP,2,1,1
16324,2027750085,BX,324 BRYANT AVENUE,06,F4,M.S.T. RANDALL LLC,2,1,1
16325,2031860108,BX,2265 WALTON AVENUE,02,C0,"GONZALEZ, JULIAN",2,1,1
16326,2032840021,BX,363 EAST 198 STREET,01,B3,"WILLIAMS, OCTAVIO M",2,1,1
16327,2033560036,BX,3540 KINGS COLLEGE PLACE,08,W1,NYC DEPARTMENT OF EDUCATION,2,1,1
16328,2033640001,BX,3 EAST 236 STREET,01,B2,"MCCONNAUGHEY, OROSIAPAULINA",2,1,1
16329,2035200051,BX,555 ST LAWRENCE AVENUE,01,B3,"AREIZAGA, ANGEL",2,1,1
16330,2035310191,BX,515 OLMSTEAD AVENUE,01,B2,"MARTINEZ, WANDA",2,1,1
16331,2037980053,BX,2067 CHATTERTON AVENUE,01,A5,PALAFOX DEMETRIA,2,1,1
16332,2039720043,BX,1556 PARKER STREET,02,C0,"CEDENO, JULIAN R",2,1,1
16333,2040610021,BX,1005 SACKET AVENUE,01,B2,ERICA LABOY,3,2,1
16334,2041300011,BX,1849 HAIGHT AVENUE,01,A1,ANTHONY R SEDIA,2,1,1
16335,2041400006,BX,1432 BLONDELL AVENUE,10,G1,BLONDELL HOLDINGS CORP.,2,1,1
16336,2041770053,BX,1752 MAHAN AVENUE,01,B1,PAGNOTTA  ROSANNA,2,1,1
16337,2041910026,BX,1870 MULFORD AVENUE,01,A1,"DEB ASSETS, INC.",2,1,1
16338,2042430018,BX,2856 EAST 197 STREET,02,C0,"GEGA, PHILIP  J",2,1,1
16339,2044100010,BX,2310 DELANOY AVENUE,01,B1,GINA O. MARAIA,2,1,1
16340,2045190009,BX,2716 HONE AVENUE,01,B1,"ZHENG, ZHENG JING",2,1,1
16341,2045530019,BX,2942 RADCLIFF AVENUE,01,A9,"ALTIERI, VINCENT",2,1,1
16342,2046460028,BX,3644 OLINVILLE AVENUE,02,C0,"STONE, HORTENSE",2,1,1
16343,2046610088,BX,749 EAST 213 STREET,01,B1,1720 NY LLC,2,1,1
16344,2046640084,BX,758 EAST 217 STREET,02,C3,SEABROOK LAVERNE,2,1,1
16345,2046650175,BX,730 EAST 218 STREET,02,C0,"HUANG, GONG LIN",2,1,1
16346,2046730034,BX,815 EAST 214 STREET,01,B2,MARY EDWARDS,2,1,1
16347,2046910054,BX,934 EAST 221 STREET,01,B3,JENNINGS VERONICA,2,1,1
16348,2047180018,BX,1438 OAKLEY STREET,01,B9,"SHAW, LOLA C",2,1,1
16349,2047870051,BX,2814 KINGSLAND AVENUE,01,A2,MARLON MCKAY,2,1,1
16350,2047960005,BX,2941 GRACE AVENUE,01,A2,"NELSON, DORIS M",2,1,1
16351,2048270085,BX,684 EAST 226 STREET,02,C0,"GRANT, EARL",2,1,1
16352,2048330017,BX,683 EAST 230 STREET,01,B1,LINTON ALENE,2,1,1
16353,2048590034,BX,909 EAST 223 STREET,02,C0,TODMAN ANTHONY,2,1,1
16354,2049620031,BX,3974 AMUNDSON AVENUE,01,B2,MICHAEL PLUMMER,2,1,1
16355,2049800052,BX,4085 EDSON AVENUE,10,G0,"SORIANO, SEBASTIAN",2,1,1
16356,2050250031,BX,4220 WILDER AVENUE,01,A1,"COLEMAN, AISHAH",2,1,1
16357,2050780061,BX,4621 CARPENTER AVENUE,02,C0,MOHANI PRASAD,2,1,1
16358,2054110216,BX,1542 MACDONOUGH PLACE,01,A1,"MACRINO, VINCENT",2,1,1
16359,2054850062,BX,629 CLARENCE AVENUE,01,B2,MARY MEADE,2,1,1
16360,2056260234,BX,63 PELL PLACE,01,A2,JILL LAFONTAINE AS TRUSTEE,2,1,1
16361,2056280005,BX,4 CAROLL STREET,01,A1,FITZGERALD CLAIRE E,2,1,1
16362,2058821115,BX,6112 SPENCER AVENUE,02,C0,BRENDAN O'SULLIVAN,2,1,1
16363,3001200020,BK,49 FLATBUSH AVENUE EXT,08,W9,NYC DEPARTMENT OF EDUCATION,2,1,1
16364,3002750041,BK,140 STATE STREET,02,C0,"140 STATE STREET, LLC",2,1,1
16365,3003630017,BK,34 WOODHULL STREET,02,C0,"MASTRIANO, DEBRA",2,1,1
16366,3003740048,BK,149 LUQUER STREET,02,C0,DOMENICO DI MEGLIO,2,1,1
16367,3003760043,BK,113 NELSON STREET,02,C0,"VILLELLA, DOMINICK",2,1,1
16368,3003990037,BK,506 WARREN STREET,04,S5,"NEVINS PLAZA, LLC",2,1,1
16369,3004670022,BK,130 3 PLACE,02,C0,"POLITI, JOSEPH",2,1,1
16370,3005310034,BK,86 PIONEER STREET,01,B9,"GALLAGHER, ELLEN",2,1,1
16371,3006120205,BK,790 COLUMBIA STREET,06,E1,ERIE BASIN MARINE ASSOCIATES,6,5,1
16372,3006650046,BK,213A 29 STREET,01,B9,HRONEC MARIAN,2,1,1
16373,3006770052,BK,199 32 STREET,02,C0,"FELICIANO, SAMUEL",2,1,1
16374,3007230025,BK,346 42 STREET,08,M1,ST MICHAELS RC CH,5,4,1
16375,3008730035,BK,292 17 STREET,01,B2,"MICHAEL, PETER",2,1,1
16376,3008730052,BK,293 18 STREET,01,B2,"EHRENBERG, STUART",2,1,1
16377,3008860016,BK,316 19 STREET,02,C0,"MANDEL, KEVIN",2,1,1
16378,3010340058,BK,219 14 STREET,01,B2,"BASU, TONUCA",2,1,1
16379,3010520026,BK,140 16 STREET,01,B3,THE ROOKMIN SEWNARINE IRREVOCABLE TRUST,2,1,1
16380,3011630001,BK,520 PROSPECT PLACE,08,I6,"PROSPECT ACQUISITION II, LLC",2,1,1
16381,3012270053,BK,857 PROSPECT PLACE,02,C2,"TAYLOR, KEVIN",2,1,1
16382,3012800036,BK,1594 BEDFORD AVENUE,08,M1,EBENEZER BAPTIST CHURCH,2,1,1
16383,3012980012,BK,360 CROWN STREET,01,A4,"LUSTIG ELGRABLY, ESTHER",2,1,1
16384,3012990035,BK,472 CROWN STREET,01,B1,LAKIN-ATKINS ETHEL C,2,1,1
16385,3013100051,BK,489 EMPIRE BOULEVARD,08,M1,CHEVRA AHA ACHIM,2,1,1
16386,3013990018,BK,1324 EASTERN PARKWAY,01,B2,"LEATH, MARY  A",2,1,1
16387,3014020069,BK,1641 PRESIDENT STREET,01,B1,STERNA KELLER,2,1,1
16388,3014140067,BK,743 CROWN STREET,02,C3,"LAINE, MASHA",2,1,1
16389,3015160002,BK,89 THOMAS S BOYLAND ST,09,Q2,NYC DEPARTMENT OF PARKS AND RECREATION,2,1,1
16390,3015310155,BK,9A HULL STREET,02,C0,UNAVAILABLE OWNER,2,1,1
16391,3015340048,BK,187 HULL STREET,02,C2,THELMA WALTHOUR,2,1,1
16392,3015530008,BK,2224 FULTON STREET,02,C0,2218 FULTON STREET LLC,2,1,1
16393,3016320054,BK,937 GATES AVENUE,02,C0,"SHINN, DAVID A",2,1,1
16394,3017820010,BK,844 DEKALB AVENUE,05,K1,"CHEYENNE REALTY    ,",3,2,1
16395,3018600072,BK,69 HERKIMER STREET,01,B2,"SONGUI, DAVID",2,1,1
16396,3018670088,BK,1247 ATLANTIC AVENUE,04,D7,1247 M&F MANAGEMENT LLC,3,2,1
16397,3018980055,BK,120 FRANKLIN AVENUE,01,B2,"PANETH, YOSEF",2,1,1
16398,3019530071,BK,303 GREENE AVENUE,02,C3,"PRINCE, EVELYN",2,1,1
16399,3021020059,BK,324 CARLTON AVENUE,02,C0,"MASON, YVONNE A",2,1,1
16400,3022340053,BK,227 LYNCH STREET,02,C0,CHOICE EQUITIES LLC,2,1,1
16401,3022400012,BK,50 MIDDLETON STREET,02,C3,"GOLDMAN, PEARL",2,1,1
16402,3023900036,BK,49 SOUTH 1 STREET,02,C3,GREGDOM LLC,2,1,1
16403,3024210035,BK,247 SOUTH 3 STREET,03,D9,GROWER-GREEN HOUSING DEVELOPMENT FUND CO RPORATION,2,1,1
16404,3026080025,BK,381 KINGSLAND AVENUE,05,J6,KINGSLAND 359 LLC,2,1,1
16405,3026850054,BK,34 DIAMOND STREET,01,B3,"SKORDZKA, MONIKA",2,1,1
16406,3027240025,BK,447 MEEKER AVENUE,02,C1,447 MEEKER LLC,2,1,1
16407,3027310016,BK,26 RICHARDSON STREET,02,C2,RICHARDSON LOFTS LLC,2,1,1
16408,3027760032,BK,147 POWERS STREET,02,C0,LERA MANAGEMENT LLC,2,1,1
16409,3030740001,BK,328 JOHNSON AVENUE,06,F4,BOERUM JOHNSON AVE ASSOC,2,1,1
16410,3031060006,BK,74 GRAHAM AVENUE,04,S2,"74 GRAHAM AVENUE, LLC",2,1,1
16411,3031880018,BK,360 TROUTMAN STREET,06,F4,MATLOG REALTY CORP,3,2,1
16412,3032140033,BK,497 HART STREET,01,B3,"EBERT, REBECCA",2,1,1
16413,3032810015,BK,376 HIMROD STREET,02,C0,"RODRIGUEZ, ROMEO",2,1,1
16414,3035570022,BK,180 BLAKE AVENUE,08,M9,MOUNTAIN OF FIRE & MIRACLES MINISTRIES I NC.,2,1,1
16415,3036100054,BK,500 AMBOY STREET,01,B1,"PAUL, ROGER",2,1,1
16416,3039400022,BK,2971 FULTON STREET,07,G2,ARVERNE MEWS BY THE SEA LLC,2,1,1
16417,3039430007,BK,3049 FULTON STREET,01,B2,PERUMAL SONNY,2,1,1
16418,3039720012,BK,259 ESSEX STREET,08,M4,ST RITAS RC CH,4,3,1
16419,3040500039,BK,995 BLAKE AVENUE,01,A5,"MORRISON, RUTH",2,1,1
16420,3041680005,BK,343 CRESCENT STREET,11,V0,NY REALTY ENTERPRISES PLUS CORP.,2,1,1
16421,3041930007,BK,395 CHESTNUT STREET,01,A1,"CORTEZ, HUGO L",2,1,1
16422,3046730001,BK,676 LINDEN BOULEVARD,08,W1,NYC DEPARTMENT OF EDUCATION,2,1,1
16423,3048800014,BK,826 TROY AVENUE,01,B2,"MCPHERSON, LEOTHA V",2,1,1
16424,3048860053,BK,43 EAST 32 STREET,01,B3,"DILLON, SEAN",2,1,1
16425,3049520042,BK,3521 AVENUE D,01,A9,DEUTSCHE BANK NATIONAL TRUST COMPANY,2,1,1
16426,3050850075,BK,211 LINDEN BOULEVARD,03,D1,221 LINDEN PROPERTY LLC,3,2,1
16427,3050890071,BK,2211 CHURCH AVENUE,05,O5,2211 CHURCH AVE. REALTY LLC,2,1,1
16428,3051430003,BK,1208 BEVERLEY ROAD,01,B2,"KRAININ, DANIEL M",2,1,1
16429,3052810026,BK,89 EAST 2 STREET,01,B2,"CHINO, FERMIN",2,1,1
16430,3053040069,BK,3554 12 AVENUE,01,A2,"LOWINGER, SAMUEL",2,1,1
16431,3053590061,BK,411 EAST 7 STREET,01,A1,"MCDONAGH, EILEEN",2,1,1
16432,3053650054,BK,1555 40 STREET,01,B1,SCHWARTZ CZIPI,2,1,1
16433,3053930005,BK,910 CORTELYOU ROAD,07,G2,HI TECH EQUIPMENT RENTAL AND SALES CORP,2,1,1
16434,3054270068,BK,315 FOSTER AVENUE,02,C1,"315 FOSTER AVENUE, LLC",2,1,1
16435,3054320045,BK,4412 17 AVENUE,01,B1,HOROWITZ SHLOMO,2,1,1
16436,3054340024,BK,1644 45 STREET,01,A9,"BRECHER, MENDEL",2,1,1
16437,3054740052,BK,1871 53 STREET,01,A1,DAVID SPORN,2,1,1
16438,3054810073,BK,1929 54 STREET,01,A5,"BRACH, ELIAS",3,2,1
16439,3054850027,BK,1652 54 STREET,01,B2,"FRIEDMAN, DAVID T.",2,1,1
16440,3054890081,BK,1617 56 STREET,01,A9,GITTY MILLER,2,1,1
16441,3054917506,BK,1520 56 STREET,02,R6,UNAVAILABLE OWNER,2,1,1
16442,3055280035,BK,2068 61 STREET,01,B1,"MOLLANO, SAL",2,1,1
16443,3055280040,BK,2078 61 STREET,01,A9,"SCHWARTZ, DAVID",2,1,1
16444,3056150052,BK,1169 46 STREET,08,M9,BINYAN SHEL CHESSED,2,1,1
16445,3056380069,BK,917 50 STREET,02,C0,JOSEPH FRANKOVITS CORP.,2,1,1
16446,3056560042,BK,5110 14 AVENUE,01,B3,"GONEN, JANINA",2,1,1
16447,3056640023,BK,1450 52 STREET,02,C0,"ELI MENDLOWITZ, AS TRUSTEE",2,1,1
16448,3056750058,BK,1153 55 STREET,01,B1,"MAJOR SUPPLY, LLC",2,1,1
16449,3057030057,BK,1139 59 STREET,02,C0,"LLIGUICHUSHCA, CARME",2,1,1
16450,3057170013,BK,1108 60 STREET,05,H9,VERTU ROC LLC,2,1,1
16451,3057180016,BK,1260 60 STREET,05,K6,F I ASSOCIATES,3,2,1
16452,3057330053,BK,1361 63 STREET,02,C0,KIM WU AS TRUSTEE,2,1,1
16453,3058550046,BK,6742 5 AVENUE,04,S2,"YAM, OI KWOK",2,1,1
16454,3059740023,BK,1042 78 STREET,01,A5,PATRICK ACETO,2,1,1
16455,3059770039,BK,7904 RIDGE BOULEVARD,02,C0,"PANAGOPOULOS, PEGGY",2,1,1
16456,3060430022,BK,238 86 STREET,04,S2,238 86TH STREET REALTY LLC,2,1,1
16457,3060640041,BK,359 90 STREET,01,B1,90TH STREET PROPERTY LLC,2,1,1
16458,3061420065,BK,208 BATTERY AVENUE,01,B1,MARGARET LI CAUSI,2,1,1
16459,3061420079,BK,248 BATTERY AVENUE,01,A5,"YAFAI, MOHAMED",2,1,1
16460,3061670033,BK,1366 70 STREET,01,B1,ARSENAL BROTHERS LLC,2,1,1
16461,3061980065,BK,1131 74 STREET,01,B2,EVA BUONIN CONTRI,2,1,1
16462,3062210046,BK,7522 13 AVENUE,04,S1,"GIRASOLE, RICHARD",2,1,1
16463,3062230060,BK,1445 76 STREET,01,A9,"FONG, CHRISTINE W.Y.",2,1,1
16464,3063330022,BK,1938 84 STREET,02,C0,PI YUN TSOU,2,1,1
16465,3063370034,BK,1170 85 STREET,01,A1,"DILEO, JOHN",2,1,1
16466,3063380030,BK,1260 85 STREET,01,B3,"PENA, JOVANNY",2,1,1
16467,3063630064,BK,48 BAY 13 STREET,01,B1,"ZHAO, LI YI",2,1,1
16468,3064480026,BK,8779 BAY PARKWAY,07,G5,JOAN R. DAVIDSON TRUST,2,1,1
16469,3065280008,BK,720 AVENUE J,01,A1,HARARY MAX,2,1,1
16470,3065280015,BK,1034 EAST 8 STREET,01,A3,"SASSON, SAMANTHA",2,1,1
16471,3065290067,BK,1059 EAST 8 STREET,01,A3,"ADES, ROCHELLE",2,1,1
16472,3065690011,BK,624 AVENUE M,01,B1,"LERNER, LEO",2,1,1
16473,3066090026,BK,1642 EAST 3 STREET,01,B2,"1642 ASSOCIATES, LLC",2,1,1
16474,3066130077,BK,1543 OCEAN PARKWAY,01,A3,"ZAAFARANI, SARINE",2,1,1
16475,3066230033,BK,1664 WEST 8 STREET,01,B3,"PENNINO, MANDALENA",2,1,1
16476,3066340070,BK,1699 EAST 2 STREET,01,A1,"KROUB, GASTON",2,1,1
16477,3066390045,BK,717 QUENTIN ROAD,01,A9,"BERSHATSKY, ABBE",2,1,1
16478,3066600030,BK,1834 EAST 4 STREET,01,B2,SUTTON RACHEL,2,1,1
16479,3066630017,BK,1808 EAST 7 STREET,01,B2,FARAH ABE,2,1,1
16480,3066810214,BK,1889 EAST 2 STREET,01,B1,CHARLOTTE ZETOONEY,2,1,1
16481,3067050050,BK,1203 AVENUE J,05,O5,BRL REALTY LLC,3,2,1
16482,3067900011,BK,1632 EAST 28 STREET,01,A1,"SCHWARTZ, MICHAEL B",2,1,1
16483,3068850011,BK,67 27 AVENUE,02,C0,"SBANO, THERESE",2,1,1
16484,3070910119,BK,929 HUTCHINSON COURT,01,B3,"FAKS, YOUSSEF",2,1,1
16485,3071010028,BK,2044 WEST 4 STREET,02,C0,"LOO, YI GUANG",2,1,1
16486,3071040520,BK,2059 EAST 1 STREET,01,A5,"BOTTON , SAMUEL",2,1,1
16487,3071080060,BK,2129 EAST 5 STREET,01,B2,"DECK, ISAAC",2,1,1
16488,3071090076,BK,2033 OCEAN PARKWAY,01,A1,"ABED, JOSEPH",2,1,1
16489,3071180016,BK,2124 WEST 8 STREET,01,B3,MIGNOLE FRANCO,3,2,1
16490,3071230035,BK,2288 MCDONALD AVENUE,06,F5,2288 MCDONALD AVENUE LLC,2,1,1
16491,3071300022,BK,2196 EAST 4 STREET,01,A5,DOUGLAS HABER,2,1,1
16492,3071560046,BK,447 AVENUE W,01,A1,"DWECK, STEVEN",2,1,1
16493,3071590080,BK,2259 EAST 7 STREET,01,A9,"ABBOUDI FARHI, SUZI",2,1,1
16494,3071800077,BK,455 AVENUE X,01,B1,"MEHANI, JACQUES",2,1,1
16495,3071840038,BK,93 LANCASTER AVENUE,01,A1,"LEVY, JOEY",2,1,1
16496,3071840041,BK,83 LANCASTER AVENUE,01,B1,"SERIEH, SALIM",2,1,1
16497,3071840054,BK,57 LANCASTER AVENUE,01,A1,"ALHAKIM, NORI",2,1,1
16498,3072010057,BK,66 PARKWAY COURT,01,A5,"ALHALABI, SAMI",3,2,1
16499,3072950031,BK,1960 EAST 17 STREET,01,B2,DAVID KUBRESI,2,1,1
16500,3075740002,BK,2821 AVENUE I,01,B2,"HERBSTMAN, SARA",2,1,1
16501,3076440016,BK,1267 EAST 26 STREET,01,A1,"DAYAN, MARLENE",2,1,1
16502,3076580070,BK,1344 EAST 23 STREET,01,A1,"MINZER, NAFTALI",2,1,1
16503,3076810032,BK,1441 EAST 27 STREET,01,B3,MIRIAM EISENBERG QUALIFIED PER RES TRUST  #1,2,1,1
16504,3077390064,BK,894 EAST 56 STREET,01,A1,DYRICK JOHN,3,2,1
16505,3077440072,BK,1744 ALBANY AVENUE,01,B3,"EDMUND, JOSEPH B",2,1,1
16506,3077540017,BK,1683 UTICA AVENUE,04,K4,PILO PROPERTIES CORP.,3,2,1
16507,3077880006,BK,4007 AVENUE K,01,B2,"EDWARDS, REBECCA",2,1,1
16508,3078010011,BK,1319 EAST 53 STREET,01,B1,SOARES MIGUEL,5,4,1
16509,3078730005,BK,4813 AVENUE N,04,K4,UNAVAILABLE OWNER,2,1,1
16510,3079010071,BK,1462 EAST 57 STREET,01,A9,"BAIN, MARIE J",2,1,1
16511,3020300006,BK,37 CUMBERLAND STREET,,Z9,"37 CUMBERLAND HOLDING, LLC",0,1,-1
16512,2056260304,BX,65 EARLEY STREET,01,B2,"KISS, ELIZABETH",1,2,-1
16513,5054200101,SI, MAYBERRY PROMENADE,11,V0,A ROMI COHN,0,1,-1
16514,3061870001,BK,1101 73 STREET,01,B1,ANNA MARIA SANGES,2,3,-1
16515,4089610035,QN,82 STREET,11,V0,ANWAR ADIL,0,1,-1
16516,4089740256,QN,92 STREET,11,V0,ALBUJA JOHNNY,0,1,-1
16517,3022420053,BK,153 LORIMER STREET,02,C0,LORIMER PARTNERS LLC,0,1,-1
16518,3063340029,BK,2064 84 STREET,01,B1,"WAN CHIN, LAI",1,2,-1
16519,5056750065,SI,30 LORING AVENUE,01,A5,REGINA BONAVENTURA,1,2,-1
16520,5008490045,SI,31 VISTA AVENUE,01,B3,ANTHONY ORSO,2,3,-1
16521,5008530033,SI, OVERLOOK AVENUE,11,V0,"SWEENEY, PHILLIP B",0,1,-1
16522,5010060028,SI, PARK AVENUE,07,U6,NYC ECONOMIC DEVELOPMENT CORPORATION,0,1,-1
16523,4117160127,QN,122 PLACE,10,G0,"RASIAWAN, JAY",0,1,-1
16524,4119460083,QN,108 AVENUE,11,V0,ABDOOL H KARIMBASKII,0,1,-1
16525,5007340063,SI,477 INGRAM AVENUE,01,A5,"SKOPP, MARSHALL S",1,2,-1
16526,3042130016,BK,1024 GLENMORE AVENUE,02,C1,MHANY 2011 HOUSING DEVELOPMENT FUND CORP ORATION,7,8,-1
16527,3071670025,BK, BOYNTON PLACE,11,V0,LOUIS J VINGELLI,0,1,-1
16528,5010500147,SI,96 CATHERINE STREET,01,A1,"CHEN HE, JIAN",0,1,-1
16529,3009310006,BK,5 AVENUE,11,V1,LFR REALTY CORP,0,1,-1
16530,2030040046,BX,1893 LONGFELLOW AVENUE,01,B9,"HANASAB, SAMIEL",1,2,-1
16531,4119650119,QN,111-19 148 STREET,01,A5,BUSH  DENNIS E,1,2,-1
16532,5078570080,SI,1 HYLAN BOULEVARD,09,Q9,NYC DEPARTMENT OF PARKS AND RECREATION,0,1,-1
16533,3046830141,BK,EAST 57 STREET,11,V0,SHERMAN CHURCH AVE,0,1,-1
16534,5011270164,SI,50 INNIS STREET,01,B2,"MEJIA, RIGOBERTO",0,1,-1
16535,4082720012,QN, LAKEVIEW AVENUE,10,G0,DANIEL LEVI,0,1,-1
16536,5011320041,SI,480 VILLA AVENUE,01,A1,"PAUL-BAZIL, KURT",0,1,-1
16537,3048620034,BK,535 LINDEN BOULEVARD,01,B2,KING WINSTON E,1,2,-1
16538,3050260051,BK, LINCOLN ROAD,07,U8,NYC TRANSIT AUTHORITY,0,1,-1
16539,1017750003,MN,1845 PARK AVENUE,10,G6,"1775 TP4 HOUSING DEVELOPMENT FUND COMPAN Y, INC.",0,1,-1
16540,4120150324,QN,142 PLACE,10,G0,"GOWINS, SELESHA",0,1,-1
16541,5080500094,SI,162 BENTLEY STREET,01,A1,EDWARD DONOHUE,1,2,-1
16542,3081270084,BK,907 EAST 94 STREET,01,B2,COURTNEY GREGORY,2,3,-1
16543,3081640037,BK, FARRAGUT ROAD,11,V0,NIGRO JOANNE,0,1,-1
16544,2032470165,BX,250 BEDFORD PARK BL WEST,08,W5,CITY UNIVERSITY CONSTRUCTION FUND,1,2,-1
16545,5012080024,SI,3245 RICHMOND TERRACE,07,T9,EGRET REALTY CORP,1,2,-1
16546,4142551771,QN,165 AVENUE,11,V0,"MCGUIGAN, THOMAS",0,1,-1
16547,1003450001,MN,148 ATTORNEY STREET,03,D8,148 PARTNERS LLC,0,1,-1
16548,5011720244,SI,235 DIXON AVENUE,01,A1,"RUFFIN, SHAWN L",0,1,-1
16549,4082450114,QN,53-05 MORENCI LANE,01,A0,VITO & HELEN LEFEMINE,1,2,-1
16550,3055370006,BK,15 AVENUE,07,U7,NYC TRANSIT AUTHORITY,0,1,-1
16551,4153040003,QN,325 CROSS BAY BOULEVARD,11,V0,"GILL, ROBERT",2,3,-1
16552,5012460073,SI,234 HARBOR ROAD,01,A1,"HOPPIE-DUNCAN, TAMESHA",1,2,-1
16553,1003850002,MN,21 AVENUE B,04,C7,21/23 AVENUE B REALTY LLC,1,2,-1
16554,4153760037,QN,312 CROSS BAY BOULEVARD,01,A1,"MCCAMBRIDGE, JOHN T.",1,2,-1
16555,3079320277,BK, PRESTON COURT,,Z9,1011 EAST 46TH STREET,0,1,-1
16556,3017680072,BK,157 HART STREET,02,C0,BIG SHADE TREE LLC.,1,2,-1
16557,5002510043,SI,236 HART BOULEVARD,01,A1,"MCCARTHY, JOHN L",1,2,-1
16558,3087530042,BK,120 KENSINGTON STREET,01,A1,ALEXANDER PINKUSOVICH,1,2,-1
16559,3017910070,BK,35 VAN BUREN STREET,11,V0,WAZOBIA HOUSE HOUSING DEVELOPMENT FUND C ORPORATION,0,1,-1
16560,3088561853,BK,1 OPAL COURT,01,A1,"LI, XIAO SHENG",1,2,-1
16561,3083690405,BK,1353 EAST 69 STREET,01,B2,"MARGOLIN, ALEXANDER",1,2,-1
16562,3054977509,BK,1634 57 STREET,02,R6,UNAVAILABLE OWNER,0,1,-1
16563,4158350034,QN,342 BEACH 45 STREET,01,A1,STONE NATALIE,1,2,-1
16564,2055920118,BX,2820 COLLIS PLACE,01,A5,"GLASHEEN, DOLORES",1,2,-1
16565,5011650014,SI,165 SIMONSON AVENUE,01,B2,"LUGO, RACHEL",1,2,-1
16566,4159050072,QN,194 SEA GRASS LANE,01,B2,"MAO, KRISTOPHER KUNBO",1,2,-1
16567,4004900100,QN,1 STREET,09,Q1,NYC DEPARTMENT OF PARKS AND RECREATION,0,1,-1
16568,5010790005,SI, HARRISON AVENUE,11,V0,UNAVAILABLE OWNER,0,1,-1
16569,5017170070,SI, MORROW STREET,11,V1,BIG MORROW LLC,0,1,-1
16570,5019920075,SI,111 MC DIVITT AVENUE,01,A5,"MIERZWA, MISOLAW",1,2,-1
16571,2055180292,BX,3129 WISSMAN AVENUE,01,B1,UNAVAILABLE OWNER,2,3,-1
16572,3022420045,BK,169 LORIMER STREET,11,V1,169 LORIMER LLC,0,1,-1
16573,5023060128,SI,79 MEISNER AVENUE,01,A0,M P THOMPSON,1,2,-1
16574,5007130027,SI,109 MOUNTAINVIEW AVENUE,01,A1,"HEUVEL, JOHN VANDEN",1,2,-1
16575,4159050077,QN,191 BEACH 62 STREET,01,B2,"TOBAR, ARTURO T",1,2,-1
16576,1016800032,MN,334 EAST 109 STREET,05,GW,2113 FIRST AVENUE LLC,1,2,-1
16577,2050210015,BX,4134 DE REIMER AVENUE,11,V0,RUBEN M AUGUSTA,0,1,-1
16578,4008790151,QN,24 STREET,11,V0,"GAVALAS, ELEFTHERIA",0,1,-1
16579,5028310172,SI,5 KEELEY STREET,01,A1,ROBERT RUFFO,1,2,-1
16580,5028440071,SI,60 LYNHURST AVENUE,01,A1,"ZHENG, ZHEN",0,1,-1
16581,5028580026,SI,22A WHITE STREET,10,G0,P MATTIOLA,1,2,-1
16582,5006990014,SI, LINCOLN STREET,10,G7,MANOR ROAD ASSOC LLC,0,1,-1
16583,5008240096,SI,14 LARRISON LOOP,01,B2,"BALILA, DALIT",1,2,-1
16584,4012280026,QN,39-41 57 STREET,10,G0,ARMAAN HOLDINGS LLC,0,1,-1
16585,5028980024,SI,661 ELBE AVENUE,01,A5,ELBE AVENUE LLC,0,1,-1
16586,4013280067,QN,41-26 58 STREET,08,M9,GREATER NEW YORK CORPORATION OF SEVENTH  DAY ADVENT,2,3,-1
16587,4082320391,QN,249-39 RUSHMORE TERRACE,01,A2,GRILLO FAMILY TRUST,2,3,-1
16588,5007400050,SI,33 ARDMORE AVENUE,01,A2,THOMAS J KENNEDY III,1,2,-1
16589,3057300018,BK,62 STREET,11,V0,JIAN LING HE,0,1,-1
16590,3064410034,BK,1970 BATH AVENUE,10,G0,JULIET R SKYERS       #A,0,1,-1
16591,4014850037,QN,40-30 75 STREET,04,D7,KING HENRY APTS LLC,1,2,-1
16592,5030030012,SI,168 HOPE AVENUE,01,A1,DEROSS LUCILLE,1,2,-1
16593,4009750034,QN,21-62 80 STREET,01,B1,CELESTE BRAVIN,1,2,-1
16594,1014890037,MN,508 EAST 78 STREET,02,C6,CHEROKEE OWNERS CORP,2,3,-1
16595,2048570005,BX,4179 BRONXWOOD AVENUE,,Z9,CASA FAMILY LIMITEDPARTNERSHIP,0,1,-1
16596,4125880061,QN,140-40 171 STREET,01,A1,"HASKINS, CAROLYN",1,2,-1
16597,2040520065,BX,1811 WALLACE AVENUE,01,B2,"MALDONADO, RAYMOND",2,3,-1
16598,1010360021,MN,317 WEST 45 STREET,05,H9,"CIRCUIT,",1,2,-1
16599,5007130057,SI,41 MOUNTAIN VIEW AVENUE,01,A5,37 MOUNTAINVIEW PROPERTY LLC,1,2,-1
16600,4012920031,QN,37-50 82 STREET,05,K2,82ND STREET RETAIL LLC,1,2,-1
16601,5015080170,SI,33 TREMONT AVENUE,01,B2,"GAUDIOSO, LORRAINE M",1,2,-1
16602,4019330028,QN,50-34 103 STREET,02,C0,"HUANG , YUN GUO",1,2,-1
16603,3065840066,BK,1537 EAST 2 STREET,01,B3,"TALAMO, DONNA",1,2,-1
16604,5033240006,SI,251 REID AVENUE,01,A5,"MAN, CHUNG Y",1,2,-1
16605,4020150002,QN,42-05 111 STREET,02,C0,"CHANG, HUNG BI",0,1,-1
16606,4081000025,QN,239-14 POPLAR STREET,01,B2,JOHN LA MARCA,1,2,-1
16607,5033950047,SI,277 QUINTARD STREET,01,A5,"HADZIU, BESNIK",0,1,-1
16608,2042620067,BX, MATTHEWS AVENUE,10,G0,"HERNANDEZ, GERARDO",0,1,-1
16609,5080380017,SI, NASHVILLE STREET,11,V0,"MESSINA, ROGER P",0,1,-1
16610,3045270113,BK,665 FOUNTAIN AVENUE,07,G9,HJC HOLDING CORP,0,1,-1
16611,5035890029,SI, MIDLAND AVENUE,10,G0,"SALVADOR, JEAN E",0,1,-1
16612,5037130050,SI, SEAVER AVENUE,11,V0,JOSEPH BERLEN,0,1,-1
16613,5038200052,SI,313 MORELAND STREET,01,A5,"WENG, BAOZHU",0,1,-1
16614,4026570040,QN,59-02 BORDEN AVENUE,11,V1,"HOME DEPOT U.S.A, INC.",0,1,-1
16615,4126640071,QN,188-21 120 ROAD,01,A1,"KIRKLAND, DWAYNE",1,2,-1
16616,2049690041,BX, SECOR AVENUE,11,V0,DENISE A KNIGHT,0,1,-1
16617,4027920023,QN,57-34 69 LANE,01,B1,"GIGLIO, JOSEPHINE",2,3,-1
16618,4017540018,QN,111 STREET,10,G0,JUAN MANUEL BATISTA,0,1,-1
16619,4160920079,QN,171 COMMODORE CIRCLE W,01,B2,"SUN, LANTAO",1,2,-1
16620,3051080049,BK,2913 SNYDER AVENUE,01,B2,SNYDER HOLDINGS LLC,1,2,-1
16621,3051190041,BK, BEVERLY ROAD,07,U7,NYC TRANSIT AUTHORITY,0,1,-1
16622,2045640064,BX,2814 SEXTON PLACE,01,B1,"ROSADO, JORGE A",1,2,-1
16623,5006810347,SI,27 MARX STREET,01,B2,"ALBUNIO, LORI",1,2,-1
16624,3070190009,BK,1908 NEPTUNE AVENUE,10,G7,"CLEMENTE, GARY",0,1,-1
16625,1018020045,MN,308 EAST 126 STREET,,Z9,"306-308 EAST 126TH ST, LLC",0,1,-1
16626,4022800001,QN, GRAND CENTRL PARKWAY,09,Q1,NYC DEPARTMENT OF PARKS AND RECREATION,1,2,-1
16627,4032250039,QN,96-03 71 AVENUE,01,A3,JENNIFER LAM,0,1,-1
16628,4032940044,QN, QUEENS BOULEVARD,10,G0,"BROWN, JONATHAN R",0,1,-1
16629,4023290025,QN,48-02 59 PLACE,01,B2,VANEGAS RAUL,1,2,-1
16630,2026060020,BX,1132 OAK POINT AVENUE,06,E9,UNAVAILABLE OWNER,3,4,-1
16631,4036080092,QN,65-16 ADMIRAL AVENUE,01,B2,"PODESZWA, TOMASZ",1,2,-1
16632,5040800035,SI, SEAFOAM STREET,10,G0,"WELLS FARGO BANK, NA",0,1,-1
16633,5040850061,SI,42 TOPPING STREET,01,A2,R HOOHMAN,1,2,-1
16634,4037110065,QN,77-01 72 STREET,01,B2,"RAFFA, DOREEN",1,2,-1
16635,4112140011,QN,112 ROAD,07,U9,NYC DEPARTMENT OF ENVIRONMENTAL PROTECTION,0,1,-1
16636,4025160002,QN, LAUREL HILL BLVD,11,V1,NYS DEPARTMENT OF TRANSPORTATION,0,1,-1
16637,4025520124,QN,49 STREET,06,E9,57-02 48TH STREET LLC,0,1,-1
16638,3067590076,BK,1525 EAST 12 STREET,08,M1,ST. BRENDAN'S RC CHU,1,2,-1
16639,4040990116,QN,132 STREET,11,V0,UNKNOWN,0,1,-1
16640,4042320038,QN,128-18 23 AVENUE,01,B1,"WANG, XIAO BAO",1,2,-1
16641,4042760001,QN, FARRINGTON STREET,09,Q1,NYC DEPARTMENT OF PARKS AND RECREATION,0,1,-1
16642,4043270100,QN,130-30 28 AVENUE,08,Y2,NYC POLICE DEPARTMENT,1,2,-1
16643,4044160181,QN,99 MALBA DRIVE,11,V0,"MAGALHAES, MEYRIELLY",0,1,-1
16644,4026510035,QN,60 ROAD,10,G0,ANTONIO VACCARO,0,1,-1
16645,2027280064,BX,1144 SIMPSON STREET,01,B2,NGUYEN TIN,1,2,-1
16646,4027260115,QN, FLUSHING AVENUE,11,V0,MARIA A. MARKIEWICZ REVOCABLE TRUST,0,1,-1
16647,2049730014,BX, MULVEY AVENUE,11,V1,3926 MULVEY AVENUE LLC,0,1,-1
16648,4102000106,QN,110 ROAD,10,G7,"JOHNSON, CURTIS",0,1,-1
16649,5043050035,SI,4 HOLLY PLACE,01,A1,BARBARA F JACKSON,1,2,-1
16650,4047070023,QN,151-49 20 ROAD,01,B3,FRANKOLA FAMILY TRUST,1,2,-1
16651,4048330063,QN,151-49 28 AVENUE,01,A1,"ZHANG, DIANA Q",1,2,-1
16652,4032940042,QN, QUEENS BOULEVARD,10,G0,"HORODNICEANU, ODED",0,1,-1
16653,4032950064,QN, UNION TURNPIKE,10,G0,RICHARDS BARBARA SOMMER,0,1,-1
16654,2049530124,BX,4139 BOSTON ROAD,06,E7,"SNL VI, LLC",1,2,-1
16655,4033390055,QN,75 ROAD,10,G0,"HOINACKI, JEFFREY",0,1,-1
16656,4033390106,QN,75 ROAD,10,G0,"SIT, LINDA",0,1,-1
16657,3072470211,BK, SHORE PARKWAY,,Z9,2647 STILLWELL AVE CORP,0,1,-1
16658,1007840012,MN,255 WEST 34 STREET,11,V1,JCMC WEST 34 OWNER LLC,0,1,-1
16659,2049630035,BX, DURYEA AVENUE,10,G0,CREANZA MARIA,0,1,-1
16660,5006080054,SI,79 SUNNYSIDE TERRACE,01,B2,MUJAJ BEQIR,1,2,-1
16661,4055230018,QN,201-04 NORTHERN BOULEVARD,05,K1,"KAMP NEW YORK PLAZA, LLC",1,2,-1
16662,5044650015,SI,15 CHESS LOOP,01,A5,"CIOLLI, PETER",1,2,-1
16663,4057600001,QN,166-03 21 ROAD,01,A1,"MARIA JEROME, AS TRUSTEE",1,2,-1
16664,3055370005,BK,6311 15 AVENUE,10,G0,"WONG, KIT MAN",0,1,-1
16665,3070160114,BK,2865 WEST 23 STREET,01,A5,"WU, KONG PING",1,2,-1
16666,4063990058,QN,138-07 64 AVENUE,01,A5,"KWAN, DIANE WAI",1,2,-1
16667,5040540041,SI, MANILA PLACE,07,U2,CON EDISON,0,1,-1
16668,3070600019,BK,2926 WEST 19 STREET,04,D6,CONEY ISLAND PHASE 1 HOUSING DEVELOPMENT  FUND,1,2,-1
16669,5006090016,SI,42 ALPINE AVENUE,01,A2,FRANK A PASTORE AND PAMELA M CARUSO,1,2,-1
16670,4067170073,QN,150-08 GRAND CENTRAL PKWY,01,A5,WALTER CALDERON,2,3,-1
16671,4069080006,QN,67 AVENUE,11,V0,FRANK WILLIAM,0,1,-1
16672,5061460016,SI,777 ROSSVILLE AVENUE,01,B9,"FILOGAMO, SANTO",1,2,-1
16673,5006070036,SI,61 ALPINE AVENUE,01,A3,"HOLDMAN, KEVIN",1,2,-1
16674,5061460022,SI,791 ROSSVILLE AVENUE,01,B9,"TEWS, PETER J",1,2,-1
16675,4038330002,QN,82-15 MYRTLE AVENUE,02,C0,MAUREEN E SETZER,1,2,-1
16676,4039160019,QN,3-57 SOUNDVIEW LANE,01,B1,"GUO, QI JIN",1,2,-1
16677,4039420001,QN,7-21 COLLEGE PLACE,01,A5,UNAVAILABLE OWNER,1,2,-1
16678,3071020027,BK,254 LAKE STREET,01,B1,CHI POR LI,1,2,-1
16679,5066770039,SI, HOLTEN AVENUE,01,Z0,KNOX STREET BUILDERS LLC,0,1,-1
16680,1004930111,MN,232 MOTT STREET,05,K1,"ELIZABETH FIREHOUSE, LLC",0,1,-1
16681,2052260117,BX,3341 DE REIMER AVENUE,01,B1,"FOSTER, STEPHANIE",1,2,-1
16682,4081030047,QN,312 CHERRY STREET,02,C0,"POLLICINO, ANNA",1,2,-1
16683,4081380014,QN,42-03 WESTMORELAND STREET,01,A1,"TOULON, AS TRUSTEE, PETERSON E",1,2,-1
16684,4081380032,QN,43-07 WESTMORELAND STREET,01,A2,DUANE JOHN F,1,2,-1
16685,4083060004,QN,245-50 62 AVENUE,02,C6,SOL GOLDMAN INVESTME,66,67,-1
16686,4083060092,QN,246-02 63 AVENUE,01,A0,JUNE F JONES (MRS HARRY B),1,2,-1
16687,4086890028,QN, LANGDALE STREET,10,G0,"KUNDLAS, GURPREET",0,1,-1
16688,4088200022,QN,86-19 261 STREET,01,B1,"CARILLO, ILEANA M",1,2,-1
16689,4067570021,QN,61-19 161 STREET,01,B3,FRANK DI FAZIO,2,3,-1
16690,4089180056,QN,80-27 87 ROAD,01,B2,"LIN, MEI JIN",1,2,-1
16691,2032490072,BX,2766 CLAFLIN AVENUE,01,B1,CAROL CLARK-DUNSTON,1,2,-1
16692,5069430112,SI,88 CLEARMONT AVENUE,01,B2,"ZOHAR, FLORA",1,2,-1
16693,4089750065,QN,93-16 89 AVENUE,01,B2,"AZAD, MOHAMMAD",2,3,-1
16694,4090120039,QN,95-17 81 STREET,01,A1,"KHURRAM , MUHAMMAD",1,2,-1
16695,5021400227,SI,199 SIGNS ROAD,01,B2,"KHALID, MOHAMMAD",3,4,-1
16696,3078910007,BK,2187 FLATBUSH AVENUE,11,V1,"2189 FLATBUSH AVE REALTY, LLC",0,1,-1
16697,5069790094,SI,164 EL CAMINO LOOP,01,B9,"LAGREGA, MATTHEW",1,2,-1
16698,4092990008,QN,110 STREET,11,V0,"KAUR, SUKHWINDER",0,1,-1
16699,4093150030,QN,108-03 ATLANTIC AVENUE,05,K1,UNAVAILABLE OWNER,0,1,-1
16700,4093430019,QN,89-28 117 STREET,01,B1,"SINGH, JARNAIL",2,3,-1
16701,5004470022,SI,304 DEMOREST AVENUE,01,A2,HOLDEN SUSAN,1,2,-1
16702,5075330029,SI,57 STATION AVENUE,10,G0,"STROH, ROBERT",0,1,-1
16703,3073240030,BK,2516 OCEAN AVENUE,04,S1,DITCHEK ALAN,1,2,-1
16704,4061540049,QN,36-15 205 STREET,01,A0,"LIN, KENNETH",1,2,-1
16705,5069790154,SI,98 EL CAMINO LOOP,01,B9,FRANK BERTINO,1,2,-1
16706,3082980126,BK,1609 EAST 95 STREET,11,V0,WARREN CARO,0,1,-1
16707,4064990012,QN,64-25 136 STREET,01,A5,"CHAN, SEE YUN",1,2,-1
16708,4099190001,QN,182-43 89 AVENUE,02,C0,"BOADNARAINE, IDNERADEVI",1,2,-1
16709,5069790194,SI,21 MALIBU COURT,01,B9,"GUO, TUAN",1,2,-1
16710,5006000005,SI,113 GRAND AVENUE,01,A1,"ROPERTI, CHRISTINA",1,2,-1
16711,4072140047,QN,75-67 197 STREET,01,B1,"WONG, YIN-NGAN",1,2,-1
16712,5073170027,SI,34 MANDY COURT,01,B9,"MAZZO, JOSEPH",1,2,-1
16713,3062410059,BK,2143 77 STREET,01,B2,"LEE, TON WO",1,2,-1
16714,5070940050,SI,31 WILTSHIRE LANE,01,B9,UNAVAILABLE OWNER,1,2,-1
16715,5004190013,SI,165 WOOLLEY AVENUE,01,A1,CEE JAY REAL ESTATE DEVLP. CORP.,0,1,-1
16716,5072060321,SI, DERICK COURT,11,V1,"ZANETI, HAROLD",0,1,-1
16717,5075150200,SI, OUTERBRIDGE AVENUE,11,V1,"7515 LOT 200, LLC",0,1,-1
16718,4104540040,QN,189-15 89 AVENUE,01,A1,"KALICHARAN, DHARAMRAJ",1,2,-1
16719,4105040030,QN,86-36 PALO ALTO STREET,01,B3,ILUMINADA BATISTA,1,2,-1
16720,4106570165,QN,8965A VANDERVEER STREET,10,G0,DEBBY A AKINLEYE,0,1,-1
16721,5075340140,SI,52 STATION AVENUE,01,A1,"FITZGERALD, MICHAEL D",1,2,-1
16722,4162780069,QN,1-44 BEACH 134 STREET,01,A2,JASON BENSON,1,2,-1
16723,4090790016,QN,101-32 80 STREET,01,B2,"ABEDIN, MOHAMED Z",1,2,-1
16724,5077400001,SI, RICHARD AVENUE,09,Q0,NYC DEPARTMENT OF PARKS AND RECREATION,0,1,-1
16725,2050160085,BX, EDSON AVENUE,10,G0,SYDNEY A POWELL,0,1,-1
16726,5078600065,SI,85 SURFSIDE PLAZA,01,A5,MILLER JULIA,1,2,-1
16727,3072060043,BK, AVENUE Z,07,U7,NYC TRANSIT AUTHORITY,0,1,-1
16728,3072470288,BK, SHELL ROAD,11,V1,NYC DEPARTMENT OF SMALL BUSINESS SERVICES,0,1,-1
16729,2050460048,BX,4367 FURMAN AVENUE,01,B1,SMITH PETER A,1,2,-1
16730,2039520017,BX,1603 UNIONPORT ROAD,11,V1,ZP REALTY LLC,0,1,-1
16731,4113370044,QN,132-23 RUBY STREET,10,G0,"MC DERMOTT, TERANCE",0,1,-1
16732,4114570061,QN,155-41 77 STREET,01,B2,"GUZMAN, JUANITA",1,2,-1
16733,5040070225,SI,331 PENN AVENUE,01,A2,"SHOSTYA, ANNA",2,3,-1
16734,4009030039,QN,26-18 12 STREET,01,B3,"CORSO - SUSCA, LISA ANN",1,2,-1
16735,1004110052,MN,113 STANTON STREET,04,S4,"SM STANTON, LLC",1,2,-1
16736,4163020022,QN,327 BEACH 145 STREET,01,A1,RAYMOND BARTOLI,1,2,-1
16737,4094490044,QN,133-01 95 AVENUE,01,B3,MILTON LINDOR,1,2,-1
16738,4015900032,QN,94-29 41 ROAD,01,A5,"SANIZACA , JUSTO",2,3,-1
16739,4016870038,QN,101-13 32 AVENUE,02,C0,"LLIGUICOTA, CARLOS",1,2,-1
16740,2056410296,BX,220 CITY ISLAND AVENUE,,Z9,LUKECO LLC,2,3,-1
16741,5000100001,SI, ACADEMY PLACE,10,G6,ALLIED ST GEORGE C,0,1,-1
16742,4017700016,QN,101-06 39 AVENUE,01,B3,"INTRIAGO, GUILLERMOD",1,2,-1
16743,3078770006,BK,5201 AVENUE N,05,K1,CLL HOLDING CORP,0,1,-1
16744,5000360043,SI,70A SCRIBNER AVENUE,10,G0,LINDA STREITFELD REVOCABLE TRUST AGREEME NT,0,1,-1
16745,5036200018,SI,28 OTIS AVENUE,01,B2,KENNETH J. SIDEROWITZ,1,2,-1
16746,2050480015,BX,4371 BARNES AVENUE,10,G0,ELIZABETH MANIRAM,0,1,-1
16747,4095930044,QN,133-01 107 AVENUE,01,B3,RICHMOND 101 LLC,1,2,-1
16748,5005720069,SI,4A DYSON STREET,10,G0,BOULAY ANDRE,0,1,-1
16749,4121750082,QN,158 STREET,10,G7,JOHN OLIVER,0,1,-1
16750,2041310016,BX,1847 TOMLINSON AVENUE,01,B2,"PEREZ, JR., RAFAEL",1,2,-1
16751,3073440043,BK,1215 AVENUE V,01,A1,ALBERT SROUR,1,2,-1
16752,4019660061,QN, WALDRON STREET,11,V0,"NARAIDOO, ANASUYA",0,1,-1
16753,4159050030,QN,62-13 OCEAN AVENUE SOUTH,01,A5,"KWONG, WING",1,2,-1
16754,4159050047,QN,123 BEACH 62 STREET,01,A5,"BERMAN, VLADIMIR",1,2,-1
16755,4077660053,QN,79-13 209 STREET,01,A1,"FLIEGEL, JUDITH  S",1,2,-1
16756,3071460045,BK, MC DONALD AVENUE,10,G7,MAPLE WOOD 62 LLC,0,1,-1
16757,4126040064,QN,118-19 189 STREET,01,A1,LILLIAN GREEN,1,2,-1
16758,4101130071,QN, TUCKERTON STREET,11,V1,ELMHURST DAIRY HOLDINGS LLC,0,1,-1
16759,3083660062,BK,28 BERGEN BEACH PLACE,01,A9,"JACKSON, ERIC M",1,2,-1
16760,4128220060,QN,120-46 238 STREET,01,A2,U.S. BANK NATIONAL ASSOCIATION,1,2,-1
16761,4102190097,QN,170-17 DOUGLAS AVENUE,,Z9,MTR REALTY LLC,0,1,-1
16762,2042990003,BX,963 BRADY AVENUE,01,B1,"HAXHARI, CEZAR",0,1,-1
16763,5035550001,SI, NORTH RAILROAD AVE,07,U6,NYS DEPARTMENT OF TRANSPORTATION,0,1,-1
16764,4159050079,QN,185 BEACH 62 STREET,01,B2,"HOPE, LISEL",1,2,-1
16765,4024330012,QN,47 AVENUE,07,U1,LIRR,0,1,-1
16766,3087530049,BK,134 KENSINGTON STREET,01,A1,ONYX IRREVOCABLE TRUST,2,3,-1
16767,5003277501,SI,966 CLOVE ROAD,02,R3,NAME NOT ON FILE,1,2,-1
16768,3088850086,BK,19 IRA COURT,10,G0,JOSEPH J BANHAM,0,1,-1
16769,3073500020,BK,EAST 18 STREET,11,V0,TRAN GEOFFREY,0,1,-1
16770,2044500146,BX, HONE AVENUE,10,G0,DINH HUNG QUANG,0,1,-1
16771,4159050147,QN,188 SALTAIRE LANE,01,B2,"CONNOR, CHANDRA",1,2,-1
16772,4028080154,QN,72 PLACE,11,V0,NYC DEPARTMENT OF CITYWIDE ADMINISTRATIVE SERVICES,0,1,-1
16773,4160660039,QN, THURSBY AVENUE,,Z9,"POEHLMAN, JOSEPH",0,1,-1
16774,4032740029,QN,23 MIDDLEMAY CIRCLE,01,A5,"SCHUTZMAN, FRED",1,2,-1
16775,4141600004,QN,157 AVENUE,11,V0,GIUSEPPE & ROSALIA SEDITA,0,1,-1
16776,4032940041,QN, QUEENS BOULEVARD,10,G0,COLLINS ALISON V,0,1,-1
16777,4032950053,QN, UNION TURNPIKE,10,G0,"RAMOS , CARLOS",0,1,-1
16778,4142431165,QN,82 DAVENPORT COURT,01,A1,GENDRON ROGER,2,3,-1
16779,4033260031,QN,119-16 83 AVENUE,01,A3,"NISIMOV, MUSHE",0,1,-1
16780,4142511603,QN,164 ROAD,11,V0,"MICHEL, THOMAS",0,1,-1
16781,2045650046,BX,2919 MORGAN AVENUE,01,A1,"PASSARO, DANIEL",2,3,-1
16782,4112340171,QN,216-15 114 ROAD,01,A0,"WRIGHT, PAMELA",1,2,-1
16783,3011300011,BK, PACIFIC STREET,04,D6,ROMAN CATHOLIC CHURCH OF ST.JOSEPH,3,4,-1
16784,5003480015,SI,111 BEECHWOOD PLACE,01,B1,FRATELLO REALTY GROUP LLC,1,2,-1
16785,4117240012,QN,130-47 117 STREET,01,B3,DENNIE OUTAR,1,2,-1
16786,4035810013,QN,60-26 ST FELIX AVENUE,10,G0,"CARRILLO, DAWN M",0,1,-1
16787,2027470001,BX,984 FAILE STREET,08,W1,NYC DEPARTMENT OF EDUCATION,1,2,-1
16788,2027590388,BX, BRUCKNER BOULEVARD,07,U8,PENN CENTRAL COMPANY,0,1,-1
16789,4162820033,QN,1-49 BEACH 137 STREET,01,A1,"VITALE, MICHAEL",1,2,-1
16790,3056180038,BK,15 AVENUE,11,V0,BECK MAYER,1,2,-1
16791,5000230034,SI,17 FREMONT STREET,11,V1,EVERYTHING GOES REALTY,0,1,-1
16792,4038170002,QN,77-37 79 PLACE,01,A9,RANNAZZISI JOSEPH,1,2,-1
16793,5000360062,SI,36 SCRIBNER AVENUE,11,V0,FORMICA CONSTRUCTION INC.,0,1,-1
16794,5000600041,SI,69 FRANKLIN AVENUE,01,B3,NILUFAR MAHMOOD,2,3,-1
16795,5003260360,SI,171 SLOSSON AVENUE,01,B2,"KAPLAN-MAGNUS, STACIE BETH",1,2,-1
16796,4063150066,QN,42-01 218 STREET,01,A1,"KWONG, KAM MAN KENNY",1,2,-1
16797,3052480008,BK,2701 GLENWOOD ROAD,01,B2,2701 GLENWOOD ROAD LLC,1,2,-1
16798,2053490006,BX,1308A ELLISON AVENUE,10,G0,THOMAS DONLON,0,1,-1
16799,5001780020,SI,44 BRITTON STREET,01,B2,GZL SWEET LAND INC.,0,1,-1
16800,5000800017,SI, YORK AVENUE,10,G7,LONGVIEW COUNTY REALTY LLC,0,1,-1
16801,5000850026,SI,42 BUTLER TERRACE,01,A5,"XIAN, SHUANG LIAN",1,2,-1
16802,4007290045,QN,47-10 30 AVENUE,04,S1,ANZALONE LUCILLE,1,2,-1
16803,2029960049,BX,965 EAST 172 STREET,04,S9,CASTILLO REALTY CORP.,1,2,-1
16804,4007870013,QN,42-07 20 ROAD,10,G0,PHILIP DUCATELLI,0,1,-1
16805,4122820041,QN,134 AVENUE,01,Z0,"HAZZARD, HAZEL",0,1,-1
16806,5003490029,SI,3 WINTHROP PLACE,01,B1,TIMOTHY J BEAGEN,1,2,-1
16807,4162580063,QN,444A BEACH 136 STREET,10,G0,"ESPOSITO, JOHN",0,1,-1
16808,4125170075,QN,172-25 126 AVENUE,01,B2,"SELBY, NICHOLA M",1,2,-1
16809,2040080010,BX,EAST 180 STREET,07,U7,NYC TRANSIT AUTHORITY,0,1,-1
16810,5004790035,SI,317 COLLFIELD AVENUE,01,B2,"COSTA , JOAN",1,2,-1
16811,4163040056,QN,328 BEACH 148 STREET,01,A1,JAMES SAPORITO,1,2,-1
16812,3083380300,BK, FLATLANDS AVENUE,07,U0,NYC DEPARTMENT OF ENVIRONMENTAL PROTECTION,0,1,-1
16813,5002540139,SI,6 LAKEWOOD ROAD,10,G0,"CAIAZZO, EDWARD G",0,1,-1
16814,4069130008,QN,65-55 172 STREET,11,V0,"GREAT SUNSHINE AT FRESH MEADOWS, LLC",1,2,-1
16815,5006370010,SI,341 VANDERBILT AVENUE,01,B3,"STEWART, SHAREE",1,2,-1
16816,5006480026,SI,973 VAN DUZER STREET,01,A5,"YANG, HAO E",0,1,-1
16817,4126790051,QN,195 STREET,11,V0,"CUMMINGS, MICHAEL",0,1,-1
16818,4054870031,QN,157-04 LABURNUM AVENUE,01,A1,"LIM, GLORIA ALOG",1,2,-1
16819,4128740050,QN,128-16 234 STREET,01,A2,A HUDSON,1,2,-1
16820,3085380053,BK,2136 RYDER STREET,01,A1,"DENG, DAVID QI YOU",1,2,-1
16821,5007270010,SI, BRADLEY AVENUE,11,V0,UNAVAILABLE OWNER,0,1,-1
16822,5007740190,SI,627 WESTWOOD AVENUE,01,A5,"TORALBALLA, MYRNA",1,2,-1
16823,4060740027,QN,33-38 JORDAN STREET,01,A5,"IU, ANTHONY",1,2,-1
16824,5010440155,SI,156 DECKER AVENUE,01,A1,HECTOR A. PEREZ JR.,1,2,-1
16825,5002220048,SI,616 CARY AVENUE,01,A1,"ODEGE, KALU",1,2,-1
16826,5033330042,SI,295 RARITAN AVENUE,01,B3,GENC ALAJ,1,2,-1
16827,4163210012,QN,187 BEACH 147 STREET,01,A1,"BABAN, GERALDINE S",1,2,-1
16828,4003610033,QN,37-34 12 STREET,02,C3,"STERN, FATIMA",1,2,-1
16829,4132090072,QN, HOOK CREEK BOULEVARD,,Z9,"MEHR, LORI",0,1,-1
16830,4133010228,QN,167-37 147 AVENUE,01,B2,PLAZA GARDENS REAL ESTATE CORP,1,2,-1
16831,5001970100,SI,134 ALASKA STREET,04,S1,HARRY SANTANA,3,4,-1
16832,5014810081,SI,21 HOME PLACE,01,A1,ROBERT E STUCKEY,1,2,-1
16833,4133120021,QN,145-16 FARMERS BOULEVARD,08,M9,RC CH CHRIST THE KING,1,2,-1
16834,5000230040,SI,21 BROOK STREET,04,S2,"VELAUTHAMPILLAI, SIVAKUMAR",1,2,-1
16835,3077150005,BK,3213 AVENUE R,01,A9,"FRIEDMAN, MOSHE",1,2,-1
16836,5015240022,SI,251 CAMBRIDGE AVENUE,01,B2,"CHEN, JUMEI",0,1,-1
16837,2034300068,BX, HARDING PARK,11,V0,"HP HOMEOWNERS SSOC,INC",0,1,-1
16838,4064531000,QN,134-16 HORACE HARDING EXPWY,09,Z8,JACK L TRUCTON,10,11,-1
16839,4142471296,QN,104 STREET,11,V0,"LUCAS, TIMOTHY EDWARD",0,1,-1
16840,4142551773,QN,165 AVENUE,11,V0,"MCGUIGAN, THOMAS",0,1,-1
16841,5024000180,SI,2655 RICHMOND AVENUE,05,K6,"MACY'S RETAIL HOLDINGS, INC.",1,2,-1
16842,4153080450,QN, CROSS BAY BOULEVARD,11,V0,FRANCES SCANLON,0,1,-1
16843,5002790076,SI,27 PARK VIEW PLACE,01,A3,"KLIESCH, RICHARD",1,2,-1
16844,5028470140,SI,117A VIRGINIA AVENUE,10,G0,"GUERRIERO, JAMES",0,1,-1
16845,5028540006,SI,142 HYLAN BOULEVARD,01,B3,"EL-SAYED, IMAN",1,2,-1
16846,5028900021,SI, ODER AVENUE,11,V0,"WAHID, ABDUL",0,1,-1
16847,4068460026,QN,75-38 164 STREET,01,A5,"CHAN, CHING MELODY",1,2,-1
16848,5031100037,SI,221 SAND LANE,10,G0,JANET T. VERRI,0,1,-1
16849,4069220047,QN,67-12 169 STREET,01,A2,"CHOY, CHI B",1,2,-1
16850,4069730025,QN,165-21 UNION TURNPIKE,10,G0,LUCILLE P NORTON,0,1,-1
16851,4159690025,QN,BEACH 47 STREET,11,V0,"FIGUEROA, JUAN E",0,1,-1
16852,5033380031,SI, HANCOCK STREET,10,G0,"AKSABANOVIC, OMER",0,1,-1
16853,5033550066,SI, MASON AVENUE,11,V0,STATEN ISLAND UNVRST HOSPITAL,0,1,-1
16854,5033010056,SI, CROMWELL AVENUE,11,V0,ST ANNS R C CHURCH,0,1,-1
16855,5034720070,SI,517 SEAVIEW AVENUE,01,B9,UNAVAILABLE OWNER,1,2,-1
16856,5005560154,SI,25 SUSAN COURT,01,A5,"WONG, TAK CHEONG",1,2,-1
16857,5035770053,SI,29 COLFAX AVENUE,01,A5,"ELSAADANY, AHMED",1,2,-1
16858,5000800014,SI,254 YORK AVENUE,01,A5,"YANG, HUI",0,1,-1
16859,4006160071,QN,30-92 33 STREET,02,C0,"KOSTARAS 111 REALTY, LLC",1,2,-1
16860,2036130022,BX, SEWARD AVENUE,10,G0,"CASTILLO, WHALESCA",0,1,-1
16861,5040670040,SI,54 BEACON PLACE,01,A5,SCIANGULA SALVATORE,1,2,-1
16862,4076870031,QN,69-52 229 STREET,01,B3,"ZHU, MAN CHUNG",1,2,-1
16863,5041300397,SI,178 MANILA AVENUE,01,A9,JAMES V. JACKSON,1,2,-1
16864,5000870082,SI,293 LAFAYETTE AVENUE,01,A1,"DUKES, ERIC",1,2,-1
16865,5001030004,SI, ELY STREET,10,G0,CARLOS N NIETO,0,1,-1
16866,4007390027,QN,30-45 48 STREET,02,C2,"GIZZI, ROSA",1,2,-1
16867,4082330415,QN,249-24 RUSHMORE TERRACE,01,A2,"LIU, THOMAS",2,3,-1
16868,5001850153,SI,1641 RICHMOND TERRACE,07,G2,"INGRASSIA, RONALD",4,5,-1
16869,5001250003,SI,345 CASTLETON AVENUE,01,A5,"RAMIREZ, HECTOR",1,2,-1
16870,5050900010,SI,3538 AMBOY ROAD,01,B9,THE GRSW STEWART REAL ESTATE TRUST,1,2,-1
16871,5001260012,SI,89 SILVER LAKE ROAD,01,B2,"FIKIAS, IOANNIS A/K/A JOHN",1,2,-1
16872,4007650020,QN,19-00 48 STREET,11,V1,"CHARMER INDUSTRIES,INC",0,1,-1
16873,3061380006,BK,10015 4 AVENUE,03,D4,BRIDGE-HAMILTON REALTY,1,2,-1
16874,5002870030,SI,673 PELTON AVENUE,01,A1,ALICE GARGANO,1,2,-1
16875,5003020018,SI,31 HOWE STREET,01,B2,"NASIR, ADNAN",0,1,-1
16876,4090820037,QN,81-58 102 AVENUE,11,V0,"NANDALALL, NAGESHWAR",0,1,-1
16877,5003260369,SI,61 LAKELAND ROAD,01,A0,JOHN MILANO,1,2,-1
16878,5001840033,SI,1382 RICHMOND TERRACE,06,E1,CADDELL DRYDOCK REPAIR CO INC,1,2,-1
16879,5042000001,SI, RAILROAD AVENUE,07,U1,CITY OF NEW YORK,0,1,-1
16880,4018609101,QN,57-02 92 STREET,10,G1,UNAVAILABLE OWNER,1,2,-1
16881,3023210036,BK,209 NORTH 7 STREET,11,V0,MUSCATO PETER,1,2,-1
16882,5069790198,SI,15 MALIBU COURT,01,B9,"TAGGART, JENNIFER",1,2,-1
16883,5072670004,SI, CLAY PIT ROAD,11,V0,20 MK LLC,0,1,-1
16884,5075630029,SI, WEINER STREET,10,G0,"SANTAGATA, RONALD",0,1,-1
16885,5003530060,SI,246 DUBOIS AVENUE,01,A1,"TAT KO, YING",2,3,-1
16886,5075720124,SI,121 MADSEN AVENUE,01,B3,"EDWARD KRAKOWER, JR.",2,3,-1
16887,4092790082,QN,86-48 126 STREET,01,B2,SHAKIR ALI,1,2,-1
16888,5001380108,SI,130 BARD AVENUE,01,B2,"VASQUEZ, ALBERTO",0,1,-1
16889,5003660037,SI,40 CONSTANT AVENUE,01,B3,EVELYN JUSTINIANO,1,2,-1
16890,5077020292,SI,26 PENTON STREET,01,A5,GIOENI JOSEPH,1,2,-1
16891,3069980007,BK,4013 MANHATTAN AVENUE,02,C0,THE BERNICE TOLCHINSKY IRREVOCABLE TRUST,2,3,-1
16892,3070030049,BK,3721 NAUTILUS AVENUE,01,B3,LIBA SHAFFER GOLDMAN,1,2,-1
16893,3055000036,BK,2070 57 STREET,02,C0,2074 57 DEVELOPMENT LLC,0,1,-1
16894,5078120056,SI, JOLINE AVENUE,10,G0,S&V BERTAN,0,1,-1
16895,4012080060,QN,54 STREET,,Z9,CK & BJ CORP,0,1,-1
16896,4093180001,QN,91-18 112 STREET,01,B3,"SINGH, AMRIK",1,2,-1
16897,5078540082,SI, SANFORD STREET,11,V0,ROBERT RUGGIERO,0,1,-1
16898,5078610056,SI,667 ROCKAWAY STREET,10,G0,"CHIRELLI, VINCENT J",0,1,-1
16899,5004140011,SI,104 WOOLLEY AVENUE,01,A1,GEORGE MARCINEK,1,2,-1
16900,2049220017,BX, MAROLLA PLACE,11,V0,NYC DEPARTMENT OF CITYWIDE ADMINISTRATIVE SERVICES,0,1,-1
16901,5001570201,SI,105 ELM STREET,01,A1,CHARLES J ARCURI,1,2,-1
16902,4013500025,QN,69-50 43 AVENUE,01,B3,MAO YOUNG CHANG,1,2,-1
16903,5001840400,SI, NORTH STREET,07,U6,NYC ECONOMIC DEVELOPMENT CORPORATION,0,1,-1
16904,5080050089,SI, ARTHUR KILL ROAD,10,G0,"BRACCINI, STEFANO",0,1,-1
16905,5023910169,SI,14 LEASON PLACE,01,A5,DEBORAH MIGLIORI,1,2,-1
16906,4094480044,QN,132-01 95 AVENUE,01,B2,"BAPTISTE, KAMINA",1,2,-1
16907,1000030003,MN, PETER MINUIT PLAZA,09,Q1,NYC DEPARTMENT OF PARKS AND RECREATION,1,2,-1
16908,1005050031,MN,161 AVENUE OF THE AMER,05,O6,"SOHO AOA OWNER, LLC",1,2,-1
16909,2042720044,BX,1918 HAIGHT AVENUE,02,C2,QOSJA MANAGEMENT LLC,1,2,-1
16910,5001780018,SI,50 BRITTON STREET,01,B2,"LIN, LIQIU",0,1,-1
16911,5001150087,SI,385 VICTORY BOULEVARD,01,B3,"LIN, CHUN",1,2,-1
16912,5007170020,SI,38 GANSEVOORT BOULEVARD,01,A1,JACK RUSSO,1,2,-1
16913,4095630119,QN,127 STREET,11,V1,126-15 LIBERTY AVENUE HOLDING LLC,0,1,-1
16914,4016010001,QN,94-05 44 AVENUE,07,G2,HUNGSTER LLC,2,3,-1
16915,3077090042,BK,3614 AVENUE P,01,B2,3614 AVE P LLC,0,1,-1
16916,3078100017,BK,1870 FLATBUSH AVENUE,10,G7,CBP OF BROOKLYN INC,0,1,-1
16917,2043250017,BX, PAULDING AVENUE,07,U7,NYC TRANSIT AUTHORITY,0,1,-1
16918,5008690066,SI,82 DALEMERE ROAD,01,B1,RICHARD DEL GUIDICE,1,2,-1
16919,5008700017,SI,1559 RICHMOND ROAD,04,K4,"DEPEPPO, VALENTINE F JR",1,2,-1
16920,5001030011,SI, ELY STREET,,Z9,"ADIMOOLAM, RAJA",0,1,-1
16921,3082000085,BK, SKIDMORE LANE,11,V0,"LOUIS, FRANCOISE",0,1,-1
16922,3055000035,BK,2066 57 STREET,02,C0,2074 57 DEVELOPMENT LLC,0,1,-1
16923,3083690348,BK,1367 EAST 70 STREET,01,B2,"SLEEPY HOLLOW DEVELOPMENT CO.,",1,2,-1
16924,2044770045,BX, EASTCHESTER ROAD,10,G0,"PACELLI, OLGA",0,1,-1
16925,3085370001,BK,3723 AVENUE U,07,G2,JAY HOFFMAN,1,2,-1
16926,3033070101,BK,311 WILSON AVENUE,02,C1,313 WILSON AVE LLC,0,1,-1
16927,1019110019,MN,129 WEST 126 STREET,02,C0,"WEST 126 GROUP, LLC",1,2,-1
16928,1019880018,MN,517 WEST 134 STREET,04,D6,198818 INC.,0,1,-1
16929,3088850090,BK,23 IRA COURT,01,A2,KUNTZE KENNETH,0,1,-1
16930,3089140086,BK,102 CANTON COURT,01,A1,"BORCHELT, PETER",1,2,-1
16931,4001830175,QN,43 STREET,11,V1,183175 QUEENS CORPORATION,0,1,-1
16932,1021800063,MN,524 FT WASHINGTON AVENUE,11,V1,FORT TRYON JEWISH CENTER,0,1,-1
16933,1022150623,MN,5365 BROADWAY,03,D3,NYC HOUSING AUTHORITY,2,3,-1
16934,5002150290,SI,865 POST AVENUE,01,B9,GRINBERG MGMT & D LLC,1,2,-1
16935,4024870004,QN,52-27 73 STREET,01,B3,"FUMAI, MARY",1,2,-1
16936,4161210007,QN,216 BEACH 88 STREET,06,E7,KEN-MAR INDUSTRIES I,1,2,-1
16937,4006190029,QN,31-10 28 ROAD,02,C1,31-10 28TH ROAD LLC,1,2,-1
16938,5002920009,SI,627 BEMENT AVENUE,01,A1,627 BEMENT AVE LLC,1,2,-1
16939,2023790045,BX,450 EAST 158 STREET,08,M1,GER M E CH OF MELROSE,1,2,-1
16940,2023880058,BX,1113 WASHINGTON AVENUE,10,G7,SHAFI IQBAL A,0,1,-1
16941,3032800038,BK,160 WYCKOFF AVENUE,04,S4,"BOLOGNA, MARIO",1,2,-1
16942,5002380126,SI,184 DUBOIS AVENUE,01,B2,ALMA JUSTINA MORALES,1,2,-1
16943,4025770025,QN,56-70 58TH STREET,06,E9,JCIAMPA COMPANY LLC,4,5,-1
16944,4160690012,QN, HESSLER AVENUE,,Z9,"VBX-4.16069.12, LLC",0,1,-1
16945,4008370065,QN,32 STREET,01,Z0,VINCENZO CIANCIO,0,1,-1
16946,3023140015,BK,256 NORTH 9 STREET,11,V0,254-256 N 9TH ST LLC,4,5,-1
16947,5005210090,SI,389 VAN DUZER STREET,04,S2,"KABALKIN, IRA V",1,2,-1
16948,5010430106,SI,54 LEXINGTON AVENUE,01,B2,LUKASZ PILAREK,1,2,-1
16949,4010840059,QN,23-59 89 STREET,02,C0,23-59 89TH STREET REALTY LLC,1,2,-1
16950,4159050091,QN,151 COMPASS PLACE,01,A5,"SHI, YI",1,2,-1
16951,3018070059,BK,401 GATES AVENUE,03,D1,401 GATES AVENUE LLC,0,1,-1
16952,4013200012,QN,51-02 ROOSEVELT AVENUE,11,V1,HW LIC ONE LLC,0,1,-1
16953,5010440056,SI,399 HEBERTON AVENUE,01,A1,JOHN F KEEGAN,1,2,-1
16954,4026470060,QN,60 COURT,09,Q9,"METROPOLITAN OVAL FOUNDATION, INC",0,1,-1
16955,4015220170,QN,76 STREET,10,G0,KEKAKIS EFSEVIA,0,1,-1
16956,2028790169,BX, SEDGWICK AVENUE,10,G7,FIRE DEPARTMENT OF NEW YORK,0,1,-1
16957,4019670005,QN,56-10 VAN CLEEF STREET,02,C0,VANCLEEF ASSOCIATES LLC,1,2,-1
16958,5010990042,SI,176 HATFIELD PLACE,01,A1,"VESTASTEGUI, ALICIA F",0,1,-1
16959,2030770039,BX, ARTHUR AVENUE,11,V1,"DINOTO, MICHAEL",0,1,-1
16960,5004880206,SI,467 BAY STREET,06,E1,NIKDANO LLC,1,2,-1
16961,4017480021,QN,34-24 107 STREET,01,A1,LUCIEN PIERRE,1,2,-1
16962,5011510035,SI,2590 RICHMOND TERRACE,05,GU,"FRIMERMAN, ELINA",0,1,-1
16963,2032610024,BX,3100 BAILEY AVENUE,04,S9,MORILLO ELIAS,1,2,-1
16964,4100900018,QN, SUTPHIN BOULEVARD,10,G7,MANISION HOMES LLC,0,1,-1
16965,2046360031,BX,3354 COLDEN AVENUE,02,C2,"OSINOWO, SIDIKATU ADEDAYO",1,2,-1
16966,3058570028,BK,67 STREET,11,V0,"TAMMARO, JOSEPH",0,1,-1
16967,4022270026,QN,110-38 68 ROAD,01,A3,"RAKHMINOV, SHALOM",1,2,-1
16968,4023170051,QN,63 STREET,09,Q0,NYC DEPARTMENT OF PARKS AND RECREATION,0,1,-1
16969,4019280043,QN, ALSTYNE AVENUE,10,G0,"BRAVO, PAULINO",0,1,-1
16970,5012540008,SI,147 SOUTH AVENUE,02,C0,VERONICA GISONDA,1,2,-1
16971,5015040105,SI,458 WILLOWBROOK ROAD,01,A1,ALBERT P ROSCHFSKA,1,2,-1
16972,2057530375,BX, PALISADE AVENUE,07,U6,MTA - METRO NORTH,0,1,-1
16973,2036530021,BX,938 BOYNTON AVENUE,01,B1,THE ARMANDO CASTILLO & NIDIA CASTILLO LI VING TRUST,2,3,-1
16974,5016000057,SI,106 ELSON STREET,01,A5,HAREN GAO,1,2,-1
16975,5016050132,SI,179 KIRSHON AVENUE,01,A2,"BLACK , JOSEPH",1,2,-1
16976,2037130069,BX, BRUCKNER BOULEVARD,10,G7,MOUNT SINAI PROPERTIES INC,0,1,-1
16977,2055190018,BX,271 LONGSTREET AVENUE,01,A2,RUSSO JOANN,2,3,-1
16978,5003680135,SI,117 WESTCOTT BOULEVARD,02,C3,"DOYLE, THOMAS",1,2,-1
16979,2053660010,BX,1356 MERRY AVENUE,02,C0,JAMES H. CARR,1,2,-1
16980,2037560064,BX,1137 LELAND AVENUE,10,G0,MENDEZ LUIS,0,1,-1
16981,2037950050,BX,EAST 177 STREET,09,Q1,NYC DEPARTMENT OF PARKS AND RECREATION,0,1,-1
16982,3031240005,BK, COOK STREET,,Z9,FLUSHING AVENUE DEVELOPMENT LLC,0,1,-1
16983,5021650001,SI, SOUTH AVENUE,11,V7,PORT AUTHORITY OF NY AND NJ,0,1,-1
16984,5022760052,SI,287 LIGHTHOUSE AVENUE,01,A2,STEVEN CISTERNATS,1,2,-1
16985,2039000001,BX,1400 TAYLOR AVENUE,01,A1,"AGUILAR, OSCAR",1,2,-1
16986,4027390022,QN,61 STREET,10,G0,SPURGIASZ THERESA,0,1,-1
16987,5022940060,SI,40 OLD MILL ROAD,08,M3,CHURCH OF ST ANDREW,1,2,-1
16988,2046930004,BX,1051 EAST GUN HILL ROAD,05,K1,1047 E. GUN HILL REALTY CORP.,2,3,-1
16989,5024450020,SI,41 LOTT LANE,01,A5,SAM E. KYROLLOS,1,2,-1
16990,4028370028,QN,60 DRIVE,10,G0,"PORRETTO, ANNAMARIA",0,1,-1
16991,4031450040,QN,85-65 67 ROAD,01,A5,"LEE, JUNG KUAI",1,2,-1
16992,4032640011,QN,72-12 JUNO STREET,01,B3,"BEAUVAIS, LOUIS J",1,2,-1
16993,5024500536,SI,198 ESSEX DRIVE,01,B9,WLODZIMIERZ,1,2,-1
16994,4073820006,QN,205-10 50 AVENUE,01,A1,KWOK HING CHAN,2,3,-1
16995,4033390027,QN,75 ROAD,10,G0,MARTIN E CARVER,0,1,-1
16996,4033390054,QN,75 ROAD,10,G0,EDITH EVA ELTON,0,1,-1
16997,4033390104,QN,75 ROAD,10,G0,MARDI MCDOUGALL,0,1,-1
16998,2051090025,BX,4818 OSGOOD STREET,10,G0,"SEERAM, SURSATI",0,1,-1
16999,5027050300,SI, VICTORY BOULEVARD,07,U0,"CONSOLIDATED EDISON CO.OF N.Y.,INC.",0,1,-1
17000,5028320060,SI,69 COURTNEY LOOP,01,B9,GREHER WILLIAM,1,2,-1
17001,4036960065,QN,73 STREET,11,V0,I.Z.A. 05 CORP,0,1,-1
17002,2050720125,BX, BYRON AVENUE,11,V0,RAGHUBIR RAJENDRA P,0,1,-1
17003,4038130020,QN,77-24 76 STREET,01,B3,CHARLES WEBER IRREVOCABLE TRUST DATED 10 /09/2014,1,2,-1
17004,4030250001,QN,69 STREET,07,U7,CONSOLIDATED RAIL CORP,2,3,-1
17005,2030300036,BX, WEBSTER AVENUE,10,G7,543 P & S MANAGEMENTCORP.,0,1,-1
17006,5028990147,SI,93 MOSEL AVENUE,01,A5,"LIANG, JIEBANG",1,2,-1
17007,5062200024,SI,23 BARB STREET,01,A5,"ZHANG, HARRY",1,2,-1
17008,5029300024,SI,172 MOSEL AVENUE,01,A5,"MORALI, RUTH S",1,2,-1
17009,4101720036,QN,164 PLACE,10,G0,AMITY BAPTIST CHURCH INC,0,1,-1
17010,2046600054,BX,764 EAST 213 STREET,02,C2,764 E 213TH ST LLC,2,3,-1
17011,2054790065,BX, CLARENCE AVENUE,11,V0,AMELIA CAFARO REVOCABLE TRUST,0,1,-1
17012,5031220341,SI,84 OCEANSIDE AVENUE,01,A5,"ABDALADZE, MERAB",1,2,-1
17013,2057630555,BX,3423 TIBBETT AVENUE,01,A5,PAULINE O SULLIVAN,1,2,-1
17014,5032540050,SI,275 LAMPORT BOULEVARD,01,B2,SEBASTIANA LIANTONIO,1,2,-1
17015,2048500052,BX,814 EAST 226 STREET,02,C2,814 E 226 LLC,1,2,-1
17016,2055290425,BX,50 PENNYFIELD AVENUE,05,K1,50 PENNYFIELD BUILDING C,1,2,-1
17017,4033050029,QN, MARKWOOD PLACE,10,G0,"CZYZEWSKI, BRYAN K",0,1,-1
17018,5032740042,SI,148 SAND LANE,02,C0,"CHEN, RUIFENG",1,2,-1
17019,4029550110,QN,62 AVENUE,07,U6,NEW YORK CENTRAL LINES,0,1,-1
17020,5033590036,SI,153 LACONIA AVENUE,01,B3,"ELAYYAN, FOUAD",1,2,-1
17021,4033390059,QN,75 ROAD,10,G0,"GRANGER, GAIL M",0,1,-1
17022,3034350037,BK,189 COOPER STREET,03,D3,189 COOPER STREET LLC,0,1,-1
17023,2052320023,BX,3290 BOLLER AVENUE,01,B2,"AMPONG, CEPHAS A",1,2,-1
17024,2052560190,BX, CONNER STREET,07,U9,NYC DEPARTMENT OF ENVIRONMENTAL PROTECTION,0,1,-1
17025,4053770017,QN,147-18 SANFORD AVENUE,01,B1,LUNG SHENG LEE,1,2,-1
17026,2053500039,BX,3108 EAST TREMONT AVENUE,04,S3,KING SUM YU,1,2,-1
17027,2053620012,BX, HOLLYWOOD AVENUE,10,G0,JOSEPH A TESTA,0,1,-1
17028,4057610028,QN,166-44 21 ROAD,01,A0,"BARRY, MICHAEL B",1,2,-1
17029,4059440056,QN,15-12 15 AVENUE,11,V0,BAYSIDE 215TH REALTY LLC,0,1,-1
17030,2055780084,BX,2836 SAMPSON AVENUE,01,A2,RAMDAT MAHABIR,1,2,-1
17031,5037020046,SI,297 SANILAC STREET,01,B2,A GALLETTA,2,3,-1
17032,5004580009,SI,17 SEWARD PLACE,01,A2,DOROTHY SCHECHTER,1,2,-1
17033,4031650033,QN,67-54 BURNS STREET,02,C0,JADDE LLC,1,2,-1
17034,5040530026,SI,212 CUBA AVENUE,01,A5,CUBA PARTNERS LLC,1,2,-1
17035,5041300655,SI, ROMA AVENUE,11,V0,NYS DEPARTMENT OF ENVIRONMENTAL CONSERVATION,0,1,-1
17036,2048530061,BX,818 EAST 229 STREET,02,C0,BENLOSS ERIC,1,2,-1
17037,2056250183,BX,61 BUCKLEY STREET,01,A2,"SORELL, STUART",1,2,-1
17038,2055450030,BX, CALHOUN AVENUE,10,G0,"BRAUE, ANTHONY",0,1,-1
17039,5041970010,SI,205 3 STREET,01,B2,"SLANE DEVELOPERS, LLC",1,2,-1
17040,4116490057,QN,114-11 122 STREET,01,A1,PENA DEMARIS,1,2,-1
17041,4142340534,QN,39 109 AVENUE,11,V0,NYC DEPARTMENT OF ENVIRONMENTAL PROTECTION,0,1,-1
17042,5043320032,SI,40 BLACKHORSE COURT,01,A3,ALEKSEY ILISHAYEV,0,1,-1
17043,3036000136,BK,438 BRISTOL STREET,01,B1,"CANNON, WILLIAM",0,1,-1
17044,4142310080,QN, RAU COURT,11,V0,VITO A AGATE,0,1,-1
17045,4032950068,QN, UNION TURNPIKE,10,G0,"PHAM, LYNN",0,1,-1
17046,4081290161,QN,44-06 JESSIE COURT,01,B3,YOONSUK KANG,2,3,-1
17047,5046450072,SI,15 WILLOW LANE,01,B9,"RUBILOTTA, VICTOR",1,2,-1
17048,4117280062,QN,130-40 122 STREET,01,A2,ALDWIN L WILLIAMS,1,2,-1
17049,5050160001,SI,54 JUSTIN AVENUE,07,U9,MTA - STATEN ISLAND RAILWAY,0,1,-1
17050,4082600014,QN,253-32 NORTHERN BOULEVARD,05,K2,ARTHUR KATSELIANOS,2,3,-1
17051,4136020012,QN,145-07 FRANKTON STREET,01,B3,"COLLINS, LAVERN",1,2,-1
17052,4088090082,QN,265 STREET,11,V0,G MARRA,0,1,-1
17053,4088530142,QN,86-20 85 STREET,10,G0,BASDEO JAGDAR,0,1,-1
17054,4032950069,QN, UNION TURNPIKE,10,G0,"ZOOBI, FIDA",0,1,-1
17055,4033390020,QN,75 ROAD,10,G0,THE ALISA ZAMIR REVOCABLE TRUST,0,1,-1
17056,5052850012,SI,238 BEACH ROAD,01,A2,"SULLIVAN, LAURENCE",1,2,-1
17057,4090290036,QN,89 STREET,11,V0,COLORADO GUSTAVO E,0,1,-1
17058,4033390021,QN,75 ROAD,10,G0,ORCHARD FIELDS LLC,0,1,-1
17059,2048330011,BX,4127 WHITE PLAINS ROAD,04,S2,WPR 230 LLC,1,2,-1
17060,5053060071,SI,238 WIMAN AVENUE,01,A1,JOSEPH LA ROSA,1,2,-1
17061,4090850037,QN,84-03 102 ROAD,11,V0,"ALI, FEROZA",0,1,-1
17062,4120160059,QN,142-22 119 ROAD,01,B3,"MC LEAN, JULIUS",1,2,-1
17063,4091350114,QN,80 STREET,11,V0,MOHAMMED J. UDDIN,0,1,-1
17064,4092820039,QN,86-45 130 STREET,01,B3,"MARAJ, SHAM",1,2,-1
17065,4033390024,QN,75 ROAD,10,G0,"WEINSTEIN, JAN",0,1,-1
17066,4036960074,QN,72-27 73 STREET,01,B2,"ROPPOLO, PIETRO",1,2,-1
17067,4037280060,QN,57-07A CLOVER PLACE,10,G0,"MONCINO, ROBERT A",0,1,-1
17068,5055900018,SI,18 SYLVIA STREET,04,S2,5590 HOLDING LLC,1,2,-1
17069,2047870056,BX,2820 KINGSLAND AVENUE,01,A2,PLAZA GARDENS REAL ESTATE CORP,1,2,-1
17070,5057350299,SI,187 PRESENTATION CIRCLE,01,B2,"PAC, KAMIL",1,2,-1
17071,5003110026,SI, FORD PLACE,10,G0,ANN-MARIE WHITE,0,1,-1
17072,4035810043,QN,60-23 78 AVENUE,10,G0,LOREY BYPASS TRUST,0,1,-1
17073,5062140049,SI, EAGAN AVENUE,01,B2,BOULDER BUILDING CORP.,1,2,-1
17074,5065340044,SI, ARBUTUS AVENUE,11,V0,PAUL DI GEORGIO,0,1,-1
17075,4096170027,QN,88-24 VAN WYCK EXPRESSWAY,07,G2,"RIVERA, EVELYN",0,1,-1
17076,5069770031,SI,92 MAQUIRE AVE,11,V0,ATTILDO EDWARD NUCCI,0,1,-1
17077,5070920119,SI,80 CRABTREE AVENUE,01,B9,"DEANGELIS, MICHAEL",1,2,-1
17078,4097670059,QN,88-56 162 STREET,03,D1,89TH AVE PROJECT LLC,0,1,-1
17079,4097760043,QN,161-06 NORMAL ROAD,01,A1,SEWLALL MOHABIR,1,2,-1
17080,2041410011,BX, BLONDELL AVENUE,07,U7,NYC TRANSIT AUTHORITY,0,1,-1
17081,5073170273,SI,119 PEMBROOK LOOP,01,A5,"COSTADURA, BRIAN",1,2,-1
17082,4100250011,QN,95-14 WALTHAM STREET,01,B2,CEPIN NUNCIATINA,2,3,-1
17083,5003320125,SI,54 SLOSSON AVENUE,01,B2,"ESPOSITO, ANDREW",1,2,-1
17084,4124060280,QN, BAISLEY BOULEVARD,08,I6,DORMITORY AUTHORITY OF THE STATE OF,1,2,-1
17085,4101300043,QN,150-37 SHORE AVENUE,01,B1,WILLIAMS BARBARA,1,2,-1
17086,4125150027,QN, BAISLEY BOULEVARD,10,G0,APOSTOLIC FAITH ASSE,0,1,-1
17087,5003890099,SI,81 BURNSIDE AVENUE,01,A1,"KELLY , DAVID  R",1,2,-1
17088,4102990036,QN,112-04 177 STREET,01,A2,BROWN  MYRON,1,2,-1
17089,5078850004,SI, BRIGHTON STREET,11,V0,STEPHEN DELUZIO,0,1,-1
17090,2037660066,BX,1231 LELAND AVENUE,01,A1,FORDE JASMINE,3,4,-1
17091,2056290131,BX,60 HAWKINS STREET,01,A2,"PORT, THEODORE",1,2,-1
17092,3022210042,BK,309 RUTLEDGE STREET,05,O9,GOLDEX LIMITED,0,1,-1
17093,3075830015,BK,1085 EAST 37 STREET,01,A9,"BLAIZE, AMANDA",1,2,-1
17094,5003170014,SI, EGBERT AVENUE,10,G0,H M MILLEN,0,1,-1
17095,5005560198,SI,25 THELMA COURT,01,A5,"VISDA, ELOISA",1,2,-1
17096,1000160220,MN,201 WARREN STREET,08,W1,UNAVAILABLE OWNER,1,2,-1
17097,5003320139,SI,73 DRAKE AVENUE,01,A1,"HACHEMEISTER, ROBERT S",1,2,-1
17098,2059200153,BX, DOUGLAS AVENUE,,Z9,"SALZHAUER, MICHAEL",0,1,-1
17099,2054860105,BX, SHORE DRIVE,11,V2,"RYAN, MICHAEL P",0,1,-1
17100,4128740024,QN,128-35 233 STREET,01,A2,"SINGH, SHARDA",1,2,-1
17101,2059300700,BX,4701 PALISADE AVENUE,09,Q1,NYC DEPARTMENT OF PARKS AND RECREATION,0,1,-1
17102,4038820045,QN,90-26 82 ROAD,01,B2,"SAMULAK, ANDRZEJ",1,2,-1
17103,4134350037,QN,222-02 147 AVENUE,01,A2,"TAIT, MYHOOD",1,2,-1
17104,3040380001,BK,277 BERRIMAN STREET,01,A5,"HARDY, COURTNEY",3,4,-1
17105,4111840013,QN,109 AVENUE,01,Z0,"WHITE, RAYMOND T",0,1,-1
17106,4134360029,QN,223 STREET,,Z9,UNAVAILABLE OWNER,0,1,-1
17107,4041090047,QN,14-53 141 STREET,01,A2,"HEO, SOOK JA",1,2,-1
17108,4041380001,QN,132-01 20 AVENUE,05,K6,COLLEGE POINT GROCERY OWNERS LLC,1,2,-1
17109,4041830001,QN,20 AVENUE,11,V1,NYC ECONOMIC DEVELOPMENT CORPORATION,0,1,-1
17110,4142472313,QN,10205 JAMES COURT,01,B1,"LIRIANO , ANYELINA",0,1,-1
17111,4131410014,QN,227 STREET,10,G0,PAULA DINES,0,1,-1
17112,4142501470,QN,164 AVENUE,11,V0,CHARLES WURSTER,0,1,-1
17113,4142600060,QN,182-11 EASTERN ROAD,10,G7,LOGAN PROPERTY INC,0,1,-1
17114,1014737504,MN,408 EAST 79 STREET,03,R4,UNAVAILABLE OWNER,1,2,-1
17115,4129840022,QN,132-27 BENNETT COURT,01,A1,"JACKSON, WILLIAM",1,2,-1
17116,3038750003,BK,735 HINSDALE STREET,01,B1,UNAVAILABLE OWNER,0,1,-1
17117,3040830106,BK,717 LINWOOD STREET,01,A5,"BONNEY, CHARLES",1,2,-1
17118,3087200070,BK, CONEY ISLAND AVENUE,,Z7,"OCEANA HOMEOWNERS ASSOCIATION, INC.",0,1,-1
17119,5002270086,SI,368 CLOVE ROAD,01,A1,"ROMAN, ABRAHAM",1,2,-1
17120,2059370498,BX,5255 SYCAMORE AVENUE,01,A9,BENT DAVID B,1,2,-1
17121,4121810018,QN,160-20 111 AVENUE,01,B2,"ESPINOZA, JUDITH B",1,2,-1
17122,2024880001,BX,1166 RIVER AVENUE,10,G6,"HPDC2 HOUSING DEVELOPMENT FUND COMPANY,  INC.",1,2,-1
17123,2025390502,BX, MAJ WM DEEGAN BLVD,07,U1,MTA - METRO NORTH,0,1,-1
17124,3087280058,BK,82 COLERIDGE STREET,01,A7,"KUTSAK, MAKS",1,2,-1
17125,2056440054,BX, FORDHAM STREET,10,G0,PATRICK J LA SCALA,0,1,-1
17126,2027497501,BX,1043 FAILE STREET,02,R2,UNAVAILABLE OWNER,13,14,-1
17127,4158537501,QN,44-19 ROCKAWAY BEACH BLVD,04,RR,UNAVAILABLE OWNER,0,1,-1
17128,4159050148,QN,189 WHITE SANDS WAY,01,B2,"SITU, LAIHONG",1,2,-1
17129,4159050224,QN,66-03 OCEAN AVENUE NORTH,01,B2,"VIRANI, NADIN",1,2,-1
17130,5023960217,SI,16 LUNDI COURT,01,B2,"PITCHERSKY, RYAN",1,2,-1
17131,4129440025,QN,131-33 233 STREET,01,A2,YASIN MAHMOUD,1,2,-1
17132,4160920016,QN,130 MERIDIAN BOULEVARD,01,B2,"FODERA, JOSEPH",1,2,-1
17133,3048730054,BK,885 BROOKLYN AVENUE,01,B2,HACKETT JENETTE,1,2,-1
17134,4046150015,QN,14-15 BURTON STREET,01,A1,"MATSIKAS, VASILIOS",1,2,-1
17135,2024200078,BX,EAST 161 STREET,07,U6,MTA - METRO NORTH,0,1,-1
17136,3048950037,BK,4113 SNYDER AVENUE,01,B3,"LLOYD MELVILLE MOORE, SR., TRUSTEE",1,2,-1
17137,2024200020,BX,EAST 158 STREET,07,U6,MTA - METRO NORTH,0,1,-1
17138,4051750022,QN, BOOTH MEMORIAL AVE,10,G0,YUAN ZHAO,0,1,-1
17139,3006120250,BK,5 ERIE BASIN,06,E9,ERIE BASIN MARINE ASSOCIATES,2,3,-1
17140,2032400004,BX,2655 KINGSBRIDGE TERRACE,01,A5,"ROMAN, CARLOS E",1,2,-1
17141,4136050040,QN,141-16 256 STREET,01,B3,"CHIN, KIRK",1,2,-1
17142,2022927501,BX,469 EAST 147 STREET,04,RM,UNAVAILABLE OWNER,1,2,-1
17143,4137330001,QN,148-28 BROOKVILLE BOULEVARD,01,A2,"CARR, SHIMICA",1,2,-1
17144,5001580155,SI,103 NORTH BURGHER AVENUE,01,B2,ALLEN CHUN HUA LU,0,1,-1
17145,1021010117,MN,WEST 135 STREET,07,U8,NYC DEPARTMENT OF ENVIRONMENTAL PROTECTION,13,14,-1
17146,5031010062,SI,38 HASTINGS STREET,01,A1,THOMAS & ROSEMARIE FLACCVENTO,1,2,-1
17147,4142340539,QN,2 BRIDGE STREET,11,V0,PROJECT REBUILD INC,1,2,-1
17148,4046700054,QN,149-16 20 AVENUE,01,A1,"TEETER, CALE ALLEN",1,2,-1
17149,2034870034,BX,300 ZEREGA AVENUE,11,V1,300 ZER LLC,0,1,-1
17150,4154630001,QN,9 ROAD,11,V1,BENEDETTO MICHAEL & MARY,0,1,-1
17151,4155470047,QN, VIRGINIA STREET,11,V0,MEIR M. ROTH,0,1,-1
17152,4052410020,QN,156 STREET,10,G0,PHILIP AGRO,0,1,-1
17153,4047460026,QN,17-11 FRANCIS LEWIS BLVD,10,G0,17-11 FRANCIS LEWIS REALTY LLC,1,2,-1
17154,4163500352,QN, ROCKAWAY POINT BLVD,11,V0,NYC DEPARTMENT OF CITYWIDE ADMINISTRATIVE SERVICES,0,1,-1
17155,4157490217,QN,10-33 BAY 32 STREET,01,B2,"FEKETE, JUDITH",1,2,-1
17156,5000020022,SI,155 RICHMOND TERRACE,10,G1,NEW YORK WHEEL LLC,0,1,-1
17157,4159050106,QN,172 WHITE SANDS WAY,01,B2,"LI, MING",1,2,-1
17158,5000390033,SI,40 HENDRICKS AVENUE,01,B2,"MINGXIA, LIAO",0,1,-1
17159,4162390086,QN,176 BEACH 130 STREET,02,C3,"HANNA, THOMAS",1,2,-1
17160,2038270044,BX, WATSON AVENUE,10,G7,UNION PORT FOUNDATION,0,1,-1
17161,5000450042,SI,133 HENDRICKS AVENUE,01,A1,"LIN, SEN",0,1,-1
17162,4163180015,QN,179 BEACH 144 STREET,01,A1,"BELFORD, MATTHEW P",1,2,-1
17163,5000010030,SI, BAY STREET,07,U7,MTA - STATEN ISLAND RAILWAY,0,1,-1
17164,5000170091,SI,68 MONTGOMERY AVENUE,10,G7,"ST. GEORGE MONTGOMERY PROPERTIES, LLC",0,1,-1
17165,5000800013,SI,250 YORK AVENUE,01,B9,"ZHENG, JIA YING",0,1,-1
17166,5000970030,SI,314 LAFAYETTE AVENUE,09,Q2,CHILDREN'S AID SOCIETY,1,2,-1
17167,5028730109,SI,21 CHIANTI COURT,01,A5,MOUHAMED H. HALWANI,1,2,-1
17168,5001250075,SI,330 STANLEY AVENUE,01,B2,"RAJA, NASREEN A",1,2,-1
17169,4160380036,QN,64-09 THURSBY AVENUE,02,C0,"WILLIAMS, TYRONE T",1,2,-1
17170,2041420112,BX, MC ALPIN AVENUE,07,U7,NYC TRANSIT AUTHORITY,0,1,-1
17171,5001320221,SI,112 DELAFIELD AVENUE,01,A1,STEVEN & ANDREA BEYER,1,2,-1
17172,2044500047,BX,2559 HONE AVENUE,10,G0,"ZAZA, VINCENT",0,1,-1
17173,3088910146,BK, FANE COURT,11,V1,LACON PROPERTY DEVELOPMENT LLC,0,1,-1
17174,5001550196,SI,417 OAKLAND AVENUE,01,B3,ANN MCMAHON,1,2,-1
17175,4057540018,QN,20-07 169 STREET,01,A1,EUNICE E KIM,1,2,-1
17176,5007950054,SI,697 WILLOWBROOK ROAD,01,A9,"DENG, RICHARD J",1,2,-1
17177,5004250005,SI, WARDWELL AVENUE,10,G0,THOMAS MARONEY,0,1,-1
17178,4051400047,QN,43-45 MAIN STREET,05,K1,SPIRITED DRAGON REAL ESTATE DEVELOPMENT  LLC,1,2,-1
17179,2046760055,BX,822 EAST 218 STREET,02,C0,"RYNER, GERARD S",1,2,-1
17180,3046400017,BK,122 EAST 54 STREET,02,C0,"BYNOE, DEBBIE J",1,2,-1
17181,3057330019,BK,1330 62 STREET,02,C0,"YANG, ZU ZENG",1,2,-1
17182,5002510017,SI,190 HART BOULEVARD,01,A1,JAMES & KATHRYN MARTINO,1,2,-1
17183,2047730018,BX,3031 GUNTHER AVENUE,10,G0,REV R O S BRYANT,0,1,-1
17184,3008860015,BK,314 19 STREET,02,C3,314 PARK SLOPE REALTY LLC,1,2,-1
17185,5005130055,SI,109 BEACH STREET,01,A5,"MEI, YAN XIANG",1,2,-1
17186,5003600020,SI, COLLEGE AVENUE,10,G0,GORE KHURRAM N,0,1,-1
17187,5005340040,SI,15 VANDERBILT AVENUE,11,V0,THE SALVATION ARMY,1,2,-1
17188,5004840030,SI,419 WILLOWBROOK ROAD,01,B2,"PITOSCIA, ANTOINETTA",1,2,-1
17189,4065010046,QN,136-08 64 ROAD,01,A5,"MENDEZ, PEDRO P",1,2,-1
17190,5004770044,SI,319 STEWART AVENUE,01,B2,"ARONSEN, STEVEN",1,2,-1
17191,5007320054,SI,239 BYRNE AVENUE,01,A2,"GAIL MIRANDA, AS TRUSTEE",1,2,-1
17192,4000750009,QN,22-25 JACKSON AVENUE,08,P7,NYC DEPARTMENT OF CULTURAL AFFAIRS,1,2,-1
17193,2049220040,BX,3600 BOLLER AVENUE,02,C0,DAVE S LYNCH,2,3,-1
17194,4059630049,QN,26-25 172 STREET,01,A1,"CONELLI, PATRIZIA",1,2,-1
17195,5009340051,SI, RICHMOND ROAD,09,Z8,UNITED BRETHRENS CHURCH,0,1,-1
17196,5009480045,SI,77 BEACON AVENUE,01,A5,WILLIAM COUNIHAN,1,2,-1
17197,4060250018,QN,32-36 JORDAN STREET,01,A5,DOUGLAS T KARVECKY,1,2,-1
17198,5010500160,SI, CORTLANDT STREET,01,Z0,JOHN J GALL,0,1,-1
17199,3064710013,BK, CROPSEY AVENUE,08,N2,CROPSEY PROPERTIES LLC,3,4,-1
17200,5009510040,SI, ENFIELD PLACE,09,Q0,NYC DEPARTMENT OF PARKS AND RECREATION,0,1,-1
17201,2050810095,BX,4515 WHITE PLAINS ROAD,10,G7,"BLAKE, LLOYD G",0,1,-1
17202,5007140133,SI,178 GOWER STREET,01,A1,"MARTINO, ANN R",1,2,-1
17203,5011580079,SI,60 HOUSMAN AVENUE,01,A1,"VELAZQUEZ, SANDRA",1,2,-1
17204,5011940022,SI,253 VAN NAME AVENUE,01,A1,"RODRIGUEZ, ALFREDO",1,2,-1
17205,5012000083,SI,316 VAN NAME AVENUE,01,A2,MARIE-PAULE MANISCALCO,1,2,-1
17206,4157580043,QN, FAR ROCKAWAY BLVD,07,U7,NYC TRANSIT AUTHORITY,0,1,-1
17207,5012560069,SI,221 GRANDVIEW AVE,06,E1,221 GRANDVIEW AVE ESTATES LLC,0,1,-1
17208,5014370025,SI,99 RIEGELMANN STREET,01,A1,"SCHOEN, ROSEMARIE",1,2,-1
17209,5014890055,SI,241 VEDDER AVENUE,01,Z0,HOLIDAY VILLIAS  HOA,0,1,-1
17210,5007270053,SI,94 WHEELER AVENUE,01,A5,"96 WHEELER AVENUE PROPERTY HOLDING, LLC",1,2,-1
17211,5015040107,SI,462 WILLOWBROOK ROAD,01,B2,"BARONICK, JOAN",1,2,-1
17212,5007280037,SI,66 BRADLEY AVENUE,01,A2,REGINA NOTO FABRIZIO,1,2,-1
17213,1005307508,MN,25 GREAT JONES,04,RM,22 BNDO LLC,1,2,-1
17214,2048980047,BX,1200 EAST 224 STREET,02,C3,JEAN M SMITH,1,2,-1
17215,5007490049,SI,121 WOODWARD AVENUE,01,A2,NATHANIEL KANNER,1,2,-1
17216,5005290034,SI,8 BROWNELL STREET,01,A1,TROIANO GARY,1,2,-1
17217,4069710047,QN,164-28 77 ROAD,01,A1,"ROSA, MANUEL",1,2,-1
17218,5028490028,SI,154 VERMONT AVENUE,01,A1,"RUSSO, VINCENT",2,3,-1
17219,5028570003,SI, WHITE STREET,11,V0,FILIPPO BLANDA,0,1,-1
17220,3013610014,BK,139 UTICA AVENUE,02,C1,141 UTICA LLC,1,2,-1
17221,5010050014,SI,96 ANN STREET,06,E1,"97 PORT RICHMOND AVE, LLC",1,2,-1
17222,2055440017,BX, REVERE AVENUE,10,G0,MILAGRO DIAZ,0,1,-1
17223,4068960025,QN,61-15 168 STREET,01,B2,"LIN, WEI",1,2,-1
17224,5031910150,SI,4 DURGESS STREET,01,A2,E AMOROSO,1,2,-1
17225,5032030028,SI, GRASMERE COURT,11,V0,APRIL ISAMBERT,0,1,-1
17226,5033060053,SI,47 LIBERTY AVENUE,01,B3,"ISMAIL, ERDOAN",1,2,-1
17227,5033210056,SI,85 LIBERTY AVENUE,02,C0,LIBERTY AVE CONSTRUCTION INC,1,2,-1
17228,5006240009,SI,561 RICHMOND ROAD,01,B3,MRS MARY KIRPAN,1,2,-1
17229,5034020025,SI, LANSING STREET,10,G0,FRANK PUGLISI,0,1,-1
17230,5035560003,SI,155 JEFFERSON AVENUE,01,A0,"LOUIS CAPOBIANCO, AS TRUSTEE",1,2,-1
17231,5011320070,SI,46 WALKER STREET,01,B3,"TIERNEY, MICHELLE",1,2,-1
17232,5036790010,SI, HUNTER AVENUE,10,G0,CEKOVIC HAJRODIN,0,1,-1
17233,5037000044,SI,15 MAPLEWOOD PLACE,05,K1,ABUPLUS LLC,0,1,-1
17234,5012120061,SI,33 DE HART AVENUE,01,B2,"REBECCA NICHOLAS-GRAY, TRUSTEE",1,2,-1
17235,2048700046,BX,1020 EAST 224 STREET,01,B1,"WIREDU, WENDY",1,2,-1
17236,1001910008,MN,14 WHITE STREET,10,G6,14 WHITE STREET LLC,0,1,-1
17237,1001590040,MN,128 PARK ROW,08,Y3,US GENERAL SERVICES ADMINISTRATIONN,1,2,-1
17238,3067650046,BK,1590 EAST 19 STREET,04,D7,1590 EAST 19TH STREET LLC,0,1,-1
17239,3067650066,BK,1579 EAST 18 STREET,01,B2,"HERSKOWITZ, MORDECHAI",1,2,-1
17240,3012600026,BK,451 EASTERN PARKWAY,08,M1,NORTHEASTERN CONFERENCE CORPN OF 7TH DAY  ADVENTIST,1,2,-1
17241,5044780087,SI,150 CORONA AVENUE,01,A5,"MIGLIORATO, GRACE",1,2,-1
17242,4142280220,QN, BAYVIEW AVENUE,11,V0,THOMAS P COYNE,0,1,-1
17243,4079860054,QN, BRADDOCK AVENUE,05,O5,UNAVAILABLE OWNER,0,1,-1
17244,5051570039,SI,3941 HYLAN BOULEVARD,11,V0,HLT DEVELOPMENT LLC,1,2,-1
17245,5051900035,SI, FAIRLAWN AVENUE,11,V0,WATERRSEDGE AT GREAT KILLS HOME-   OWNER S ASSN INC,0,1,-1
17246,3069440007,BK, SHORE PARKWAY,11,V0,EXCELSIOR YACHT CLUB,0,1,-1
17247,5053060070,SI,236 WIMAN AVENUE,11,V0,GGAA REALTY LLC,0,1,-1
17248,5053230003,SI,55 LYNDALE AVENUE,01,A2,"BALLARO, STEVEN",1,2,-1
17249,4080360006,QN, GROSVENOR STREET,10,G0,VERGIRIS KYRIAKOS,0,1,-1
17250,5002200090,SI,861 FOREST AVENUE,01,B1,FORET JARDIN CORP,1,2,-1
17251,4003000002,QN,30-21 STARR AVENUE,10,G7,STARR REALTH CO (NE) LLC,0,1,-1
17252,5055200050,SI,3519 RICHMOND AVENUE,11,V0,RICHMOND 45 INC.,0,1,-1
17253,5064310023,SI, DISCALA LANE,11,V0,PERRY CRISCITELLI,0,1,-1
17254,5065590137,SI,222 BILLIOU STREET,01,A3,UNAVAILABLE OWNER,0,1,-1
17255,4015130042,QN,41-41 GLEANE STREET,01,A1,"SAJULGA, ANITA LUZ A",1,2,-1
17256,4124790041,QN,176-21 SUNBURY ROAD,01,A2,"MANOHAR, MAHAESH",1,2,-1
17257,5069790158,SI,92 EL CAMINO LOOP,01,B9,"SIMONCELLI, CHRISTOPHER",1,2,-1
17258,3070850113,BK,164 VAN SICKLEN STREET,01,A3,UNAVAILABLE OWNER,0,1,-1
17259,5013180211,SI,152 HOLLAND AVENUE,01,A5,DERICK DARKO OBENG,1,2,-1
17260,5070930057,SI,11 CRABTREE AVENUE,01,A5,FLORIO ANTHONY,1,2,-1
17261,5013180132,SI, HOLLAND AVENUE,11,V0,"CALLAHAN, PETER",0,1,-1
17262,5077520057,SI,6716 AMBOY ROAD,01,A1,MARY ANNE LANGE TOTH,1,2,-1
17263,5014400005,SI,161 WILLOWBROOK ROAD,01,A2,"FOTINATOS, DAMION",2,3,-1
17264,5015220052,SI,202 HAWTHORNE AVENUE,01,Z0,ROSE CHILLI,0,1,-1
17265,3009980016,BK,274 7 STREET,01,B9,274 7TH ST LLC,2,3,-1
17266,4015920202,QN,43 AVENUE,11,V0,"LAM, ALAN",0,1,-1
17267,3076390069,BK,1314 EAST 22 STREET,01,A1,GOLDBERG ELIEZER,2,3,-1
17268,5078630276,SI,21 FOREST LANE,01,A5,PELLEGRINO MICHAEL P,1,2,-1
17269,5019910026,SI,41 CONRAD AVENUE,01,A5,"SINCLAIR, CRAIG",1,2,-1
17270,5078670137,SI,363 SLEIGHT AVENUE,01,A2,"D'AMBROSIO, JESSI",1,2,-1
17271,3013110058,BK,563A EMPIRE BOULEVARD,04,S2,ROYAL BLUE REALTY CORP,1,2,-1
17272,5079090038,SI,510 MAIN STREET,01,A1,WAYNE VOSBRINK,1,2,-1
17273,5060280027,SI,32 PRATT COURT,01,A5,ANDREA VELAZQUEZ,1,2,-1
17274,5080480057,SI,39 BENTLEY LANE,01,B2,CASALASPRO BARBARA,1,2,-1
17275,3013617501,BK,1204 ST MARKS AVENUE,02,R1,UNAVAILABLE OWNER,1,2,-1
17276,5022880122,SI,421 EDINBORO ROAD,01,A1,SUSAN A MCDERMOTT,1,2,-1
17277,1003460150,MN,145 CLINTON STREET,05,O6,SITE 3 DSA OWNER LLC,0,1,-1
17278,5057060018,SI,148 SHELDON AVENUE,01,A5,ANNA MARIA CARROLL TRUSTEE,1,2,-1
17279,3053500069,BK,1421 36 STREET,08,I6,WOMEN'S LEAGUE COMMUNITY RESIDENCES INC,1,2,-1
17280,3078500079,BK,1494 EAST 53 STREET,01,A9,"BENHARUSH, NIR",1,2,-1
17281,4136050010,QN,140-59 255 STREET,04,S1,PIERRE VINCENT,1,2,-1
17282,3015840009,BK,366 STOCKTON STREET,04,D6,366 STOCKTON REALTY LLC,0,1,-1
17283,3015930039,BK,1046 BROADWAY,04,S2,CLASON MANAGEMENT,0,1,-1
17284,5028730111,SI,27 CHIANTI COURT,01,A5,"CHEN, JESSIE MEIYUN",1,2,-1
17285,5029660005,SI,224 CHESTNUT STREET,01,B2,CARMINE LENZO,2,3,-1
17286,1017207501,MN,1 MT MORRIS PARK WEST,03,R4,UNAVAILABLE OWNER,8,9,-1
17287,1019570020,MN, ST NICHOLAS AVENUE,11,V5,NYS DORM AUTH,0,1,-1
17288,3082350010,BK,10830 FLATLANDS AVENUE,05,K5,"KFC U.S. PROPERTIES, INC.",1,2,-1
17289,4098940086,QN,90-64 179 STREET,01,B2,"BISSOONDIAL, MOHAN",1,2,-1
17290,4083000055,QN, DOUGLASTON PARKWAY,07,U2,CONS EDISON CO,0,1,-1
17291,5014780490,SI,91 HOUSTON STREET,01,A9,CARDELLA ANNA,1,2,-1
17292,4085740129,QN,81-19 251 STREET,01,A1,"RANA, PREHLAD",1,2,-1
17293,2025260010,BX,1080 SUMMIT AVENUE,02,C0,"VERA, ARLES",2,3,-1
17294,5030600001,SI, OVERLOOK COURT,,Z9,C TIGLAO JR,0,1,-1
17295,5007230035,SI,48 PERRY AVENUE,01,B3,UNAVAILABLE OWNER,1,2,-1
17296,3023690029,BK,26 MARCY AVENUE,04,S2,UNAVAILABLE OWNER,0,1,-1
17297,5055260025,SI,3447 RICHMOND AVENUE,01,B2,LUCIANO DEVITO,1,2,-1
17298,4118930046,QN,124-22 SOUTH CONDUIT AVENUE,01,A1,"BALDEO, PHILIP",1,2,-1
17299,4130670001,QN,142-29 222 STREET,01,B3,"PERRIN, MELVINA LYNN",1,2,-1
17300,5054410037,SI,329 DEWEY AVENUE,01,B3,L & T NELSON,5,6,-1
17301,5031670039,SI, BALTIC AVENUE,11,V0,"SCIASCIA, JONI",0,1,-1
17302,4118620046,QN,129 STREET,11,V0,CLAUDIE EUGENE,0,1,-1
17303,2032190140,BX,2457 DEVOE TERRACE,02,C0,DUDHNATH  BHAGWAN,2,3,-1
17304,5080340039,SI,25 HALE STREET,01,A1,GAIL HAFELE,1,2,-1
17305,4003640012,QN,37-07 21 STREET,07,G2,"YARDLEY ASSOCIATES, LLC",2,3,-1
17306,2034360133,BX,100 LIGHTHOUSE COURT,01,B2,"MEDINA, VIVIAN",1,2,-1
17307,3027640038,BK,133 DEVOE STREET,03,D1,131 DEVOE STREET LLC,1,2,-1
17308,4004740031,QN,38-11 10 STREET,05,H2,HKOQ LLC,1,2,-1
17309,5032370063,SI,26 MALLORY AVENUE,01,A2,JAMES MCHENRY,1,2,-1
17310,4113380012,QN,76-09 BLAKE AVENUE,10,G7,STEVEN LOWERY,0,1,-1
17311,4005700023,QN,30-85 23 STREET,02,C0,CALOGERA CARLINO IRREVOCABLE ASSET,1,2,-1
17312,5032510004,SI, MC CLEAN AVENUE,11,V0,"MCCLEAN DEVELOPERS, LLC",0,1,-1
17313,2039190055,BX, BEACH AVENUE,10,G0,JAMES A SMITH,0,1,-1
17314,5007260015,SI,127 WHEELER AVENUE,01,B2,ZIAD SHOMAN,1,2,-1
17315,4006830074,QN,30-42 42 STREET,02,C2,C&C 42ND REALTY LLC,1,2,-1
17316,5007370022,SI,170 KELL AVENUE,01,A2,MARY ELLEN BARANSKI,1,2,-1
17317,2040620310,BX, POPLAR STREET,10,G0,BESSIE HORMON,0,1,-1
17318,5035000029,SI,481A FR CAPODANNO BLVD,01,B9,"CAJITA, DENNIS",1,2,-1
17319,5035000141,SI,449 FATHER CAPODANNO BL,01,A5,"MARTIN, DONALD",1,2,-1
17320,2040810033,BX,2619 CHESBROUGH AVENUE,10,G6,2619 LLC,0,1,-1
17321,4008750035,QN,23-19 23 STREET,01,A5,"SEHOU, ADAM",1,2,-1
17322,2041690027,BX,1725 CROSBY AVENUE,05,O7,1725 CROSBY REALTY LLC,1,2,-1
17323,3036910011,BK, ATLANTIC AVENUE,10,G7,CRYSTAL BLUE LLC,0,1,-1
17324,4098840043,QN,175-06 DEVONSHIRE ROAD,03,D4,175 06 OWNERS CORP,1,2,-1
17325,2044490090,BX, LURTING AVENUE,10,G0,2433 LURTING LLC,0,1,-1
17326,4089750063,QN,94-06 89 AVENUE,01,B2,"JIANG, XIANG JING",2,3,-1
17327,5035620079,SI,62 ADAMS AVENUE,01,A5,"LI  MAI, LINDA",1,2,-1
17328,4012080032,QN,38-23 55 STREET,07,U2,LIRR,2,3,-1
17329,4089830044,QN,91-47 89 STREET,01,A9,"RIOS , CAROLINA",1,2,-1
17330,4090160013,QN,83-19 ROCKAWAY BOULEVARD,10,G0,HARRY VASS,0,1,-1
17331,4090590063,QN,97-54 87 STREET,07,G2,UNAVAILABLE OWNER,0,1,-1
17332,5040490008,SI,172 WINHAM AVENUE,01,A2,PONESSE ANDREW,1,2,-1
17333,2048440008,BX,761 EAST 230 STREET,01,A1,"SINGH, RAVIN",1,2,-1
17334,2048510025,BX,831 EAST 226 STREET,02,C0,"SENIOR, HYLTON",1,2,-1
17335,4015380087,QN,80-25 CORNISH AVENUE,08,M9,CHRISTIAN REVIVAL TEMPLE A/K/A     TEMPL O DEL AVIVAMIENTO CRISTIANO,1,2,-1
17336,4016570020,QN,105-05 DITMARS BOULEVARD,01,B3,"PATEL, INDIRA",1,2,-1
17337,4094710037,QN,95-25 129 STREET,01,B3,"SINGH, SUKHJINDER",1,2,-1
17338,2049690040,BX, SECOR AVENUE,11,V0,"OSUJI, ROSE C",0,1,-1
17339,5021580009,SI, FOREST STREET,11,V0,THOMAS CRILLY,0,1,-1
17340,3045580095,BK,654 SAPPHIRE STREET,01,B2,"HINOJOSA, MARTA",1,2,-1
17341,3045860887,BK,600 VANDALIA AVENUE,01,B2,"HAYES, MELISSA DENISE",1,2,-1
17342,5042310012,SI,132 BEACH AVENUE,01,A1,MICHAEL A TANTILLO,2,3,-1
17343,4110170045,QN,114-61 200 STREET,01,A5,"DALEY, RYAN",1,2,-1
17344,5026250121,SI,131 BURKE AVENUE,01,B2,"MILLER, JULIA",1,2,-1
17345,4091790030,QN,85-70 102 STREET,01,B2,"8570 102ND STREET, LLC",1,2,-1
17346,2039040034,BX,EAST 177 STREET,07,U6,NYS DEPARTMENT OF TRANSPORTATION,0,1,-1
17347,4023990032,QN,68-19 JAY AVENUE,02,C0,GENISE ROBERT,2,3,-1
17348,4092260084,QN,113-05 JAMAICA AVENUE,04,S2,"RUPNARAIN, SURUJDYAL",1,2,-1
17349,5050210068,SI,115 BAY TERRACE,01,Z0,WM BEVERIDGE,0,1,-1
17350,5080200065,SI,127 BARNARD AVENUE,01,A1,SANDRA A MILLER,1,2,-1
17351,5050900058,SI,3534A AMBOY ROAD,01,B9,ALBERT FINKELSHTEYN,1,2,-1
17352,2055770003,BX, DEWEY AVENUE,10,G0,"POUCHIE, NAOMI",0,1,-1
17353,2056250224,BX, BUCKLEY STREET,11,V0,BREEN JAMES S,0,1,-1
17354,2056260378,BX,73 WINTERS STREET,01,A2,ELLEN CRIBBEN,1,2,-1
17355,5077550011,SI,156 CAMDEN AVENUE,01,A5,DIANNE SERGI,1,2,-1
17356,2056410110,BX, CITY ISLAND AVENUE,10,G7,SO MINNEFORD YACHT CLUB,0,1,-1
17357,4092880081,QN,102-13 88 AVENUE,01,A1,R A VOSS,1,2,-1
17358,5075840060,SI,4884 ARTHUR KILL ROAD,05,K1,RBK PROPERTIES CORP.,1,2,-1
17359,5052120200,SI, NELSON AVENUE,09,Q1,NYC DEPARTMENT OF PARKS AND RECREATION,0,1,-1
17360,5052680148,SI,276 WINCHESTER AVENUE,01,A2,"DELACY, THOMAS",1,2,-1
17361,3004410030,BK,226 4 AVENUE,04,S9,BIMLESH AGGARWAL,1,2,-1
17362,4027160013,QN,56 DRIVE,10,G7,64-15 GRAND AVE LLC,0,1,-1
17363,2058831164,BX,306 WEST 262 STREET,01,A1,MALACH SOLOMON,1,2,-1
17364,5052970057,SI,16 RIDGECREST AVENUE,01,A2,"GILCHER, BETTYANN",1,2,-1
17365,3050280086,BK,39 MAPLE STREET,01,A1,HENNING JUSTINE H,1,2,-1
17366,5008590025,SI,130 VISTA AVENUE,04,S2,"ALRAWHANI, SALAH",1,2,-1
17367,4028270053,QN,79 STREET,10,G0,"DARPINO, JESSICA",0,1,-1
17368,3050430005,BK,1935 BEDFORD AVENUE,01,A1,"BEDFORD HOLDINGS JV, LLC",2,3,-1
17369,4093610001,QN,133 STREET,07,U7,LIRR,0,1,-1
17370,5072060294,SI, INDUSTRIAL LOOP,,Z9,M A G PROPERTIES II L,0,1,-1
17371,3011770037,BK,449 LINCOLN PLACE,08,M9,CHURCH OF GOD,1,2,-1
17372,5054520027,SI, WILSON AVENUE,07,U6,MTA - STATEN ISLAND RAILWAY,0,1,-1
17373,4094390054,QN,94-19 121 STREET,01,B2,"RAMRATTAN, SOHAN A.",1,2,-1
17374,4104460027,QN,90-30 191 STREET,02,C0,"WAIDOE, MOHESKUARI",2,3,-1
17375,4033690126,QN,4-84 RICARD STREET,10,G0,BRZOZOWSKI LESZEK,0,1,-1
17376,4100210010,QN,143-19 102 AVENUE,01,B2,"NAIPAUL, MONICA",1,2,-1
17377,3054200006,BK,845 SETON PLACE,08,I7,UNAVAILABLE OWNER,0,1,-1
17378,3014710007,BK,507 HOWARD AVENUE,02,C0,NYC HOUSING AUTHORITY,1,2,-1
17379,4098060034,QN,90-05 171 STREET,11,V0,RISHAB INC.,1,2,-1
17380,4094400069,QN,93-06 124 STREET,01,A9,"RAMSAYWACK, CHAMPAWATTIE",1,2,-1
17381,5056640100,SI,151 GRANTWOOD AVENUE,01,A1,TESTAMENTARY TRUST OF JENNIE BACAS,1,2,-1
17382,4094500070,QN,94-21 134 STREET,01,B3,"HOLT, LESTER",1,2,-1
17383,4094670015,QN,95-20 127 STREET,01,B3,"MOHAMMED, ASLAM",1,2,-1
17384,4093560001,QN,127-08 91 AVENUE,06,F1,VIOLET J ROMANN,1,2,-1
17385,4038110065,QN,77-58 74 STREET,01,A5,HUBER RICHARD H,1,2,-1
17386,5062360044,SI, ARDEN AVENUE,11,V0,R RIEDER,0,1,-1
17387,3058020055,BK,7 AVENUE,11,V1,PENTECOSTAL CHRISTIAN CHURCH,1,2,-1
17388,4038820052,QN,90-36 82 ROAD,01,B1,"GARCIA, GARY",1,2,-1
17389,5064750040,SI, BERTRAM AVENUE,11,V0,ST JOSEPH BY THE SEA HIGH SCHOOL,0,1,-1
17390,2048040100,BX,1824 ALLERTON AVENUE,07,T9,NYC TRANSIT AUTHORITY,10,11,-1
17391,5065800068,SI, ANDROVETTE AVENUE,11,V0,AMSIRAC LLC,0,1,-1
17392,4045430078,QN,154-21 POWELLS COVE BLVD,01,A1,"COMITO, PATRICIA",1,2,-1
17393,5065860017,SI,5504 AMBOY ROAD,01,B2,HUI ZHENG,1,2,-1
17394,3023690028,BK,24 MARCY AVENUE,04,S2,UNAVAILABLE OWNER,0,1,-1
17395,4095890033,QN,103-25 135 STREET,01,B1,UNAVAILABLE OWNER,1,2,-1
17396,4095920078,QN,104-36 133 STREET,11,V0,ARYA SPIRITUAL CENTER IN,0,1,-1
17397,4038120101,QN, COOPER AVENUE,11,V0,NYS DEPARTMENT OF TRANSPORTATION,0,1,-1
17398,4047280010,QN,1614 FRANCIS LEWIS BLVD,01,B2,"DOUKAKIS, EMMANUEL",1,2,-1
17399,3057087502,BK,943 60 STREET,04,RM,83888 CONDOMINIUM,1,2,-1
17400,5075960279,SI,37 TILLER COURT,01,A5,"CAPORUSSO, CATHERINE",1,2,-1
17401,5077020286,SI,42 PENTON STREET,01,A5,NYDIA R PEREZ,1,2,-1
17402,4097690004,QN,159-11 HILLSIDE AVENUE,04,S2,FIVE DEVELOPMENT LLC,1,2,-1
17403,5077550009,SI,162 CAMDEN AVENUE,01,A5,"CHEKERA, OLEG",1,2,-1
17404,5078120058,SI, JOLINE AVENUE,10,G0,"BRUCKMAN, MAE L",0,1,-1
17405,5022360053,SI,42 DANNY COURT,01,A5,"DONOVAN, FRANCIS",1,2,-1
17406,3057130052,BK,1473 60 STREET,01,B1,1473 REALTY LLC,1,2,-1
17407,3032710015,BK,352 STANHOPE STREET,02,C2,"DIMARIA, GIUSEPPE",1,2,-1
17408,3032750039,BK,100 HIMROD STREET,02,C1,100 HIMROD STREET II LLC,0,1,-1
17409,4052590033,QN,191 STREET,10,G0,"KANG, YOUNG HWA",0,1,-1
17410,3030517501,BK,89 MONTROSE AVENUE,02,R1,UNAVAILABLE OWNER,0,1,-1
17411,5052890012,SI,132 PACIFIC AVENUE,01,A1,JOSEPH IRACI,1,2,-1
17412,4053850031,QN,155-16 SANFORD AVENUE,04,S2,"KIM, YI SIK",1,2,-1
17413,3036440001,BK, ROCKAWAY AVENUE,07,U6,NYC TRANSIT AUTHORITY,0,1,-1
17414,4017800032,QN,108-68 39 AVENUE,02,C0,SEGUNDO A ZHAGUI,1,2,-1
17415,3024550032,BK,61 SOUTH 6 STREET,,Z9,RATE HOLDING INC,0,1,-1
17416,3031610015,BK,17 STANWIX STREET,,Z9,WIN KAY MANAGEMENT LLC,0,1,-1
17417,3031710069,BK, TROUTMAN STREET,02,C1,TROUTMAN GARDEN PARTNERS LLC,0,1,-1
17418,5001610112,SI, NORTH BURGHER AVENUE,11,V0,JENSON DEVELOPMENT INC.,0,1,-1
17419,4057900030,QN,22-08 201 STREET,01,A0,JOHN J CURLEY,1,2,-1
17420,4096170009,QN,136-06 HILLSIDE AVENUE,01,B1,"TAVERAS, BIENVENIDO",1,2,-1
17421,4059770009,QN,26-49 202 STREET,01,A2,MCCARTHY LOREEN A,1,2,-1
17422,4059930017,QN,209-22 27 AVENUE,01,A2,"GE, KENNETH",1,2,-1
17423,5019910037,SI,138 ASHWORTH AVENUE,01,A5,"HUANG, VINCENT CHENG",1,2,-1
17424,4060430009,QN,32-06 208 STREET,01,A5,"GUZMAN, ENRIQUE A",1,2,-1
17425,5042310115,SI,80 7 STREET,01,A1,JEFFREY A PALAZZO,1,2,-1
17426,3044520840,BK,577 VANDALIA AVENUE,01,B2,"OTTY , NGOZI",1,2,-1
17427,4088870025,QN,85-44 96 STREET,01,A1,"LAW, SPENCER",1,2,-1
17428,5010500060,SI,27 CORNELL STREET,01,A9,"DIGIROLAMO, MARY A",1,2,-1
17429,4099280016,QN,89-21 187 STREET,01,A1,DOFREDO  FLORENTINO E,2,3,-1
17430,3047610022,BK,EAST 51 STREET,11,V0,"HINDS, STEPHON J",0,1,-1
17431,4078420014,QN,224-01 UNION TURNPIKE,05,K1,UNAVAILABLE OWNER,0,1,-1
17432,4100320015,QN,148 STREET,11,V0,PORTUGESE AMERICAN CULTURAL CENTER,0,1,-1
17433,3049700067,BK,1351 BROOKLYN AVENUE,11,V0,1351 BROOKLYN AVENUE LLC,1,2,-1
17434,3062480053,BK,1781 78 STREET,01,B2,"LIN, XIAN TAO",1,2,-1
17435,4100610035,QN,105 AVENUE,,Z9,"SCACCIA PROPERTY HOLDINGS VI, LLC",0,1,-1
17436,1008790052,MN,150 EAST 24 STREET,10,G1,24TH STREET MMP GARAGE LLC,1,2,-1
17437,4082320397,QN,249-51 RUSHMORE TERRACE,01,A1,COFFARO ROBERT & ANNA,1,2,-1
17438,3062600040,BK,1782 78 STREET,02,C0,ALFREDA GABANSKA,1,2,-1
17439,3052120041,BK,2502 NEWKIRK AVENUE LLC,02,C1,2506 NEWKIRK AVENUE LLC,1,2,-1
17440,4088210001,QN,262 STREET,11,V0,"MICELI, NICHOLAS",0,1,-1
17441,5069680042,SI,1101 RENSSELAER AVENUE,01,A5,JAMES LADIS,1,2,-1
17442,5065300001,SI, CHESTER AVENUE,11,V1,NYC DEPARTMENT OF PARKS AND RECREATION,0,1,-1
17443,5063240021,SI,5295 AMBOY ROAD,01,B2,"LIN, DI",1,2,-1
17444,4101920014,QN,164-10 110 ROAD,11,V0,RESCUE CHURCH OF CHRIST,0,1,-1
17445,4129440009,QN,131-67 233 STREET,01,A2,EVA GLENN,1,2,-1
17446,1011820049,MN,342 WEST 71 STREET,05,HR,RIVERSIDE STUDIOS LLC,1,2,-1
17447,1011840003,MN,1 RIVERSIDE DRIVE,08,M1,ISLAMIC CENTER OF NEW YORK,1,2,-1
17448,5045970040,SI,141 ELKHART STREET,01,A2,RONALD J PERROTTA,1,2,-1
17449,4102130007,QN,172-14 JAMAICA AVENUE,04,D6,PARTHENON LLC,0,1,-1
17450,4060260024,QN,32-38 200 STREET,01,A5,"SAVARINO, WILLIAM J.",1,2,-1
17451,4093310050,QN,121 STREET,07,U7,LIRR,0,1,-1
17452,5043370006,SI, AMBOY ROAD,10,G0,"SPADAFORA, ANTHONY",0,1,-1
17453,4093930036,QN,94-19 109 STREET,01,B1,"KAUR, PARAMJEET",1,2,-1
17454,5028580015,SI, MARYLAND AVENUE,11,V0,CHARLES FALETTA,0,1,-1
17455,4125290240,QN,126-02 172 STREET,02,C0,"BRATHWAITE, MELVIN",1,2,-1
17456,4094450029,QN,94-04 130 STREET,11,V1,NYC DEPARTMENT OF CITYWIDE ADMINISTRATIVE SERVICES,0,1,-1
17457,3065120026,BK,848 EAST 10 STREET,01,A9,"TAWIL, RAPHAEL",1,2,-1
17458,5057350432,SI,115 PRESENTATION CIRCLE,01,A5,"BARBELLA, KATHERINE",1,2,-1
17459,3059470075,BK,43 77 STREET,01,A1,"TZITZIKALAKIS, JOHN",1,2,-1
17460,4103760033,QN,105-24 189 STREET,01,A1,DEWALT WILBERT,1,2,-1
17461,2027720072,BX,416 COSTER STREET,11,V1,DAMAN-E-P. LLC,0,1,-1
17462,4102130064,QN,172 STREET,11,V0,SHRI SURYANARAYAN MANDIR INC,0,1,-1
17463,4095490053,QN,107-57 111 STREET,01,B3,"VICUNA, CARLOS",1,2,-1
17464,4093560035,QN,92 AVENUE,07,U9,NYC DEPARTMENT OF ENVIRONMENTAL PROTECTION,0,1,-1
17465,3060460044,BK,79 88 STREET,01,A9,"CORSI, MARY ELIZABETH",1,2,-1
17466,4095920037,QN,133 STREET,10,G0,SINGH VIRJANAND,0,1,-1
17467,3039240048,BK,162 CLEVELAND STREET,01,A1,SHIWRAM CHANDROWTIE,1,2,-1
17468,4103030021,QN,112-07 179 STREET,01,A1,"MANBODH, SURESHWAR K",0,1,-1
17469,4107380014,QN,221-62 91 ROAD,01,A1,"BALKARAN, TERRENCE",2,3,-1
17470,3074160013,BK,EAST 15 STREET,01,B1,UNAVAILABLE OWNER,0,1,-1
17471,4008720007,QN,23-25 ASTORIA BOULEVARD,11,V1,23-25 ASTORIA BLVD LLC,0,1,-1
17472,3074221032,BK,3758 NOSTRAND AVENUE,05,K1,RS NOSTRAND LLC,1,2,-1
17473,3049520043,BK,3517 AVENUE D,01,A9,MARION BOYKIN JR,1,2,-1
17474,3040100014,BK,309 VAN SICLEN AVENUE,02,C1,309 VAN SICLEN AVE LLC,0,1,-1
17475,4098840001,QN,175-39 HIGHLAND AVENUE,03,D1,DALNY 175 LLC,2,3,-1
17476,4105160090,QN,86-97 PALO ALTO STREET,01,A1,"HOPPE, JR., KURT E.",1,2,-1
17477,3041570056,BK,356 CHESTNUT COURT,01,B2,"RAMJEET, JAGDESH",1,2,-1
17478,5029170021,SI,1987 CLOVE ROAD,01,A5,"GARGANTIEL SEMBRANO, MIA PAYOMO",0,1,-1
17479,4100410012,QN,104-14 PINEGROVE STREET,01,B2,BOOKER T. RICHARDSON,1,2,-1
17480,5029170023,SI,1983 CLOVE ROAD,01,A5,"NG, CHUI YEE TRACY",0,1,-1
17481,5026320017,SI,100 SHELLEY AVENUE,01,A1,JEFFREY SANTORA,2,3,-1
17482,5016960047,SI,464 VAN NAME AVENUE,01,A5,"CICE, ABIB",1,2,-1
17483,5030380055,SI,12 RODERICK AVENUE,01,A5,"XIE, YIXIAO",0,1,-1
17484,4051750027,QN,148 STREET,10,G0,WAI BEN TOW,0,1,-1
17485,2039720041,BX,1552 PARKER STREET,02,C1,PRS MANAGEMENT LLC,1,2,-1
17486,2039810100,BX, LANE AVENUE,09,Q1,NYC DEPARTMENT OF PARKS AND RECREATION,0,1,-1
17487,4102440199,QN,170 STREET,11,V0,MELVIN & JUANITA GREEN,0,1,-1
17488,2046850022,BX,EAST 214 STREET,11,V0,WILWORTH BENJAMIN,0,1,-1
17489,5055230075,SI,66 SWEETBROOK ROAD,01,A1,"RICHIUSA, CHARLES",1,2,-1
17490,2040300044,BX, FILLMORE STREET,11,V0,"STEVERINO, CLAUDIA",0,1,-1
17491,5043360022,SI, VINCENT AVENUE,10,G0,"IANUZZI, CHRISTINE C",0,1,-1
17492,4104840098,QN,90-17 202 STREET,01,A1,"RAFEEK, MOHAMED",2,3,-1
17493,4060220006,QN,29-02 200 STREET,02,C0,"MA, WILLIAM V",1,2,-1
17494,3070160127,BK,2837 WEST 23 STREET,01,A5,JING RAN FENG A/K/A V,1,2,-1
17495,4092790096,QN,86-45 125 STREET,01,B2,"RATHBONE, JUDITH",1,2,-1
17496,4115010051,QN,133-64 PECONIC STREET,01,B3,"FOLEY, MICHAEL J",1,2,-1
17497,3045700122,BK,1148 ELDERT LANE,01,B1,"WHARTON, NANETTE",1,2,-1
17498,4121990053,QN,115-31 159 STREET,01,B1,"BRIDGEMOHAN, AARON",0,1,-1
17499,3071000011,BK,2014 WEST 5 STREET,10,G0,"MORRONE, CARMELA",0,1,-1
17500,5031250193,SI,143 OCEAN AVENUE,01,A5,MANDY SOWAN,1,2,-1
17501,3045950215,BK,1022 EAST 93 STREET,04,D7,"RUTLAND ROAD HOUSES, INC.",5,6,-1
17502,5005290008,SI,78 BROAD STREET,01,B3,"SPEZIO, ROGER",1,2,-1
17503,4115990055,QN,109-27 118 STREET,01,B3,"MOHAN, SURUJNAUTH",1,2,-1
17504,5013180209,SI,148 HOLLAND AVENUE,01,A5,FREDDIE MAC,1,2,-1
17505,5033300013,SI,226 BURGHER AVENUE,01,B3,"ABDULHAQ, RAJA",1,2,-1
17506,4116190035,QN,114-19 LINDEN BOULEVARD,01,A1,"RAMJATTAN, CHANARDAI",1,2,-1
17507,3072790024,BK,606 SHEEPSHEAD BAY ROAD,07,U8,SOUTH BROOKLYN RAILROAD,0,1,-1
17508,3087360096,BK,124A EXETER STREET,10,G0,"RICHARD INGSTER, AS TRUSTEE",0,1,-1
17509,4118590007,QN,125-05 149 AVENUE,01,B2,"PRASHAD, JEAN",2,3,-1
17510,3087530010,BK,121 JAFFRAY STREET,01,A1,NORMAN AND MARY ANN MARCHETTI LIVING TRU ST,2,3,-1
17511,2047900035,BX,2910 WICKHAM AVENUE,01,B2,W2910 LLC,0,1,-1
17512,4119690025,QN,114-42 140 STREET,10,G0,"JOHNSON, JOSEPH",0,1,-1
17513,4117780024,QN,131-05 131 AVENUE,01,B2,UNAVAILABLE OWNER,0,1,-1
17514,3088661766,BK,3 KEEN COURT,10,G0,"QUINN, CAROL A",0,1,-1
17515,5027740023,SI,114 CANNON AVENUE,01,A2,PAUL QUICK,1,2,-1
17516,4014060039,QN,94-15 32 AVENUE,01,A1,"GRANT, CLAUDETTE A",1,2,-1
17517,4046830005,QN,150-42 15 DRIVE,01,B3,"SAVIDIS, GEORGE",1,2,-1
17518,2048540073,BX,838 EAST 230 STREET,02,C0,"CAMPBELL, LEEBERT",1,2,-1
17519,4005720015,QN,23-11 30 ROAD,10,G7,MOUNT SINAI HOSPITAL,0,1,-1
17520,3075920030,BK,937 EAST 28 STREET,01,A1,"ROSANEL, JOSEPH",1,2,-1
17521,4120990014,QN,135 AVENUE,07,U2,CON EDISON,0,1,-1
17522,5005310020,SI,58 HARRISON STREET,01,B3,"SANTINELLO, ELIZABETH",1,2,-1
17523,5034120039,SI,68 MC LAUGHLIN STREET,01,B2,MICHAEL/MINDY  TAYLOR,1,2,-1
17524,4006870131,QN,42 STREET,10,G0,RAFFAELE DEL GRECO,0,1,-1
17525,4082620040,QN, GLENWOOD STREET,11,V0,REMICA PROPERTY GROUP CORP.,0,1,-1
17526,3077490076,BK,4595 KINGS HIGHWAY,01,A5,"FORRESTER, PAULINE H",1,2,-1
17527,4007090001,QN,44-19 BROADWAY,11,V1,"GINA ARGENTO, AS TRUSTEE",1,2,-1
17528,2050340050,BX,4320 BRONX BOULEVARD,07,G2,4320 REALTY LLC,2,3,-1
17529,5041970006,SI,201 3 STREET,01,B2,"SLANE DEVELOPERS, LLC",1,2,-1
17530,3077980052,BK,1825 UTICA AVENUE,06,F5,"52 REALTY ASSOCIATES, LLC",1,2,-1
17531,4008500050,QN,20 AVENUE,07,U2,"ASTORIA GENERATING COMPANY ACQUISITIONS,  L.L.C.",26,27,-1
17532,4120380034,QN,142-52 122 AVENUE,01,A1,DANIEL JACQUELINE L.R.,2,3,-1
17533,3082180052,BK,EAST 92 STREET,10,G7,GRACE CHURCH OF BROO,0,1,-1
17534,2046140001,BX, BURKE AVENUE,10,G7,TRINITY FAITH PENTECOSTAL CHURCH OF GOD,0,1,-1
17535,3083660066,BK,36 BERGEN BEACH PLACE,01,A9,CARLOS LANTOK,1,2,-1
17536,4126570014,QN,119-16 201 PLACE,01,B2,"ALLY, NEAZABAM",0,1,-1
17537,4126640003,QN,120-09 FARMERS BOULEVARD,01,B3,"MARCELINO, CONNIE",1,2,-1
17538,4125680008,QN,173-05 137 AVENUE,11,V0,TOTTEN MICHAEL W,0,1,-1
17539,5016000040,SI,23 PYRAMID COURT,01,A5,"FOK, PETRO",1,2,-1
17540,4129130058,QN,130-20 235 STREET,01,A2,"CURTIN, HEATHER",1,2,-1
17541,4119410275,QN, GLASSBORO AVENUE,11,V0,WIFI GLASSBORO HOLDING GROUP INC.,0,1,-1
17542,4055540012,QN,197-25 46 ROAD,,Z9,SUTTER PARK HOMES INC,1,2,-1
17543,2053370040,BX, PAINE STREET,10,G0,MARIO PIACQUADIO,0,1,-1
17544,5027840029,SI, VICTORY BOULEVARD,10,G7,VICTORY-SIMON HOLDING,0,1,-1
17545,4004740048,QN,38-42 11 STREET,05,H3,"38 11TH STREET, LLC",0,1,-1
17546,4130720004,QN,142-37 224 STREET,01,A2,LENNOX O JOSLYN,1,2,-1
17547,4006590045,QN,37-08 30 AVENUE,04,S2,VILLA REALTY LLC,1,2,-1
17548,4126640025,QN,120 AVENUE,11,V0,DEVONISH HUVON,0,1,-1
17549,4015430009,QN,83-19 CORNISH AVENUE,02,C0,"ZHENG, NIANG",1,2,-1
17550,3053667501,BK,3801 15 AVENUE,02,R2,NAME NOT ON FILE,3,4,-1
17551,5015080138,SI,25 CANTERBURY AVENUE,01,A2,URCIVOLI JOSEPH,1,2,-1
17552,3072000036,BK, OCEAN COURT,11,V0,"MITA, CHAAYA",1,2,-1
17553,4128750012,QN,128-55 234 STREET,01,A2,RICHARD & MAXINE ROACH,1,2,-1
17554,4134330036,QN, SPRINGFIELD BLVD,11,V9,NYC DEPARTMENT OF CITYWIDE ADMINISTRATIVE SERVICES,0,1,-1
17555,3071010211,BK,WEST 4 STREET,11,V0,MORRONE JOSEPH,0,1,-1
17556,4136050055,QN,141-46 256 STREET,01,B3,NAZEEM AZEEZ,1,2,-1
17557,5015150048,SI,510 WEST CASWELL AVENUE,01,B1,WILLIAM ORTEGA,1,2,-1
17558,4130110046,QN,218 STREET,11,V1,PAUL ANDERSON,0,1,-1
17559,4142461194,QN,163-52 104 STREET,01,B3,CARLA M DOHERTY,1,2,-1
17560,4142600101,QN, ROCKAWAY BOULEVARD,07,T1,NYC DEPARTMENT OF SMALL BUSINESS SERVICES,0,1,-1
17561,4153240018,QN,19 ROAD,11,V0,"HENGLEIN, JOHN F",0,1,-1
17562,5038160101,SI,629 LINCOLN AVENUE,01,A5,"YAREMCHUK, LESYA",0,1,-1
17563,4019510010,QN,57-41 GRANGER STREET,03,D9,GRANGER STREET REALTY LLC,3,4,-1
17564,4130440029,QN, SPRINGFIELD BLVD,11,V0,KISSOON GAITRI Y,0,1,-1
17565,2057160700,BX,,07,U6,NYC DEPARTMENT OF ENVIRONMENTAL PROTECTION,0,1,-1
17566,4024920346,QN,79-05 ELKS ROAD,02,C0,"MULLARKEY, EILEEN",1,2,-1
17567,4026550067,QN,59-15 59 ROAD,01,B3,KONRAD KUDYBA,1,2,-1
17568,2058404143,BX,390 WEST 253 STREET,01,A4,GALWAY  ANDREW V,1,2,-1
17569,4159050120,QN,177 SEA GRASS LANE,01,B2,"GAI, YUAN",1,2,-1
17570,4038150025,QN,77-28 79 STREET,01,A1,"GUGLIEMI, CHERYL",1,2,-1
17571,4023110250,QN,49 STREET,09,Z8,TR-ST PATRICKS CATHEDRAL,1,2,-1
17572,4160420024,QN,450 BEACH 69 STREET,02,C0,"ZANDERS, FLORIDA",1,2,-1
17573,5051130016,SI,20 KEATS STREET,01,A2,ROBERT S ENGLER,1,2,-1
17574,4160510023,QN,465 BEACH 69 STREET,01,A1,"JAYCOXE, ANNIE W.",1,2,-1
17575,3000440045,BK, HARRISON ALLEY,11,V0,CARMELLA IBELLI,0,1,-1
17576,4024350032,QN,50 AVENUE,11,V2,SUWEB REALTY INC.,0,1,-1
17577,5038470021,SI,12A IONA STREET,10,G0,ANGELA TROIA IRREVOCABLE TRUST,0,1,-1
17578,5040860007,SI,160 MARINE WAY,01,B2,SOBHY GADELSAYED,2,3,-1
17579,5037960025,SI,540 HUNTER AVENUE,01,A1,FREEBORN EMPTY LOTS LLC,0,1,-1
17580,4032950063,QN, UNION TURNPIKE,10,G0,"BALCI, ILKER",0,1,-1
17581,4033370150,QN, AUSTIN STREET,10,G0,"BROMLEY, WILLIAM JAMES",0,1,-1
17582,3071280003,BK,376 AVENUE U,04,O8,372 AVENUE U HOLDING LLC,1,2,-1
17583,4035090020,QN,59-35 71 AVENUE,04,S2,AMS-MYRTLE LLC,0,1,-1
17584,5015480155,SI,31 JENNIFER PLACE,01,Z0,UNAVAILABLE OWNER,0,1,-1
17585,4162680062,QN,226 BEACH 135 STREET,01,A1,"GLUCKSMAN, DAVID",1,2,-1
17586,4162780031,QN,1-53 BEACH 133 STREET,01,A1,"CALAKOS, ANASTASIOSS",1,2,-1
17587,4036610045,QN,70-18 71 STREET,01,A1,"ALVARADO, PHAN",1,2,-1
17588,5036460018,SI,297 BURBANK AVENUE,01,A0,"MAHONEY, MATTHEW",1,2,-1
17589,4163250300,QN,BEACH 149 STREET,11,V1,UNITED STATES/AMER/A/G/S,0,1,-1
17590,4128650014,QN,121-30 LAURELTON PARKWAY,01,A2,"WHITE, JENNIFER",1,2,-1
17591,5000410012,SI,34 LAYTON AVENUE,01,B2,"HARRELL, CHARISE",1,2,-1
17592,4044670043,QN,2-43 148 STREET,01,B3,1847 HOLDINGS LLC,1,2,-1
17593,5000850024,SI,52 BUTLER TERRACE,01,A5,"ZHENG, AINA",1,2,-1
17594,5001060044,SI,10 PINE STREET,01,B2,"VALENCIA, FIDEL",1,2,-1
17595,4029110011,QN,58-12 83 PLACE,01,B3,ANNE INDELICATO IRREVOCABLE GRANTOR TRUS T,2,3,-1
17596,3055090041,BK,16 AVENUE,07,U6,BROOKLYN YARDS DEVELOPMENT LLC,0,1,-1
17597,5034910117,SI,45 CRESTWATER COURT,01,A5,ASHRAF A. HASSAN,1,2,-1
17598,4134190013,QN,183 STREET,10,G7,"MASTRONARDI BROTHERS, INC",0,1,-1
17599,4032800055,QN,74-01 KESSEL STREET,01,A5,"BRANCIFORTE, DAINORA",1,2,-1
17600,4032940019,QN,75 AVENUE,10,G0,OSUGI YUKO,0,1,-1
17601,5002190029,SI,590 DELAFIELD AVENUE,01,B2,"GUO, HUA",0,1,-1
17602,4032950058,QN, UNION TURNPIKE,10,G0,LEE AMY,0,1,-1
17603,4033020126,QN,203 GREENWAY NORTH,10,G0,"STANOJEVIC, STOJAN D",0,1,-1
17604,5033780100,SI,348 CROMWELL AVENUE,01,A3,ANTHONY R AVENA & ANTOINETTE T AVENA,1,2,-1
17605,4117890041,QN,130 PLACE,11,V0,ASLAM MOHAMMAD,0,1,-1
17606,5035510065,SI,220 SEAVER AVENUE,09,Q2,STATEN ISLAND LITTLE LEAGUE,0,1,-1
17607,4045700176,QN,159 STREET,11,V0,UNAVAILABLE OWNER,0,1,-1
17608,4033370151,QN, AUSTIN STREET,10,G0,"CORDOBA, DANIYALOV",0,1,-1
17609,5002850061,SI,569 OAKLAND AVENUE,01,A2,CHRISTOPHER VEGA,1,2,-1
17610,4033390056,QN,75 ROAD,10,G0,"COX, DOMENICA",0,1,-1
17611,4047040006,QN,151-05 18 AVENUE,01,A1,NICOLE SCHMITT,1,2,-1
17612,5003490038,SI,76 BEECHWOOD PLACE,01,B1,MARGARET POSTIGLIONE,1,2,-1
17613,4033390058,QN,75 ROAD,10,G0,"TURNER, MICHAEL D",0,1,-1
17614,4128890128,QN,129 ROAD,11,V0,"NARANJIT, NARMESH",0,1,-1
17615,4051750023,QN, BOOTH MEMORIAL AVE,10,G0,RALPH MONACO (EXECS),0,1,-1
17616,4036050001,QN,66-26 METROPOLITAN AVENUE,05,K6,VERTICAL INDUSTRIAL DEVELOPMENT CORPORAT ION,2,3,-1
17617,4036080079,QN,64-50 ADMIRAL AVENUE,01,B2,"NIKODIN, JONEL",1,2,-1
17618,4036080099,QN,65-30 ADMIRAL AVENUE,01,B2,THE GIUSEPPINA PIAZZA REVOCABLE TRUST,1,2,-1
17619,5042060076,SI,86 NEW DORP PLAZA,10,G0,"TITAN PLAZA, LLC",0,1,-1
17620,4036360013,QN,65-08A CATALPA AVENUE,10,G0,JERZY MROZ,0,1,-1
17621,4057320018,QN, WILLETS POINT BLVD,07,U2,"CONSOLIDATED EDISON CO.OF N.Y.,INC.",0,1,-1
17622,5003880004,SI,532 JEWETT AVENUE,01,A1,"BOUDERAU, JONATHAN",1,2,-1
17623,4129710122,QN,133-11 231 STREET,01,A2,"BECKFORD, ARCHIBALD",1,2,-1
17624,5035350096,SI,21 STOBE AVENUE,01,A5,"COSTELLO, SALVATORE J",1,2,-1
17625,5028460012,SI,NA TOMPKINS AVENUE,11,V1,"TOMPKINS CAPITAL STATEN ISLAND, LLC",2,3,-1
17626,4068950026,QN,61-11 167 STREET,02,C0,YIM KAM TONG,1,2,-1
17627,4037140010,QN,61-20 COOPER AVENUE,04,S2,6120 COOPER LLC,1,2,-1
17628,4036510029,QN,69-33 67 PLACE,01,A9,ROSEMARY DARMSTADT DEVISEE,1,2,-1
17629,4037400375,QN, CYPRESS AVENUE,09,Z8,VETERANS ADMINISTRATI,0,1,-1
17630,5005080024,SI, VAN DUZER STREET,11,V0,"VAN BALTIC, LLC",0,1,-1
17631,5005140034,SI,77 BREWSTER STREET,01,B2,"ZHENG, KANG",0,1,-1
17632,4038330078,QN,78-68 83 STREET,01,B2,"RANDO, NANCY",2,3,-1
17633,5005560186,SI,26 SUSAN COURT,01,A5,PHILLIPS GLORIA M,1,2,-1
17634,3055380004,BK,16 AVENUE,07,U7,NYC TRANSIT AUTHORITY,0,1,-1
17635,4084010650,QN, GRAND CENTRL PARKWAY,11,V0,UNITED CERE/PAL/QUE/INC,0,1,-1
17636,5006030076,SI,37 GLENWOOD AVENUE,01,A2,STEPHEN & KATHRYN ANTOSZ,1,2,-1
17637,4039480008,QN,124-12 5 AVENUE,01,B2,"ZHANG, NENG CHUN",1,2,-1
17638,4130430100,QN,140 AVENUE,11,V0,UNAVAILABLE OWNER,0,1,-1
17639,4039650033,QN,123-09 9 AVENUE,01,A1,ISAAC GUERRERO,1,2,-1
17640,4094400088,QN,94-22 124 STREET,01,A9,RAMOS AIDA L,1,2,-1
17641,4094750011,QN,95-14 132 STREET,01,A1,"FELSENTHAL, EDWARD",1,2,-1
17642,5007220074,SI,49 PERRY AVENUE,01,A1,"YIP, RAYMOND",1,2,-1
17643,4136720042,QN,257-43 148 ROAD,01,B2,"TANIS, SANDRO",1,2,-1
17644,4150130025,QN,158-08 ROCKAWAY BOULEVARD,05,K2,RCM DUPLCTNG SPPLY EQPMT,1,2,-1
17645,5020000141,SI,43 PERSIMMON LANE,01,A5,"MATTHIES, CRAIG",1,2,-1
17646,4042660036,QN,25-52 126 STREET,01,B3,MARINKO KOLANOVIC,1,2,-1
17647,5009000040,SI, TODT HILL ROAD,09,Q5,NYS DEPARTMENT OF ENVIRONMENTAL CONSERVATION,0,1,-1
17648,4097760018,QN,159-30 NORMAL ROAD,01,B2,"DAS, SHIPRA",1,2,-1
17649,4036150007,QN, TRAFFIC AVENUE,10,G0,"JENKELEIT, RALPH",0,1,-1
17650,4018820063,QN,47-23 98 PLACE,01,A1,"MARTINEZ, SANDRO",1,2,-1
17651,5009550220,SI,155 FRIENDSHIP LANE,03,D1,SEAVIEW C HOUSING DEVELOPMENT FUND,1,2,-1
17652,4099370114,QN,178-28 WEXFORD TERRACE,02,C2,"178-28 WEXFORD TERRACE, LLC",1,2,-1
17653,4155530012,QN, MOBILE ROAD,10,G0,MOSESON RIVKA,0,1,-1
17654,4155710020,QN,8-37 CORNAGA AVENUE,01,B3,"BERNSTEIN, EFREM",1,2,-1
17655,4046300032,QN,145-56 19 AVENUE,01,A1,"LY, AMANDA H",1,2,-1
17656,4046690028,QN,149-59 20 AVENUE,01,B2,"YE, SONGYUE",1,2,-1
17657,4101390032,QN,108 AVENUE,07,U9,NYC DEPARTMENT OF ENVIRONMENTAL PROTECTION,0,1,-1
17658,3017860051,BK,743 LAFAYETTE AVENUE,02,C1,GW LAFAYETTE LLC,0,1,-1
17659,4049210008,QN,167-16 29 AVENUE,01,A1,"LAU, MUN HIM",1,2,-1
17660,5049850018,SI,156 HOPKINS AVENUE,01,A5,"LIN, HAI BIN",0,1,-1
17661,5032790014,SI,121 LINWOOD AVENUE,01,A5,RAISA PETROVA,1,2,-1
17662,4105140079,QN,196-19 POMPEII AVENUE,01,A1,YIWAI WUNG,2,3,-1
17663,4105230061,QN,193-27 85 ROAD,01,A1,YACOV BENLEVI,1,2,-1
17664,4051750025,QN, BOOTH MEMORIAL AVE,10,G0,ZEE MU-SHA,0,1,-1
17665,4106530060,QN,89-28 212 PLACE,01,A1,"KHAN, SUFIAN AHMED",1,2,-1
17666,4107700017,QN,218-28 97 AVENUE,06,E7,SHS QUEENS VILLAGE LL,2,3,-1
17667,4035640005,QN,17-01 STEPHEN STREET,01,B3,"MIETEK, MAREK",1,2,-1
17668,4051750037,QN,148 STREET,10,G0,"TUNG, SEN",0,1,-1
17669,4035500074,QN, CENTRE STREET,10,G7,KNITWORK ACQUISITION,0,1,-1
17670,3019287501,BK,239 SKILLMAN STREET,02,R2,UNAVAILABLE OWNER,4,5,-1
17671,5014810080,SI,19 HOME PLACE,01,A1,CARABETTA FRANK L,1,2,-1
17672,5032500025,SI,190 KENSINGTON AVENUE,01,A1,JOSEPH BYE,1,2,-1
17673,5016000053,SI,118 ELSON STREET,01,A5,"TANG , RINGO",1,2,-1
17674,3021030058,BK,167 LAFAYETTE AVENUE,01,A5,"DAVID R. STACK, TRUSTEE",0,1,-1
17675,5019880129,SI,101 WASHINGTON AVENUE,01,A1,JAY SCHAINHOLZ,1,2,-1
17676,5020000147,SI,23 PERSIMMON LANE,01,A5,"NEWTON , PATRICK",1,2,-1
17677,4033690127,QN,4-86 RICARD STREET,10,G0,RAPALA GRZEGORZ,0,1,-1
17678,5020900016,SI, DREYER AVENUE,01,Z0,FOREST VIEW HOMEOWNERS ASSOC INC,0,1,-1
17679,4116100249,QN,111 AVENUE,11,V0,"GAJADHAR, RIANNA",0,1,-1
17680,5021620151,SI, TRAVIS AVENUE,07,G9,FRANK BARNARD JR,0,1,-1
17681,4116850048,QN,116-37 128 STREET,01,B3,"MAHASE, SHIVANAND",1,2,-1
17682,5022360046,SI,30 MERRILL AVENUE,01,A5,"AHMED, OMAR",1,2,-1
17683,5022870110,SI,387 LIGHTHOUSE AVENUE,10,G0,BELLO JUDITH,1,2,-1
17684,5031210088,SI,25 WATERFORD COURT,01,B1,"PROVENZANO, GRACE",1,2,-1
17685,3071450111,BK,2224 WEST 5 STREET,01,A1,"OVADYA, CLEMI",1,2,-1
17686,5020350060,SI,25 SENECA LOOP,01,A5,RACSA RUEL,1,2,-1
17687,5028360017,SI, BAY STREET,10,G7,838 YEE PHUAN REALTY INC,0,1,-1
17688,4159050250,QN,65-16 SEASPRAY AVENUE,01,B2,"OOTTAMAKORN, CHANYUTE",1,2,-1
17689,4107550034,QN,224-23 92 ROAD,01,A1,GLAUNER THOMAS G,1,2,-1
17690,4060110020,QN,28 AVENUE,10,G0,"MCLEER, SR., RICHARD A",0,1,-1
17691,4062000041,QN,38-32 205 STREET,01,A1,"PERROS, GEORGE",1,2,-1
17692,5030990009,SI, MACFARLAND AVENUE,10,G0,"VICTOR S. CENCI, CO-TRUSTEE",0,1,-1
17693,4121360047,QN,152-11 136 AVENUE,01,A2,152-11 136TH AVE LLC,2,3,-1
17694,4121650041,QN,110-18 GUY R BREWER BLVD,08,M9,BETHEL GOSPEL TBRNCL,1,2,-1
17695,5031040042,SI,150 LILY POND AVENUE,01,A5,"LIN, JIE",0,1,-1
17696,4161550005,QN,99-18 ROCKAWAY BEACH BLVD,07,G2,2128 FLATBUSH AVE LLC,1,2,-1
17697,3057090021,BK,1034 59 STREET,01,B1,"FUNG , I YAN TSUI",1,2,-1
17698,5033790105,SI, SEAVIEW AVENUE,11,V0,"LIN, YI",0,1,-1
17699,3034720045,BK, COOKE COURT,,Z9,"BURGOS, DEYANIRA",0,1,-1
17700,4162190055,QN,240 BEACH 124 STREET,01,B2,"DENARO, ALFRED JR",1,2,-1
17701,4125180068,QN,127 AVENUE,11,V0,"DEVONISH, CHARMAIN",0,1,-1
17702,5034910006,SI,409 FATHER CAPODANNO BL,01,B9,"VALKOVA, ANNA",1,2,-1
17703,5034180014,SI,256 OLYMPIA BOULEVARD,01,B2,"SOKOLINSKAYA, JULIA",1,2,-1
17704,5035530022,SI,27 HULL AVENUE,02,C3,"HULL AVENUE PROPERTIES, LLC",1,2,-1
17705,5035640047,SI,25 JUNIPER PLACE,01,A1,STEPHANIE FRASCHILLA,1,2,-1
17706,4162510031,QN,518A BEACH 140 STREET,10,G0,518 BEACH 140TH STREET INC.,0,1,-1
17707,5036200065,SI,57 LOCUST AVENUE,01,A1,"URRICO, JOHN M",1,2,-1
17708,5030380020,SI,19 RODERICK AVENUE,01,B2,"LIN, YU YING",1,2,-1
17709,3072900058,BK,2289 CONEY ISLAND AVENUE,01,B3,"LI, YA YUN",1,2,-1
17710,4044160210,QN,109 MALBA DRIVE,01,A1,LARAINE F. ROBERTS,2,3,-1
17711,5038840028,SI,580 LINCOLN AVENUE,01,B2,"MCDANIEL, ELIZABETH",1,2,-1
17712,4073420010,QN,46-08 216 STREET,01,B2,"LIU, ZONG WANG",0,1,-1
17713,4139110125,QN, BROAD STREET,10,G0,"KIRCHNER, KARL P IV",0,1,-1
17714,3045280020,BK,930 CRESCENT STREET,01,B9,"HEWITT, NORBERTA",1,2,-1
17715,5044750001,SI, ARTHUR KILL ROAD,09,Z8,UNITED HEBREW CEMETER,0,1,-1
17716,4140800025,QN,87 STREET,11,V0,THE JOSEPH A. CURCIO TRUST,0,1,-1
17717,5046450068,SI,25 WILLOW LANE,01,B9,"MANOLATOS, ANASTASIOS",1,2,-1
17718,5046550014,SI,36 GUYON AVENUE,01,B9,"ZHENG, ZHENG KONG",0,1,-1
17719,4074740181,QN,45-35 220 PLACE,01,A1,ROSE CACCIOLA IRREVOCABLE TRUST,1,2,-1
17720,4155470043,QN, VIRGINIA STREET,11,V0,THE LUXOR TRUST,0,1,-1
17721,5000490168,SI, LAYTON AVENUE,01,Z0,LUIS CORREA,0,1,-1
17722,5053550064,SI, OAKDALE STREET,11,V0,TANZI JOHN,0,1,-1
17723,3045860959,BK,628 SCHROEDERS AVENUE,01,B2,"WATERMAN , CLAUDETTE M",1,2,-1
17724,5055070195,SI, RIDGEWOOD AVENUE,11,V0,"ELTINGVILLE COMMONS, LLC",1,2,-1
17725,4159050068,QN,182 SEA GRASS LANE,01,B2,"LI, LOUISA ZHIYING",1,2,-1
17726,4159050150,QN,183 WHITE SANDS WAY,01,B2,"MORGAN, LENNOX",1,2,-1
17727,4160890017,QN,246 BEACH BREEZE PLACE,01,B2,"LOINES, DWIGHT",1,2,-1
17728,4160900059,QN,7517 AQUATIC DRIVE,01,B2,"LEM, EDMOND CHIN",1,2,-1
17729,4160920020,QN,142 MERIDIAN BOULEVARD,01,B2,"BAUER, DANIEL",1,2,-1
17730,4160920099,QN,180 BEACH 73 STREET,01,B2,"PHILLIPS, LANA C",1,2,-1
17731,5034010023,SI, BALFOUR STREET,11,V0,KALENDER ERDINC,0,1,-1
17732,5021110032,SI,74 MULBERRY CIRCLE,01,A5,"FERLISI, CALOGERO",1,2,-1
17733,5000390051,SI,129 BENZIGER AVENUE,01,B2,"ZHU, ANNIE",0,1,-1
17734,5000640122,SI,4 HENDERSON AVENUE,01,A3,"BANNISTER, SHOWAYNE O",0,1,-1
17735,4038050008,QN,77-01 79 PLACE,01,B2,"NATKANIEC, ANDRZEJ",1,2,-1
17736,5001480055,SI,485 DAVIS AVENUE,01,B2,"CASATELLI, MARGARET S",0,1,-1
17737,5001540084,SI,353 PELTON AVENUE,01,A1,2065 FOREST AVENUE LLC,1,2,-1
17738,5001560068,SI,129 REGAN AVENUE,01,A2,WALTER LEVENDOSKY,1,2,-1
17739,4080670028,QN,34 OAK LANE,01,A1,"NICHOLAS, BRIAN",1,2,-1
17740,5001840330,SI,1435 RICHMOND TERRACE,07,T2,BLOCK 184 LLC,1,2,-1
17741,5060450114,SI,22 EVERTON AVENUE,10,G0,GIUSEPPE CONENNA,0,1,-1
17742,5062430032,SI,32 SHERIDAN PLACE,01,A2,STEVEN ERCOLE,1,2,-1
17743,3014800036,BK,1376 BROADWAY,11,V1,BROGA-MIJH INC,0,1,-1
17744,5001500091,SI,188 HARRISON PLACE,01,A1,JOHN ABER,1,2,-1
17745,5064690125,SI, POILLON AVENUE,11,V1,NYC DEPARTMENT OF PARKS AND RECREATION,0,1,-1
17746,5003290110,SI,197 SLOSSON AVENUE,01,A1,J FODERA,1,2,-1
17747,4142431168,QN, DAVENPORT COURT,11,V0,DENNIS KELLY,0,1,-1
17748,5066810008,SI,45 SEGUINE AVENUE,07,U6,MTA - STATEN ISLAND RAILWAY,0,1,-1
17749,5001500184,SI,5 HOWARD COURT,01,A5,LAURO E COLON,1,2,-1
17750,2024260001,BX,381 EAST 166 STREET,02,C1,381 E 166 ST PROPERTY LLC,0,1,-1
17751,5001850520,SI,1947 RICHMOND TERRACE,06,F5,DUCA EUGENE,2,3,-1
17752,5004670040,SI,362 CHEVES AVENUE,01,A1,MATTHEW R DE MARTINIS,3,4,-1
17753,5033620163,SI,260 HURLBERT STREET,01,B2,"GUINTO, MARGARET",1,2,-1
17754,5002240107,SI,291 MYRTLE AVENUE,01,B3,CHRISTOPHER IANNACE,1,2,-1
17755,5073170029,SI,40 MANDY COURT,01,B9,DOMINIC J. MARONE AS TRUSTEE,1,2,-1
17756,4155030070,QN,11-18 BRUNSWICK AVENUE,01,A1,"HOURIHAN, DANIEL",1,2,-1
17757,4101820033,QN,164-15 110 AVENUE,01,B2,"SINGH, HARRYNAUTH",1,2,-1
17758,5007110020,SI,654 MANOR ROAD,01,A1,ULTIMATE REALTY HOLDINGS LLC,1,2,-1
17759,5008030007,SI,275 LIVINGSTON AVENUE,01,A2,D CHRISTOPHER,1,2,-1
17760,5077980008,SI, AMBOY ROAD,11,V0,"AMERICAN AMBOY 2004,",0,1,-1
17761,5002510038,SI,228 HART BOULEVARD,01,A1,"ZARRELLI , WAYNE",1,2,-1
17762,5002610003,SI,601 BARD AVENUE,01,A1,"WALSH, CLAIRE H",1,2,-1
17763,4088110001,QN,266 STREET,11,V0,MCDONAL E. PENA,0,1,-1
17764,5078900087,SI, MANHATTAN STREET,11,V0,"MCCANN, STEVEN",0,1,-1
17765,5003290318,SI,183 SLOSSON AVENUE,01,B1,"TARIQ, CHOUDHRY W",1,2,-1
17766,5079230087,SI, ASPINWALL STREET,11,V0,SOLOMON DANIEL,0,1,-1
17767,5023700349,SI,19 TRAVIS AVENUE,01,A5,KILMAN EDUARD,1,2,-1
17768,5080050112,SI, HOPPING AVENUE,10,G0,BERMAN MYRON,0,1,-1
17769,5032050010,SI, PARKINSON AVENUE,11,V0,RIDERA LLC,0,1,-1
17770,4159050089,QN,155 COMPASS PLACE,01,B2,"HAYES, CORY",1,2,-1
17771,4159050117,QN,187 SEA GRASS LANE,01,B2,"YIP, LUN WAH",1,2,-1
17772,4079520003,QN,233-75 87 AVENUE,01,B2,"PIPINIAS, MICHAEL",1,2,-1
17773,5012770193,SI,30 MACORMAC PLACE,01,A2,"ROSE, DEBORAH",1,2,-1
17774,1007050053,MN,524 WEST 34 STREET,09,Q0,NYC DEPARTMENT OF PARKS AND RECREATION,0,1,-1
17775,4160920075,QN,6925 NAUTICAL WAY,01,B2,"GANNON, PATRICK",1,2,-1
17776,4160920126,QN,7220 WATER WAY,01,B2,"MYKOO, KENNEDY",1,2,-1
17777,4093200130,QN,112-19 ATLANTIC AVENUE,01,A5,"RICKIE-LALLA, SUSAN",1,2,-1
17778,5015600146,SI,24 CALCAGNO COURT,01,A5,"VITOVSKA , LARISA",1,2,-1
17779,1009140059,MN,501 3 AVENUE,11,V1,COA 200 E 34TH LLC,1,2,-1
17780,5020000131,SI,60 MONARCH COURT,01,A5,"DONOVAN, EDWARD J JR",1,2,-1
17781,5024450003,SI,18 LOTT LANE,01,A5,GLENDALE REALTY ASSOC,1,2,-1
17782,5031880053,SI,28 PROVIDENCE STREET,01,B1,"LIU, KING YUI",1,2,-1
17783,4033390090,QN, AUSTIN STREET,11,V0,GRANGER GAIL M,0,1,-1
17784,4099680048,QN,86-34 188 STREET,01,A1,"ADAM, ISAZZ",1,2,-1
17785,5005360052,SI,22A GORDON STREET,10,G0,FABIAN JUMELLES,0,1,-1
17786,5005370002,SI, HYGEIA PLACE,11,V0,OLUSHINA OLUBUNMI,0,1,-1
17787,5028900014,SI,386 BRITTON AVENUE,01,B2,"OU, SHU YI",1,2,-1
17788,5028990315,SI, MOSEL AVENUE,11,V0,UNAVAILABLE OWNER,0,1,-1
17789,5023900390,SI,10 TRAVIS AVENUE,01,A5,MEI LIN LEE,1,2,-1
17790,5031030030,SI,10A FLORIDA AVENUE,10,G0,"CIFONE, SALVATORE",0,1,-1
17791,4094390057,QN,94-13 121 STREET,01,B2,"MAHABIR, LACHMIWATIE",1,2,-1
17792,5032120005,SI,124 LESLIE AVENUE,01,A5,"NIGRO, RONALD L",1,2,-1
17793,5006110099,SI,576 VAN DUZER STREET,01,A1,GERARD HAMPTON,1,2,-1
17794,3055050050,BK,1869 59 STREET,01,B1,"NOE, ARON",1,2,-1
17795,3055420004,BK,20 AVENUE,07,U7,NYC TRANSIT AUTHORITY,2,3,-1
17796,5062730027,SI,327 CROWN AVENUE,01,A2,BETTY V HARTY,1,2,-1
17797,1017260013,MN,59 WEST 128 STREET,02,C1,WEST HARLEM CORP.,0,1,-1
17798,5035670010,SI, NORTH RAILROAD AVE,07,U6,MTA - STATEN ISLAND RAILWAY,0,1,-1
17799,5028670162,SI,72 FAIRWAY AVENUE,01,A2,VIRGINIA LIMA TRUSTEE,1,2,-1
17800,5036020001,SI, NORTH RAILROAD AVE,07,U1,UNAVAILABLE OWNER,0,1,-1
17801,5006940146,SI,86 WINDSOR ROAD,01,A1,"QUACINELLA, DARREN C",1,2,-1
17802,5000390029,SI,48 HENDRICKS AVENUE,01,B2,"ASHANTI, KARL",0,1,-1
17803,2024090050,BX, MELROSE AVENUE,,Z9,AMERICAN PEN CORP.,0,1,-1
17804,5038640022,SI,975 FATHER CAPODANNO BL,01,B9,"KIM, JONG WOI",1,2,-1
17805,2024380010,BX, MORRIS AVENUE,09,Q2,NYC DEPARTMENT OF PARKS AND RECREATION,0,1,-1
17806,5040370018,SI,162 MILL ROAD,01,A2,SHAO TING CAO,1,2,-1
17807,2027410200,BX,EAST 163 STREET,11,V1,NYC DEPARTMENT OF PARKS AND RECREATION,0,1,-1
17808,2027800500,BX, RYAWA AVENUE,11,V9,NYC DEPARTMENT OF SANITATION,0,1,-1
17809,4033390053,QN,1141 76 AVENUE,10,G0,ALAN C WANG,0,1,-1
17810,5031760050,SI,64 NORTH RAILROAD AVE,01,A5,"LENKIEWICZ, JOZEF",1,2,-1
17811,5046910041,SI,135 BROOK AVENUE,01,A5,RICHARD S WOERNER,1,2,-1
17812,5046960037,SI,16 CHESTERTON AVENUE,01,A2,"CEFOLI, ROBERT",1,2,-1
17813,5049850021,SI,168 HOPKINS AVENUE,01,A5,"SELLITTI, THERESA A",0,1,-1
17814,5051260046,SI,145 GREAT KILLS ROAD,01,A3,"ANGOLEMMO, ANGELO",0,1,-1
17815,5030400081,SI,75 RODERICK AVENUE,01,B3,CASTILLO JOSE,1,2,-1
17816,4033370154,QN, AUSTIN STREET,10,G0,"HUDON, NOAH L",0,1,-1
17817,5001010090,SI, WESTBURY AVENUE,11,V0,ROBERT W BOHNENBERGER,0,1,-1
17818,5054330123,SI,4 HARDY PLACE,01,A1,GURMEET SINGH,1,2,-1
17819,5001260019,SI,101 SILVER LAKE ROAD,01,B3,"DEMYAN, DEBORAH",1,2,-1
17820,5001270030,SI,173 FOREST AVENUE,01,A1,"WILLIAMS, HAROLD",1,2,-1
17821,5010530176,SI, SMITH PLACE,10,G7,"GEMSA LOAN SERVICES, LP",0,1,-1
17822,5010640039,SI,162 HAGAMAN PLACE,01,A9,JOANNE G. BROWN,1,2,-1
17823,5066180001,SI, AMBOY ROAD,07,U6,MTA - STATEN ISLAND RAILWAY,0,1,-1
17824,5010860128,SI,14 PORT LANE,01,B2,"ERIC R LORIA, SR",1,2,-1
17825,2032440100,BX, LANDING ROAD,07,U2,CONSOLIDATED EDISON COMPANY,0,1,-1
17826,5068960031,SI,50 FOSTER ROAD,01,B2,"LI, YAN QING",0,1,-1
17827,5069680053,SI,1078 SHELDON AVENUE,01,A5,"ZAUGG, ROBERT A",1,2,-1
17828,5070220009,SI,28 BROOKSIDE LOOP,01,B2,UNAVAILABLE OWNER,1,2,-1
17829,5070660090,SI,80A POPLAR AVENUE,01,A5,"SCANDARIATO, PHILIP",1,2,-1
17830,5070930055,SI,682 BLOOMINGDALE ROAD,01,A5,EDWARD DONZELLI,1,2,-1
17831,5075960188,SI,39 PILOT LANE,01,A5,"ADRIAN R. FAUSTINO, TRUSTEE",1,2,-1
17832,5077550049,SI,6763 HYLAN BOULEVARD,01,B2,ARMENIA SALVATORE,1,2,-1
17833,4101420068,QN,153-11 109 AVENUE,01,A1,KHAN MOHAMED,1,2,-1
17834,2033570120,BX, WEBSTER AVENUE,11,V1,33 INVESTORS LLC,0,1,-1
17835,4029070123,QN,82 STREET,11,V0,"POTAMITIS, ANASTASIOS",0,1,-1
17836,3080080039,BK,8718 GLENWOOD ROAD,01,A2,"GAUDINO, BALDASSARE",2,3,-1
17837,5079650009,SI,28 SATTERLEE STREET,01,A1,"SPATARO, STEPHEN JR.",1,2,-1
17838,5080200063,SI, BARNARD AVENUE,10,G0,COPPER KETTLE LLC,0,1,-1
17839,5012720425,SI,44 BETTY COURT,01,A5,PINERO EDWIN,1,2,-1
17840,4038550128,QN,88-41 75 AVENUE,01,B3,STORA JR. JOHN & SHARON,3,4,-1
17841,5029110036,SI, NARROWS ROAD SOUTH,11,V1,"TORRES, MELINDA",0,1,-1
17842,1001240024,MN,250 BROADWAY,05,O4,250 BROADWAY ASSOCIATES CORP,1,2,-1
17843,1001790013,MN,74 HUDSON STREET,10,G6,"HUDSON PARKING,",0,1,-1
17844,2037840012,BX,1262 ROSEDALE AVENUE,10,G0,"RODRIGUEZ, ORLANDO T",0,1,-1
17845,5015010016,SI,330 WILLOWBROOK ROAD,01,A1,"BRADLEY, JAMES",1,2,-1
17846,5001500442,SI,168 OAKLAND AVENUE,01,A2,"LEYKAM, ANDREW",1,2,-1
17847,1004770066,MN,48 WATTS STREET,05,O2,STONE REALTY LLC,1,2,-1
17848,5015220001,SI,55 WYONA AVENUE,08,W8,"WONG, TING KONG",1,2,-1
17849,5016850124,SI, AMITY PLACE,11,V3,"CRUZ, GRICEL",0,1,-1
17850,2040990007,BX, VAN NEST AVENUE,10,G0,"SANCHEZ, WILDER",0,1,-1
17851,4105730048,QN,89-45 208 STREET,01,A5,LUCILLE SPENCER,2,3,-1
17852,5021140065,SI,41 ROCKVILLE AVENUE,01,B2,"CAPILLO, GIANCARLO",1,2,-1
17853,5022870043,SI,401 LIGHTHOUSE AVENUE,01,B1,NEPOLA NEIL,3,4,-1
17854,5001610099,SI,207 NORTH BURGHER AVENUE,01,B2,"CESPEDES, ELBI",2,3,-1
17855,1011377501,MN,160 WEST 66 STREET,03,R4,THREE LINCOLN CENTER CONDO,1,2,-1
17856,3061550054,BK,1261 70 STREET,02,C0,1257 70TH STREET LLC,0,1,-1
17857,2044550068,BX,2414 ESPLANADE,01,A1,"SIMMONS, TAU",1,2,-1
17858,5028840030,SI, RICHMOND ROAD,09,Q9,NYC DEPARTMENT OF PARKS AND RECREATION,0,1,-1
17859,5028990314,SI, MOSEL AVENUE,11,V0,UNAVAILABLE OWNER,0,1,-1
17860,1019670012,MN,423 WEST 126 STREET,10,G6,423 COLUMBIA REALTY LLC,0,1,-1
17861,2045660057,BX, FENTON AVENUE,10,G0,JULIO E TORRES,0,1,-1
17862,5001810070,SI,495 DELAFIELD AVENUE,01,A1,"GUNASEKARA, MANOJ P",0,1,-1
17863,2025430001,BX,2 ST. ANN'S AVENUE,06,E9,CONSOLIDATED RAIL CORPORATION,1,2,-1
17864,2027360242,BX, WORTHEN STREET,11,V1,"LOMENTO ENTERPRISES,INC",0,1,-1
17865,5021650085,SI,5 TELEPORT DRIVE,05,O2,PORT AUTHORITY OF NY AND NJ,1,2,-1
17866,2041440001,BX, WATERS PLACE,07,U7,NYC TRANSIT AUTHORITY,0,1,-1
17867,5021110036,SI,66 MULBERRY CIRCLE,01,A5,NICOLE  ROTKOWITZ,1,2,-1
17868,2027810301,BX, FARRAGUT STREET,11,V9,NYC DEPARTMENT OF SMALL BUSINESS SERVICES,0,1,-1
17869,3066250069,BK,WEST 7 STREET,01,A9,"WONG, YVETTE W.Y.",1,2,-1
17870,5019910041,SI,130 ASHWORTH AVENUE,01,A5,"SHRESTHA, ARNIKO",1,2,-1
17871,3066410038,BK,901 QUENTIN ROAD,08,W2,ATERET TORAH CENTER,1,2,-1
17872,5016200053,SI,194 FAHY AVENUE,01,A5,KAZIMIERZ HALAS,1,2,-1
17873,2029080041,BX, WASHINGTON AVENUE,11,V1,GREATER NEW YORK CORPORATION OF SEVENTH  DAY ADVENT,0,1,-1
17874,5001850501,SI,1893 RICHMOND TERRACE,10,G1,"WEVEST, INCORPORATED",1,2,-1
17875,5001850600,SI, RICHMOND TERRACE,07,U9,NYC DEPARTMENT OF ENVIRONMENTAL PROTECTION,0,1,-1
17876,5001860160,SI,147 WAYNE STREET,06,F5,WAYNE EMPIRE LLC,1,2,-1
17877,2031280125,BX,952 EAST 181 STREET,02,C0,"BATISTA, JOSE F",1,2,-1
17878,2032190214,BX,113 FATHER ZEISER PLACE,11,V0,ICONIC TOWERS INCORPORATED,1,2,-1
17879,2032470220,BX,2900I GOULDEN AVENUE,08,W5,DORMITORY AUTHORITY OF THE STATE OF NEW  YORK,1,2,-1
17880,5065230110,SI,5230 AMBOY ROAD,01,B2,"MARIELLI, ANTHONY",0,1,-1
17881,2032790056,BX,2844 DECATUR AVENUE,02,C3,"PAULINO, JOSE L",1,2,-1
17882,5012110034,SI,69 ERASTINA PLACE,01,A1,CYNTHIA MATHIES,1,2,-1
17883,5033950027,SI,49 NUGENT AVENUE,01,A2,VINCENT J RUSSO,1,2,-1
17884,5067590001,SI, BAYVIEW AVENUE,07,U6,MTA - STATEN ISLAND RAILWAY,0,1,-1
17885,2053060154,BX,2739 GIFFORD AVENUE,01,Z0,CITY ISLAND HOLDINGS CORP,0,1,-1
17886,2053070073,BX,2717 BRUCKNER BOULEVARD,02,C0,ESTEBAN LOPEZ JR,1,2,-1
17887,2039520001,BX,1584 WHITE PLAINS ROAD,11,V0,ZP REALTY LLC,0,1,-1
17888,5035610066,SI, HYLAN BOULEVARD,10,G7,BOBBY G LLC,0,1,-1
17889,2040540002,BX, MORRIS PARK AVENUE,11,V1,EDWARD PICONE,0,1,-1
17890,3015920001,BK,75 LEWIS AVENUE,08,W9,ROMAN CATHOLIC CHURCH,1,2,-1
17891,3068050003,BK,2206 QUENTIN ROAD,01,A1,"AJZENMAN, MICHELLE",1,2,-1
17892,2044650011,BX,2416 BOUCK AVENUE,01,B3,"HU, SHENG ZHEN",1,2,-1
17893,5014780354,SI,68 WILLOWBROOK COURT,01,B2,P P CIURCINA,1,2,-1
17894,5036420038,SI, BACHE AVENUE,10,G0,TK HVAC CONSULTING INC.,0,1,-1
17895,5028990182,SI,29 MOSEL AVENUE,01,A5,"MEI, WEN YUE",1,2,-1
17896,2046060005,BX, SOUTH OAK DRIVE,11,V0,MASTER DEVELOPMENT 26 CORP,0,1,-1
17897,2054140119,BX,3300 RADIO DRIVE,01,B1,"MORRETTA, GRACIE",1,2,-1
17898,5031010015,SI,75A LANDIS AVENUE,10,G0,WILLIAM H CUSICK,0,1,-1
17899,4036360014,QN,65-06A CATALPA AVENUE,10,G0,"OROZCO, JORGE D",0,1,-1
17900,5038160001,SI,631 LINCOLN AVENUE,01,A5,"LEU, NANCY",0,1,-1
17901,3083660196,BK,1312 EAST 69 STREET,01,A5,"AMAECHI, OCTAVIA M",1,2,-1
17902,4028700138,QN,86-05 57 ROAD,01,B2,"ENG, SHAR HING",1,2,-1
17903,2055160101,BX,99B EDGEWATER PARK,01,A8,EDGEWATER PARK OWNRSETC,65,66,-1
17904,5011940036,SI,225 VAN NAME AVENUE,01,A2,THE SYBIL O. RAYE IRREVOCABLE TRUST,1,2,-1
17905,3083930077,BK,1448 ROYCE STREET,01,B1,"DUNN, GARY",2,3,-1
17906,2056070006,BX,2590 HARDING AVENUE,01,A1,"MERCED, MARIA",1,2,-1
17907,5002780027,SI,707 DAVIS AVENUE,01,B1,MICHAEL J. CARBONARO AS CO-TRUST,1,2,-1
17908,2056290024,BX,36 FORDHAM STREET,01,B2,"BERISHA, SUSANA",1,2,-1
17909,2057760552,BX,WEST 238 STREET,07,U7,NYC TRANSIT AUTHORITY,0,1,-1
17910,2052700003,BX, HOLLERS AVENUE,,Z9,GRILO ENTERPRISES INC,0,1,-1
17911,4028300108,QN,59 DRIVE,11,V0,CONO NATALE,0,1,-1
17912,4027800038,QN,59-64 68 STREET,01,B3,JOSEPH A CROCE,1,2,-1
17913,5010570015,SI,43 TABB PLACE,01,B2,ANNE MARIE CORI,1,2,-1
17914,2054110219,BX,1550 MACDONOUGH PLACE,01,B1,1550 MAC DONOUGH LLC,1,2,-1
17915,5003610071,SI, COLLEGE AVENUE,10,G0,ROSEMARIE SCAMPAS,0,1,-1
17916,5003680093,SI,89 GOODWIN AVENUE,01,A1,"AMATO, JOSEPH JR",1,2,-1
17917,3005550032,BK,112 SULLIVAN STREET,06,E2,FICORIA 112 SULLIVAN,1,2,-1
17918,2055240213,BX, PENNYFIELD AVENUE,01,Z0,POLYANA NIETO,0,1,-1
17919,5031190051,SI,22 WINDOM AVENUE,01,A5,"LAZEBNIK, ALLA",1,2,-1
17920,5045000800,SI, TANGLEWOOD DRIVE,11,V0,NYC DEPARTMENT OF CITYWIDE ADMINISTRATIVE SERVICES,0,1,-1
17921,3071980034,BK,2488 EAST 3 STREET,01,B3,ANTHONY NUNZIATA,2,3,-1
17922,5004470012,SI,305 BIDWELL AVENUE,01,A2,GREGORY NAEDER,1,2,-1
17923,3001990003,BK,146 FURMAN STREET,07,T2,BROOKLYN BRIDGE PARK DEVELOPMENT CO,5,6,-1
17924,4127170143,QN,187-19 PINEVILLE LANE,01,A1,KAREN BARNES,1,2,-1
17925,5046450096,SI,379 TIMBER RIDGE DRIVE,01,B9,"TRICOMI, MICHAEL",1,2,-1
17926,5010060090,SI,57 ANN STREET,01,B9,"GALARZA, MIRIAN",1,2,-1
17927,5047460026,SI,47 DELWIT AVENUE,11,V0,"SIY SOCCER LEAGUE, INC.",1,2,-1
17928,5070220003,SI,20 BROOKSIDE LOOP,01,B2,FELICETTA L. TANTILLO REAL EST IRREVOCAB LE TRUST,1,2,-1
17929,5007240038,SI,48 WHEELER AVENUE,01,A1,"WONG, GARY K",1,2,-1
17930,4131470019,QN,223 STREET,10,G0,"WEAY, EGERTON A.",0,1,-1
17931,3009080006,BK,8 AVENUE,07,U0,UNAVAILABLE OWNER,0,1,-1
17932,3073860146,BK,2913 AVENUE W,05,O7,2913 AVENUE W LLC,0,1,-1
17933,5005620048,SI, GORDON STREET,11,V0,JOAN M DOWNES,0,1,-1
17934,5005810001,SI,150 CEBRA AVENUE,01,A1,IRIS HUENTAS,1,2,-1
17935,5070940054,SI,56 BERKSHIRE LANE,01,A5,"SPAGNOLI, JOHN",1,2,-1
17936,2036860047,BX,2163 HERMANY AVENUE,01,B1,"LACHMAN, DIANA",1,2,-1
17937,5071530025,SI, ARTHUR KILL ROAD,11,V1,"DONJON MARINE CO., INC.",0,1,-1
17938,4024340004,QN,69 STREET,10,G7,TNI OWNERS LLC,0,1,-1
17939,4035810021,QN,60-44 ST FELIX AVENUE,10,G0,"MISTRETTA, JOSEPH",0,1,-1
17940,5062470034,SI,1037 ANNADALE ROAD,01,A1,"DECHBERY, JONATHAN I",1,2,-1
17941,4142340280,QN,160 AVENUE,11,V0,"PROJECT REBUILD, INC.",0,1,-1
17942,3016790135,BK,208 DECATUR STREET,04,S1,DECATUR REALTY CORP,1,2,-1
17943,3015037502,BK,729 DECATUR STREET,02,R1,UNAVAILABLE OWNER,0,1,-1
17944,4023810040,QN,65TH PLACE,04,K4,REISSANIDIS TWINS REALTY LLC,1,2,-1
17945,4018240021,QN,36 AVENUE,,Z9,"QDG PARKING PARTNERS, LLC",0,1,-1
17946,4153080038,QN,727 SHAD CREEK ROAD,01,A1,TRUDDEN MICHAEL P,1,2,-1
17947,3019090045,BK, CLASSON AVENUE,11,V0,CAR-SAL ASSOCIATES,0,1,-1
17948,5006690060,SI,104 ONTARIO AVENUE,01,A1,RICHARD PUPELLO,1,2,-1
17949,3017700002,BK,201 NOSTRAND AVENUE,10,G7,PENTECOSTAL HOUSE OF PRAYER INC,0,1,-1
17950,5065170045,SI,41 ARBUTUS WAY,01,A1,LOUIS FIGLIOLIA,0,1,-1
17951,4157350043,QN,25-14 CORNAGA AVENUE,01,A0,ROMEO ROBERT,1,2,-1
17952,4157490215,QN,10-39 BAY 32 STREET,01,B2,"LANGSNER, STEVEN",1,2,-1
17953,3021330019,BK,218 BROADWAY,05,K1,218 BROADWAY NYC LLC,0,1,-1
17954,4159050001,QN, ROCKAWAY BEACH BLVD,11,V0,BENJAMIN BECHWOOD DUNES LLC,0,1,-1
17955,5005120057,SI, SANDS STREET,11,V0,SELVARANJINI SELVARAJ,0,1,-1
17956,4159050279,QN,65-15 SEASPRAY AVENUE,01,B2,"JACKSON, LORRAINE",1,2,-1
17957,5072070305,SI,101 MILA WAY,11,V1,BLOCK 7207 REALTY LLC,0,1,-1
17958,5000390049,SI,125 BENZIGER AVENUE,01,B2,"LOUTFI, JIMMY",0,1,-1
17959,3077290035,BK,EAST 45 STREET,07,U6,LIRR,0,1,-1
17960,4160920010,QN,7010 BEACH FRONT ROAD,01,B2,"LOYER, JOE",1,2,-1
17961,4160920065,QN,6911 NAUTICAL WAY,01,B2,HERIBERTO COLLAZO,1,2,-1
17962,5069790010,SI,15 SANTA MONICA LANE,01,B9,MAGUIRE AVENUE REALTY CORP,1,2,-1
17963,3077490071,BK,1230 EAST 46 STREET,01,A5,"BALOGUN, RASHIDAT H",1,2,-1
17964,3077800045,BK,5410 AVENUE I,10,G0,MARGARET KIRNON,0,1,-1
17965,5070930001,SI,112 HARRIS LANE,01,A5,"RUSSO, MICHELLE",1,2,-1
17966,3031720041,BK,127 TROUTMAN STREET,02,C1,127 TROUTMAN LLC,0,1,-1
17967,3032490035,BK,371 STOCKHOLM STREET,04,D7,BUT WHY CORP.,1,2,-1
17968,5001160017,SI, SUMNER PLACE,11,V0,DANA SCHIAVO,0,1,-1
17969,3036610001,BK, NEW JERSEY AVENUE,10,G7,AWAN ABDUL J,0,1,-1
17970,3037460042,BK,437 SUTTER AVENUE,10,G7,435 SUTTER AVENUE REALTY LLC,0,1,-1
17971,5001430047,SI,65 NORTH MADA AVENUE,01,A1,"GRAFFEO, DIANE",1,2,-1
17972,5070930017,SI,85 HARRIS LANE,01,A5,ZIM GROUP LLC,2,3,-1
17973,5001680081,SI,721 FOREST AVENUE,05,K1,"719 FOREST AVENUE, LLC",0,1,-1
17974,4004650375,QN, QUEENS PLAZA,07,Y8,NYC DEPARTMENT OF PARKS AND RECREATION,0,1,-1
17975,5072670092,SI,35 JADE COURT,01,A5,"MEJIA, CAMILO",1,2,-1
17976,3041530074,BK,356 LOGAN STREET,02,C0,"PINO, CESAR",2,3,-1
17977,5008490250,SI,99 HOLLY STREET,01,A1,"CORAPI, KRISTIN",1,2,-1
17978,5075720063,SI,11 MADSEN AVENUE,01,B2,MCMASON PARTNERS LLC,1,2,-1
17979,5002250018,SI,282 MYRTLE AVENUE,01,A1,MICHAEL ZANIEWSKI,1,2,-1
17980,5005030032,SI,340 BAY STREET,05,O1,340 BAY LLC,1,2,-1
17981,3081690013,BK,EAST 100 STREET,07,U7,NYC TRANSIT AUTHORITY,0,1,-1
17982,5075960151,SI,27 TOPSIDE LANE,01,A5,"IRREVOCABLE LIVING TRUST, THE MARILYN PE RRETTI",1,2,-1
17983,5077020288,SI,36 PENTON STREET,01,A5,KHADDOUJ ELHATTAB,1,2,-1
17984,3045270005,BK,1100 STANLEY AVENUE,01,B2,"ADOLPHE, DARIUS",1,2,-1
17985,5077550061,SI,6779 HYLAN BOULEVARD,01,A5,"RAM, NOREEN",1,2,-1
17986,5002930115,SI,684 OAKLAND AVENUE,01,A1,"ZUNINO, JOHN B",1,2,-1
17987,3083690388,BK,1344 EAST 70 STREET,01,B2,"PACHASHYNSKYY, BOHDAN",1,2,-1
17988,3083690390,BK,1354 EAST 70 STREET,01,B2,"KLIN, GENE",1,2,-1
17989,3083690409,BK,1335 EAST 69 STREET,01,B9,"ULITSKIY, BORIS",1,2,-1
17990,5003700124,SI,20 CROWELL AVENUE,01,A1,ELLEN I BANNEY,1,2,-1
17991,5077920252,SI,406 PAGE AVENUE,01,A1,"GUZZONE, JOSEPH",0,1,-1
17992,3047560053,BK,616 ROCKAWAY PARKWAY,01,B1,ASLLEY ROBINSON,1,2,-1
17993,5003900088,SI,63 ELDRIDGE AVENUE,01,A1,FRANCIS T O'NEILL,1,2,-1
17994,3083930054,BK,7224 AVENUE N,01,A5,"SEMIDUBERSKY, LUBOV",2,3,-1
17995,5004280003,SI,299 DEEMS AVENUE,01,A1,ERIC FELTHAM IRREVOCABLE TRUST,1,2,-1
17996,5005180075,SI,35 SMITH TERRACE,01,B2,R MCANDREW,1,2,-1
17997,5006540023,SI, SENECA AVENUE,10,G0,"MASSA, MARGARET A",0,1,-1
17998,5072930010,SI, CLAY PIT ROAD,11,V1,NYS OFFICE OF GENERAL SERVICES,0,1,-1
17999,5077100202,SI,411 RICHARD AVENUE,01,B2,UNAVAILABLE OWNER,1,2,-1
18000,5007090042,SI,21 JOSEPHINE STREET,01,A1,PSAAB LLC,1,2,-1
18001,3086770089,BK,3041 BRIGHTON 7 STREET,11,V0,393 SUMPTER LLC,0,1,-1
18002,5026290081,SI,61 MILDRED AVENUE,01,A5,"KOMON, JUDYNTA",1,2,-1
18003,5008980061,SI,1101 TODT HILL ROAD,01,A2,LINDA CAPUANO,1,2,-1
18004,5009080200,SI,1A CLIFFWOOD AVENUE,08,Y1,U S A,1,2,-1
18005,5010750043,SI,30 KIRKLAND COURT,01,A5,SILVIA FIGUEROA,1,2,-1
18006,5003710075,SI,71 RAYMOND AVENUE,01,A1,SABINA A. TRANCUCCI IRREVOCABLE TRUST,1,2,-1
18007,5011210044,SI,161 JOHN STREET,01,A1,"JOY, AS TRUSTEE, DORIS MARIE",1,2,-1
18008,5013180136,SI, HOLLAND AVENUE,11,V0,NYC DEPARTMENT OF PARKS AND RECREATION,0,1,-1
18009,4096030008,QN,124 STREET,11,V0,KHAN MOHAMED H A,0,1,-1
18010,5010560030,SI, PORT RICHMOND AVENUE,10,G7,SILVESTRO & SCOLARO,0,1,-1
18011,5021110136,SI,82 GARY PLACE,01,B9,NICOLE PUMA,1,2,-1
18012,4001640011,QN,45-02 QUEENS BOULEVARD,11,V1,RASELL REALTY CORP,0,1,-1
18013,5077300072,SI, DUVAL AVENUE,11,V0,NYC DEPARTMENT OF CITYWIDE ADMINISTRATIVE SERVICES,0,1,-1
18014,5023900203,SI,22 LILLIE LANE,01,A5,MONIKA A SAMEK,1,2,-1
18015,5023900323,SI,23 LILLIE LANE,01,A5,"HERNANDEZ, ITZA",1,2,-1
18016,4094830037,QN,134-23 101 AVENUE,11,V0,"JAGERNAUTH, RANDOLPH",0,1,-1
18017,5021100056,SI,50 SLEEPY HOLLOW ROAD,01,A5,"RIVERA, EVELYN",1,2,-1
18018,5028580027,SI,22 WHITE STREET,01,A1,P &C MATTIOLA,1,2,-1
18019,3060280007,BK,8407 FT HAMILTON PARKWAY,04,S2,"TZANIDES, ELIAS",1,2,-1
18020,3061550055,BK,1259 70 STREET,02,C0,1257 70TH STREET LLC,0,1,-1
18021,3054951149,BK,21 AVENUE,11,V0,NYC DEPARTMENT OF EDUCATION,0,1,-1
18022,5028910024,SI,379A BRITTON AVENUE,10,G0,JAMES A HILL,0,1,-1
18023,5028990172,SI,43 MOSEL AVENUE,01,A5,"LAU, CHRISTINE POOI LENG",1,2,-1
18024,2054860006,BX,616 CLARENCE AVENUE,01,B9,MIMNAGH FAMILY TRUST,1,2,-1
18025,5032460001,SI,491 MC CLEAN AVENUE,01,A2,"AMMIRATI, FRANK",1,2,-1
18026,5031080060,SI,173 SAND LANE,01,A5,"ADOVIC, ADMIRA",0,1,-1
18027,5032480031,SI,226 MALLORY AVENUE,01,B3,"LEE, WAI LUEN",1,2,-1
18028,3056200013,BK,1014 46 STREET,02,C0,CONGREGATION ELIEZER ZISYA,1,2,-1
18029,1005000016,MN,120 PRINCE STREET,04,S9,"120 PRINCE STREET OWNER, LLC",1,2,-1
18030,4008727502,QN,25-50 CRESCENT STREET,04,RM,UNAVAILABLE OWNER,1,2,-1
18031,4094810035,QN,97-13 133 STREET,01,A1,"DEONARAIN, LELOUTIE",1,2,-1
18032,5035000114,SI,481R FR CAPODANNO BLVD,01,B9,"BURLAKA, IRYNA",1,2,-1
18033,3017610009,BK,226 VERNON AVENUE,02,C3,VERNON PARK LLC,0,1,-1
18034,3067630140,BK,EAST 17 STREET,11,V0,CHOW SIMON,0,1,-1
18035,5036170043,SI,252 BANCROFT AVENUE,01,A3,"NASO, PIETRO",1,2,-1
18036,5036290049,SI, CLOISTER PLACE,10,G0,AUGUST ORLANDO,0,1,-1
18037,5036510007,SI, HYLAN BOULEVARD,11,V1,MIRJAM ZYLBERBERG,0,1,-1
18038,5036860011,SI, HUNTER AVENUE,11,V0,"GJEMNICA, BEKIM",0,1,-1
18039,5037900054,SI, FREEBORN STREET,11,V0,"THE NATURE CONSERVANCY, INC.",0,1,-1
18040,5012300098,SI,222 UNION AVENUE,02,C0,"222 UNION AVE, LLC",1,2,-1
18041,5040470049,SI, WINHAM AVENUE,10,G0,ROMAN JANAS,0,1,-1
18042,5040480020,SI,166 WEED AVENUE,01,A5,WILLIAM SCHWEITZER,1,2,-1
18043,1010350025,MN,WEST 44 STREET,10,G6,"307 WEST 44TH STREET,",0,1,-1
18044,5042740107,SI,118 PETER AVENUE,01,A2,"MOREA, PASQUALE G",1,2,-1
18045,4036100032,QN, TRAFFIC AVENUE,10,G0,"LINDEN 47 GROUP, LLC",0,1,-1
18046,4092800037,QN, JAMAICA AVENUE,10,G7,WEBB ENTERPRISES INC.,0,1,-1
18047,5051950086,SI,34 WATERSIDE PARKWAY,01,A1,"TRASBORG, RICHARD",1,2,-1
18048,5052230101,SI,4 SHERWOOD PLACE,01,A1,"ZIEWIEC, JOANNA OSIECKA",1,2,-1
18049,1011717502,MN,220 RIVERSIDE BOULEVARD,04,RM,UNAVAILABLE OWNER,1,2,-1
18050,1011820012,MN,345 WEST 70 STREET,03,D4,345 WEST 70 STREET TENANTS CORP,1,2,-1
18051,4031480018,QN,85-16 68 AVENUE,01,A5,"GUAN, SHENGLI",1,2,-1
18052,1000980001,MN,304 PEARL STREET,10,G6,"250 SEAPORT DISTRICT, LLC",0,1,-1
18053,1013530012,MN,1 AVENUE,07,T9,MTA - BRIDGES AND TUNNELS,0,1,-1
18054,5032890051,SI,151 WILSON STREET,01,A2,WALERIA LESNIANSKI,1,2,-1
18055,1014140105,MN,209 EAST 59 STREET,04,C7,E.G.A ASSOCIATES INC,1,2,-1
18056,5013180220,SI,172 HOLLAND AVENUE,11,V0,MNM MANAGEMENT LLC,1,2,-1
18057,5057350375,SI,220 PRESENTATION CIRCLE,01,A5,"LAURO, LISA",1,2,-1
18058,5057350424,SI,99 PRESENTATION CIRCLE,01,A5,VINCENT DELPRETE,1,2,-1
18059,3075950003,BK,3117 AVENUE J,01,A5,"WINZELBERG, HAROLD",1,2,-1
18060,4032950052,QN, UNION TURNPIKE,10,G0,"CHEN, JIAGUO",0,1,-1
18061,4033390105,QN,75 ROAD,10,G0,"WELZ, NICOLE",0,1,-1
18062,5061460027,SI,799 ROSSVILLE AVENUE,01,A5,TORREDELFINO FAMILY IRREVOCABLE TRUST,1,2,-1
18063,5062430021,SI,12 SHERIDAN PLACE,01,A1,"BALK, HELEN A",1,2,-1
18064,5062540150,SI,870 ANNADALE ROAD,07,U6,MTA - STATEN ISLAND RAILWAY,0,1,-1
18065,5062810056,SI, EDGEGROVE AVENUE,11,V0,ANNA MAKARIGAKIS,0,1,-1
18066,5062910001,SI, STAFFORD AVENUE,11,V0,NYC DEPARTMENT OF ENVIRONMENTAL PROTECTION,0,1,-1
18067,5063330201,SI,1452 DRUMGOOLE ROAD WEST,01,B2,"CHERKASOV, ROMAN",0,1,-1
18068,3079680018,BK,8906 BEDELL LANE,01,B1,CAESAR GODFREY,1,2,-1
18069,5067280109,SI,621 JOHNSTON TERRACE,01,A5,"BASTI, JEFFREY",1,2,-1
18070,4033390103,QN,75 ROAD,10,G0,"KIRRANE, JAMES",0,1,-1
18071,1017530037,MN,1890 PARK AVENUE,07,G3,JASMAN ENTERPRISES INC.,1,2,-1
18072,2033600120,BX, WEBSTER AVENUE,07,U6,MTA - METRO NORTH,0,1,-1
18073,5033070084,SI, CORNELIA STREET,11,V0,CATHOLIC CHARITIES ARCHDIOCESE NY,0,1,-1
18074,4032940018,QN,75 AVENUE,10,G0,THE RICHARD EDWARD MARTINEZ CREDIT SHELT ER TRUST,0,1,-1
18075,3084720060,BK,1848 MADISON PLACE,01,A9,"TARVER, ALLEN G.",1,2,-1
18076,5070940072,SI,8 BERKSHIRE LANE,01,B9,"KAMINSKY, JOHN",1,2,-1
18077,2023310036,BX,338 EAST 150 STREET,10,G7,YESHIVA UNIVERSITY,0,1,-1
18078,5002270102,SI,39 CORNELL AVENUE,01,B2,MARION S SCHAAL,1,2,-1
18079,5072060101,SI,360 INDUSTRIAL LOOP,06,F5,MARSHAL LIGHTING GROUP LLC,1,2,-1
18080,4002140100,QN,39 STREET,07,U0,UNAVAILABLE OWNER,0,1,-1
18081,2023790015,BX,EAST 158 STREET,11,V0,NYC DEPARTMENT OF PARKS AND RECREATION,0,1,-1
18082,2024090073,BX,EAST 162 STREET,09,Q2,NYC DEPARTMENT OF PARKS AND RECREATION,0,1,-1
18083,5016680001,SI,1126 RICHMOND AVENUE,09,Z8,BARON HIRSCH CEMETERY,1,2,-1
18084,5001850390,SI,,07,U9,CITY OF NEW YORK,0,1,-1
18085,4005010160,QN, VERNON BOULEVARD,11,V1,NYC DEPARTMENT OF PARKS AND RECREATION,0,1,-1
18086,4005120001,QN,12-22 ASTORIA BOULEVARD,11,V1,12-20 ASTORIA BOULEVARD LLC,0,1,-1
18087,5077860108,SI,40 DAWN COURT,01,A3,"STEFOPOULOS, NIKOLAOS",1,2,-1
18088,4074650029,QN,58-54 215 STREET,01,A2,FU WAN CHAN,1,2,-1
18089,4028140107,QN,75 STREET,01,Z0,BRANDOFINO,0,1,-1
18090,2029420001,BX,1700 CROTONA AVENUE,09,Q1,NYC DEPARTMENT OF PARKS AND RECREATION,3,4,-1
18091,4017600020,QN,37-38 98 STREET,01,B2,"PAGUAY, CARLOS",1,2,-1
18092,5022310165,SI,57 BERGLUND AVENUE,02,C2,ANTHONY FANELLI,1,2,-1
18093,4029420060,QN,82-31 61 DRIVE,01,A1,"KEARNEY, PATRICK",2,3,-1
18094,2031980014,BX,2310 GRAND AVENUE,01,A5,"LITTLE, BIBI AYESHA",1,2,-1
18095,3071590067,BK,724 GRAVESEND NECK ROAD,01,B3,SALMAN EZRA,2,3,-1
18096,4008760018,QN,21-12 23 TERRACE,01,B1,DAPHNE CERINA,1,2,-1
18097,3079040032,BK,1427 EAST 59 STREET,01,B1,"DIXON, LARRY",1,2,-1
18098,3079320210,BK, PRESTON COURT,,Z9,CAPTAIN HOLDINGS CORP.,0,1,-1
18099,4012580018,QN,34-28 72 STREET,01,A5,"RAYANI, SHIRAZ H",1,2,-1
18100,5023060277,SI, MEEKER STREET,11,V0,"MORACE, DAVID",0,1,-1
18101,3080090037,BK,8814 GLENWOOD ROAD,01,A1,"JOISSIN, BILLCARDO",1,2,-1
18102,3080550045,BK,1382 REMSEN AVENUE,01,B1,"OSIKOYA, MORENIKE",1,2,-1
18103,3080730001,BK,EAST 80 STREET,07,U2,CON EDISON,0,1,-1
18104,3082030073,BK,1202R EAST 96 STREET,,Z9,"FSNR ACQUISITION GROUP, LLC",1,2,-1
18105,4014010023,QN,31-36 90 STREET,01,A5,"D'SOUZA, EDWARD N",2,3,-1
18106,4031040133,QN,91-09 64 ROAD,01,A5,"CHEN, SHU FEI",1,2,-1
18107,3086160131,BK, EAST MILL BASIN,11,V0,"DI MEGLIO, FRANCO",0,1,-1
18108,4015690054,QN,42-87 HAMPTON STREET,01,B3,"PERALTA , SEGUNDO",1,2,-1
18109,4032320017,QN,70 ROAD,10,G0,"ROCSIN, MARIA ROXANA",0,1,-1
18110,4032820012,QN, GREENWAY SOUTH,10,G0,FOX INGO H R,0,1,-1
18111,1010940024,MN,613 WEST 46 STREET,10,G7,"613 WEST 46, LLC",0,1,-1
18112,4077230010,QN, FRANCIS LEWIS BLVD,09,Q1,NYC DEPARTMENT OF PARKS AND RECREATION,0,1,-1
18113,4033170014,QN,80-45G PARK LANE,10,G0,"CHOUDRI, QAISER",0,1,-1
18114,4075210061,QN,57-42 228 STREET,01,B2,ANTHONY SCALA,1,2,-1
18115,4013230009,QN,41-38 55 STREET,01,B2,JOHN STROUMBOS,1,2,-1
18116,4003660018,QN,37-11 23 STREET,05,H3,NEW GENERATION DEVELOPMENT LLC,0,1,-1
18117,1020350001,MN,2802 FREDRICK DOUGLASS BL,04,C7,DUNBAR OWNER LLC,6,7,-1
18118,4033370155,QN, AUSTIN STREET,10,G0,CHRISTOPHER HANUSA,0,1,-1
18119,2023690045,BX,511 EAST 164 STREET,05,H9,MBX ACQUISITION HOLDINGS II LLC,1,2,-1
18120,4007300045,QN,46-12 25 AVENUE,01,B1,FRANCES PETRUSO,1,2,-1
18121,4020180300,QN,44 AVENUE,07,U7,LIRR,0,1,-1
18122,4007680025,QN,22-25 46 STREET,06,E7,"2225 46TH ST, LLC",1,2,-1
18123,5028470107,SI, VIRGINIA AVENUE,09,Q0,NYC DEPARTMENT OF PARKS AND RECREATION,0,1,-1
18124,5028980022,SI,663 ELBE AVENUE,01,A5,ELBE AVENUE LLC,0,1,-1
18125,5028990173,SI,45 MOSEL AVENUE,01,A5,VINCCI S. HOEI/AKA SHUK YIN HOEI,1,2,-1
18126,4074240007,QN,53-18 BELL BOULEVARD,01,A1,STEVE F PAVICH,2,3,-1
18127,2025420041,BX, CROSS BRONX EXPWY,07,U6,MTA - METRO NORTH,0,1,-1
18128,4025620025,QN,56 ROAD,10,G1,W B WERWAISS REALTY LLC,0,1,-1
18129,4026500061,QN,60 ROAD,10,G7,JILLIAN BRETT CORP.,0,1,-1
18130,4073140005,QN,45-39 211 STREET,01,B1,"ZHENG, CURTIS WEI",1,2,-1
18131,5012770199,SI,18 MACORMAC PLACE,01,A2,ADA GILCHRIST,1,2,-1
18132,4008750031,QN,23-29 23 STREET,01,A5,"ARISTODEMOU, ARISTOS",1,2,-1
18133,4033390019,QN,75 ROAD,10,G0,RICHARD NEIL TYLER,0,1,-1
18134,4028100040,QN,57 ROAD,11,V0,"MILEWSKA, ANNA E",0,1,-1
18135,5029740035,SI,246 ST MARYS AVENUE,01,B2,MARC J VALARA,1,2,-1
18136,4036640045,QN,70-29 72 STREET,10,G0,"CERVERA, NICOLA",0,1,-1
18137,4013460034,QN,68-07 43 AVENUE,02,C0,"LAM, PIN WONG",1,2,-1
18138,5029920001,SI,315 VIRGINIA AVENUE,01,B2,"ABOUZEID, MEDHAT",0,1,-1
18139,2032770124,BX,386 EAST 195 STREET,02,C1,UNAVAILABLE OWNER,0,1,-1
18140,4012620026,QN,34-36 76 STREET,01,A5,LINDA L. BORMAN (TRUSTEE),2,3,-1
18141,2038120045,BX,1211A CASTLE HILL AVENUE,10,G0,BERTINI LINDA,0,1,-1
18142,4033370148,QN, AUSTIN STREET,10,G0,"EDEN, JEFFREY",0,1,-1
18143,2032950029,BX,260 EAST 197 STREET,02,C0,CEELENA JODHARAM,1,2,-1
18144,4038860847,QN,96-22 METROPOLITAN AVENUE,05,K2,VENETIAN MANAGEMENT LLC,1,2,-1
18145,4034350001,QN,565 SENECA AVENUE,04,S5,565 SENECA LLC,1,2,-1
18146,4039480009,QN,124-16 5 AVENUE,01,B2,"LIN, XIUNA",1,2,-1
18147,5033150070,SI, BEAR STREET,01,B2,44 BEAR STREET LLC,0,1,-1
18148,2033840010,BX,4288 KATONAH AVENUE,02,C0,PAUL BROWNE,1,2,-1
18149,3017620055,BK,212 SPENCER STREET,02,C1,212 SPENCER LLC,0,1,-1
18150,4036190003,QN,66-99 FRESH POND ROAD,07,T9,NYC TRANSIT AUTHORITY,2,3,-1
18151,4017320025,QN,98-11 35 AVENUE,01,B3,WASHINGTON FRANK,3,4,-1
18152,4037090006,QN,73-41 71 STREET,01,B2,BOMMARITO VALERIE,1,2,-1
18153,4037970010,QN,69-07 78 STREET,01,B3,"LUNDGREN, JEREMIAH",1,2,-1
18154,4063990014,QN,138-18 63 AVENUE,01,A5,"COLARUSSO, ELIA",1,2,-1
18155,5030400203,SI,561 STEUBEN STREET,01,A2,"MORALES, LINDA",1,2,-1
18156,4038800086,QN,80-60 TROTTING COURSE LANE,01,A1,"SAN JUAN, DONATO",1,2,-1
18157,2034630001,BX, RANDALL AVENUE,09,Q1,NYC DEPARTMENT OF PARKS AND RECREATION,0,1,-1
18158,4162850066,QN,150 BEACH 141 STREET,01,A1,"FONDA SARA, AMY",1,2,-1
18159,4000110001,QN,54-19 2ND STREET,06,E1,55-01 F LLC,1,2,-1
18160,4015220174,QN,76 STREET,10,G0,"LOLIS, PANTELIS",0,1,-1
18161,4040240050,QN,9-37 117 STREET,01,A1,"CHAUCA, JUAN",1,2,-1
18162,5000390031,SI,44 HENDRICKS AVENUE,01,B2,"MA , KARL",0,1,-1
18163,4163230024,QN,1-55 BEACH 149 STREET,01,A3,"ILYAEV, SHOLOM A",1,2,-1
18164,1007360030,MN,405 WEST 38 STREET,10,G6,"509 NINTH AVENUE, LL",0,1,-1
18165,5032940095,SI, DELAWARE AVENUE,11,V0,M D PETOSA,0,1,-1
18166,4043780040,QN,122-16 31 AVENUE,06,E1,NOFELCO SERVICE INC,1,2,-1
18167,4051750033,QN,148 STREET,10,G0,"YUNG, MELISSA MEI CHU",0,1,-1
18168,3074050330,BK,2372 EAST 24 STREET,02,C0,WONG BING,1,2,-1
18169,4044670052,QN,2-29 148 STREET,01,A1,"CASABIANCA, GIANPIERO",1,2,-1
18170,3074110019,BK,2426 EAST 11 STREET,10,G0,"CHENG, VIENNA PUI",0,1,-1
18171,4027120013,QN,57-11 61 STREET,08,M1,ST STANISLAUS R C CHU,1,2,-1
18172,2042650044,BX, BOGART AVENUE,10,G0,ALFRED LIOSI,0,1,-1
18173,4046830050,QN,151-09 17 AVENUE,01,B2,"XIAO, FANGQIN",1,2,-1
18174,5033300014,SI,232 BURGHER AVENUE,01,B2,"WONG, LAN CHING",1,2,-1
18175,5033780048,SI,424 CROMWELL AVENUE,01,B9,"SARINA SANFELICE, AS TRUSTEE",1,2,-1
18176,5033910038,SI,84 OBERLIN STREET,01,A2,ANTHONY FIGUCCIO,1,2,-1
18177,1007950066,MN,140 WEST 20 STREET,11,V1,NYC DEPARTMENT OF PARKS AND RECREATION,0,1,-1
18178,4059710044,QN,28-19 JORDAN STREET,01,A0,"ASARO, CALOGERO",2,3,-1
18179,1009000057,MN,239 3 AVENUE,11,V1,200 EAST 20TH LLC,1,2,-1
18180,5034720032,SI,522 SEAVIEW AVENUE,01,B9,UNAVAILABLE OWNER,1,2,-1
18181,5028470191,SI, VIRGINIA AVENUE,11,V0,F CARULLO,0,1,-1
18182,4052830079,QN,35-54 164 STREET,01,A2,"ILA V. POSTREL, TRUSTEE",1,2,-1
18183,4052990043,QN,35-24 172 STREET,01,A3,"GANG, OK NEYO",1,2,-1
18184,5035380001,SI, BUEL AVENUE,07,U9,MTA - STATEN ISLAND RAILWAY,0,1,-1
18185,4032950066,QN, UNION TURNPIKE,10,G0,"BAZIN, ATINA",0,1,-1
18186,2045540038,BX, PAULDING AVENUE,10,G0,"HAMEED, SHABBAZ",0,1,-1
18187,5035920118,SI,17 FREMONT AVENUE,01,A1,MARCHWINSKI ROSEMARIE,1,2,-1
18188,4035980072,QN,74-68 64 LANE,01,B2,OPREA EMIL,1,2,-1
18189,4036050033,QN,65-103 TERRACE COURT,02,C0,"PUN, CHAN HONG",1,2,-1
18190,4036670650,QN, OTTO ROAD,07,U7,LIRR,0,1,-1
18191,4060550011,QN,214 STREET,11,V0,CHARLES CAMINITI,0,1,-1
18192,2046730069,BX,840 EAST 215 STREET,01,A1,"BABILAA, MELINDA",1,2,-1
18193,4038160074,QN,77-56 79 PLACE,01,A9,LINDA DIFINIZIO,1,2,-1
18194,4038270013,QN,78-06 79 STREET,01,A9,MARKOWITZ FRANK,1,2,-1
18195,4038800063,QN,80-05 MARGARET PLACE,01,B3,"CHAN, TSUN KUEN",1,2,-1
18196,4038830064,QN,90-44 83 AVENUE,01,A2,"ESTEVEZ-CREEDON*, AMELIA C",1,2,-1
18197,4028100029,QN,73-24 57 AVENUE,01,B2,ROXANN F HOLLAND,2,3,-1
18198,4065010021,QN,63-48 136 STREET,01,A5,"DEE, AS TRUSTEE, KENNETH R",1,2,-1
18199,4162180010,QN,249 BEACH 122 STREET,01,A1,ANDREW J STONE 3RD,1,2,-1
18200,4026520018,QN,59-57 59 PLACE,01,B2,"GOROWSKI, DOUGLAS R",1,2,-1
18201,4060540082,QN,32-38 214 STREET,01,A3,LOUISE CHIN,1,2,-1
18202,2032900004,BX,2772 BAINBRIDGE AVENUE,01,A1,"BHEEM, KULDIP",2,3,-1
18203,4072130025,QN,75-60 197 STREET,01,B1,AMI A BAR-MASHIAH,1,2,-1
18204,2049220086,BX,3605 MAROLLA PLACE,02,C0,MARLENE ADIGUN,1,2,-1
18205,5037060052,SI,445 NAUGHTON AVENUE,01,B3,"DONG, QI LANG",1,2,-1
18206,4045270068,QN,151-31 11 AVENUE,01,A0,"VANGELATOS, CHRISTOS",1,2,-1
18207,2049220141,BX,3606 BOLLER AVENUE,01,B2,"SMITH, PETRONA A.",1,2,-1
18208,3087520068,BK,140 JAFFRAY STREET,01,A1,"KAHN, DROR",2,3,-1
18209,2050710048,BX,4423 BYRON AVENUE,01,B3,"OLIVARES, JOSE",1,2,-1
18210,4082330407,QN,249-44 RUSHMORE TERRACE,01,A2,"LU, HUN",2,3,-1
18211,4084010150,QN, COMMONWEALTH BLVD,11,V1,NYC PARK DEPT,0,1,-1
18212,4046370052,QN,146-31 22 AVENUE,01,B2,"LI, HONG FEI",1,2,-1
18213,4088320039,QN,268 STREET,11,V0,"LEWIS, MARJORIE",0,1,-1
18214,4046580038,QN,147-39 24 AVENUE,01,A5,YEUKLIN MUI,2,3,-1
18215,4047210007,QN,15-35 CLINTONVILLE STREET,01,A1,"SCARDA, ENRICO",1,2,-1
18216,4082610076,QN,29 VAN NOSTRAND COURT,01,A5,JOSEPH GALLAGHER,1,2,-1
18217,4048530015,QN,30-37 154 STREET,01,A2,"CHEN, JINHUA",1,2,-1
18218,5077750028,SI,52 BELWOOD LOOP,01,A3,"FERGUSON, SHARON",1,2,-1
18219,1004110058,MN,149 ESSEX STREET,03,D5,152 LUDLOW STREET LLC,2,3,-1
18220,4032950062,QN, UNION TURNPIKE,10,G0,"SAVAYAN, ZAROUHI",0,1,-1
18221,2054060076,BX,3165 WATERBURY AVENUE,01,A2,"GUERRERO SOTO , FRANK",1,2,-1
18222,2054090313,BX,3351 CAMPBELL DRIVE,01,A1,FRANK MARINO,1,2,-1
18223,5037970018,SI,176 FREEBORN STREET,01,A5,ALEJANDRA VILLA,1,2,-1
18224,2054160125,BX,1634 LIBRARY AVENUE,01,B2,"FANG, JI HING",1,2,-1
18225,2054810027,BX, SHORE DRIVE,11,V1,"DAMBINSKY, JUSTIN",0,1,-1
18226,4036000040,QN,72-40 65 PLACE,10,G1,LORE E. WEISS IRREVOCABLE TRUST,1,2,-1
18227,2054880031,BX, ELLSWORTH AVENUE,11,V1,BRONXONIA YACHT CLUB INC,0,1,-1
18228,4056850027,QN,56-46 HOLLIS COURT BLVD,01,B1,"WU, HENRY",1,2,-1
18229,4057400051,QN,163-55 19 AVENUE,01,A1,"NUNEZ, MANUEL",1,2,-1
18230,2055200013,BX, PRENTISS AVENUE,09,Q7,N Y TENNIS CLUB INC,1,2,-1
18231,4058000006,QN,201-04 23 AVENUE,01,A2,JOHN COMISKEY,1,2,-1
18232,4057590028,QN, FRANCIS LEWIS BLVD,07,U2,CONS EDISON,0,1,-1
18233,4060450002,QN,32 DRIVE,10,G0,ABRAHAM BRACHOT,0,1,-1
18234,4090290035,QN,89 STREET,11,V0,"COLORADO, GUSTAVO E",0,1,-1
18235,4032290052,QN,14 GROTON STREET,01,A5,MYRON ABOLITZ,1,2,-1
18236,4090830001,QN,81-19 LIBERTY AVENUE,01,Z0,"GARCIA, EVELYN",0,1,-1
18237,4097830017,QN,84-46 160 STREET,01,A1,"VORVOLAKOS, JOHN",1,2,-1
18238,5012490083,SI,358 HARBOR ROAD,01,B2,"AJAYI, TITI LAYO",1,2,-1
18239,3084030051,BK,2016 EAST 61 STREET,01,A1,"FLECK, DOLORES",1,2,-1
18240,4159660019,QN,472 BEACH 45 STREET,01,B2,CARLOS E. RIASCOS,0,1,-1
18241,2056270040,BX,31 CENTRE STREET,01,A1,KARL E HELGESEN,1,2,-1
18242,4092860068,QN,102 STREET,10,G0,CANELA PATRICIO,0,1,-1
18243,2056460037,BX,151 BOWNE STREET,01,A1,"CASTILLO DE NOVA, ADRIANA",1,2,-1
18244,2056270043,BX,25 CENTRE STREET,01,A1,"BREEN, AIMEE",1,2,-1
18245,4068940045,QN,167 STREET,11,V0,"YU, NGAN CHUEN",0,1,-1
18246,2056290264,BX,61 CAROLL STREET,01,A1,OSBORN IRENE,1,2,-1
18247,4102430091,QN,174-11 POLHEMUS AVENUE,01,B3,"GUILLEN, JOSE",1,2,-1
18248,2046810063,BX,EAST 211 STREET,10,G0,"GORDON, PATRICIA C.",0,1,-1
18249,3005880037,BK,40 COFFEY STREET,01,A5,42 COFFEY STREET LLC,1,2,-1
18250,4094390017,QN,93-20 123 STREET,01,B2,PENELOPE SMITH,1,2,-1
18251,2054090530,BX,3268 SPENCER DRIVE,01,B1,"FILOMENA, PATRICIA",2,3,-1
18252,4020100006,QN,109-24 54 STREET,01,B2,LUIS RIERA,1,2,-1
18253,3083690346,BK,1359 EAST 70 STREET,01,B2,"FEYGIN, DMITRY",1,2,-1
18254,4108200034,QN,191-20 JAMAICA AVENUE,08,M1,C26 DEVELOPMENT CORP.,1,2,-1
18255,5047620027,SI, FOX LANE,10,G0,"CAMUSO, CHRISTOPHER",0,1,-1
18256,5078260391,SI, SPRAGUE AVENUE,11,V0,WESTVIC INC,0,1,-1
18257,4028070054,QN,79 STREET,11,V0,YUE QIU LIN,0,1,-1
18258,4052840011,QN,35-69 164 STREET,01,B1,AJFJ LLC,1,2,-1
18259,4036650007,QN,72-40 EDSALL AVENUE,10,G0,"AMATO, SALVATORE",0,1,-1
18260,4095940027,QN,105-64 135 STREET,01,B3,"SINGH, NATASHA",2,3,-1
18261,1022150652,MN, HARLEM RIVER DRIVE,07,U9,NYC DEPARTMENT OF ENVIRONMENTAL PROTECTION,0,1,-1
18262,4025050107,QN,71 STREET,11,V0,ANNA KATA,0,1,-1
18263,5057400035,SI, ASPEN KNOLLS WAY,,Z9,ASPEN KNOLLS HOMEOWNERS ASSOC,1,2,-1
18264,5061060196,SI,46 WYCLIFF LANE,01,B9,"DISCALA, ANGELO  M",1,2,-1
18265,5063170070,SI, NIPPON AVENUE,11,V0,"PASSALACQUA, ANTHONY",0,1,-1
18266,5036020020,SI, NORTH RAILROAD AVE,07,U9,MTA - STATEN ISLAND RAILWAY,0,1,-1
18267,4052160011,QN,47-12 UNION STREET,01,B1,"YE, XIAN PING",1,2,-1
18268,4092030051,QN,86-71 107 STREET,02,C0,"MEGHAN, OMADATT",1,2,-1
18269,4100450011,QN,144-24 106 AVENUE,01,B2,"ALI, BIBI S",0,1,-1
18270,4049410008,QN,190-11 33 AVENUE,01,A1,JOSE R CRUZ,1,2,-1
18271,4094470032,QN,94-14 132 STREET,01,B2,"LACKHAN, ANTHONY",1,2,-1
18272,5065840028,SI,68 PRALL AVENUE,01,B2,"MINICHELLO, VINCENT",0,1,-1
18273,2022930033,BX, BERGEN AVENUE,10,G6,524-526 BERGEN AVENUE LLC,0,1,-1
18274,3014770025,BK,1406 PITKIN AVENUE,05,O7,UNITY FUNERAL CHAPELS OF NEW YORK CITY I NC,1,2,-1
18275,4025520099,QN,56 ROAD,07,U7,LIRR,0,1,-1
18276,4126860006,QN,198-14 120 AVENUE,01,B2,"QUESLIN, MARIE L.",0,1,-1
18277,4038860846,QN,96-14 METROPOLITAN AVENUE,05,K2,VENETIAN MANAGEMENT LLC,1,2,-1
18278,4039740085,QN,126-05 11 AVENUE,01,B3,ARLENE KAPLAN TRUSTEE,1,2,-1
18279,5071050584,SI,14 PLUMTREE LANE,01,A5,ADEL KHALIL,1,2,-1
18280,3017620006,BK,957 BEDFORD AVENUE,02,C1,957 BEDFORD LLC,0,1,-1
18281,3081680011,BK,1031 EAST 98 STREET,07,U7,NYC TRANSIT AUTHORITY,0,1,-1
18282,2026910056,BX, REV JAMES POLITE AVE,11,V0,"1048 STEBBINS, LLC",0,1,-1
18283,3019697504,BK,4 DOWNING STREET,02,R1,UNAVAILABLE OWNER,1,2,-1
18284,3082850075,BK,1376 EAST 102 STREET,01,A1,HUGH F HOLLINGSWORTH,1,2,-1
18285,4024750005,QN,51-43 SIMONSON STREET,02,C3,"LIN, CHANG YUAN",1,2,-1
18286,4027520008,QN,65 STREET,10,G0,SCATURRO MARGARET,0,1,-1
18287,5020000118,SI,59 MONARCH COURT,01,A5,"WEIS, KAHL",1,2,-1
18288,5078120160,SI, GIEGERICH PLACE,10,G0,A SCHULZ,0,1,-1
18289,5078540067,SI,340 BREHAUT AVENUE,01,A2,"RUFF, STEVEN",1,2,-1
18290,4156600016,QN,13-72 CHANDLER STREET,01,B3,"MCCREADY, KAREN",1,2,-1
18291,4128220006,QN,120-45 237 STREET,01,A1,DESTIL  MARGALIE,1,2,-1
18292,4130110012,QN,217 STREET,11,V1,PAUL ANDERSON,0,1,-1
18293,3023510006,BK,193 BERRY STREET,05,K2,CAB BEDFORD LLC,1,2,-1
18294,3075600051,BK,1602 NEW YORK AVENUE,04,S1,RMP IRRV LIVING TRUST,1,2,-1
18295,4130750060,QN,143-32 181 STREET,01,A2,"ADEMUYIWA, SAMUEL",2,3,-1
18296,3017530018,BK, SANDFORD STREET,11,V1,740 MYRTLE LLC,0,1,-1
18297,5078540075,SI,354 BREHAUT AVENUE,01,A1,ALDO MERAGLIA,1,2,-1
18298,4102070047,QN,111-30 170 STREET,10,G0,WILLIAM JOSEPH B,0,1,-1
18299,4047040001,QN,17-27 MURRAY STREET,01,A1,MAKRIS GEORGE,1,2,-1
18300,4102470102,QN,171-43 108 AVENUE,01,A5,SOUTH JAMAICA HOLDINGS 2 LLC,1,2,-1
18301,3017610006,BK,220 VERNON AVENUE,02,C1,VERNON PARK LLC,0,1,-1
18302,5037900049,SI,135 FREEBORN STREET,11,V0,"FISHER, GLEN",0,1,-1
18303,4138660067,QN, BROOKVILLE BOULEVARD,09,Q1,NYC DEPARTMENT OF PARKS AND RECREATION,0,1,-1
18304,4142280210,QN, BAYVIEW AVENUE,01,Z0,PROJECT REBUILD INC,1,2,-1
18305,4142280848,QN, RUSSELL STREET,01,Z0,"STORMS, MICHAEL K",0,1,-1
18306,4142400115,QN,104 STREET,,Z9,NYC DEPARTMENT OF CITYWIDE ADMINISTRATIVE SERVICES,1,2,-1
18307,4142451374,QN,99-56 JAMES COURT,11,V0,HILGENDORF  EDWARD,0,1,-1
18308,4142531504,QN,102-28 164 AVENUE,01,B1,XIAO HUA PAN,0,1,-1
18309,4151000250,QN,159 STREET,07,U7,NYC TRANSIT AUTHORITY,0,1,-1
18310,4155370133,QN,15-20 CENTRAL AVENUE,06,E1,3480 THIRD AVENUE OWNER REALTY LLC,1,2,-1
18311,2029230013,BX,1838 BATHGATE AVENUE,,Z9,"VILOMAR, RAMON",0,1,-1
18312,3028320027,BK,211 RICHARDSON STREET,02,C2,ST CECILIAS RC CHURCH,1,2,-1
18313,4157710019,QN,546 BRIAR PLACE,01,A1,"MC ALLISTER, ROSALIE",1,2,-1
18314,4104830018,QN,90-35 201 STREET,01,A1,"JACKSON, NATASHA",1,2,-1
18315,3073780054,BK,2283 EAST 17 STREET,04,S1,"KOVALENKO, VALERIY",1,2,-1
18316,5019910032,SI,53 CONRAD AVENUE,01,A5,"MALLA, AMIT",1,2,-1
18317,4044160220,QN,115 MALBA DRIVE,01,A1,ARTICLE FOURTH TRUST U/L/W KONSTANTINOS  DRAGA,2,3,-1
18318,3018610071,BK,113 HERKIMER STREET,05,K1,DELTA KAPPA REALTY CORP,1,2,-1
18319,4020150020,QN,42 AVENUE,10,G0,MOONASAR  STEPHEN,0,1,-1
18320,2032510421,BX,WEST 205 STREET,07,U7,NYC TRANSIT AUTHORITY,0,1,-1
18321,3037920025,BK,429 WYONA STREET,02,C1,BLAKE AVE RESIDENCE LLC,0,1,-1
18322,4112220033,QN,112 ROAD,11,V0,"DEKIE, HISAO",0,1,-1
18323,5000390035,SI,36 HENDRICKS AVENUE,01,B2,"ZHENG, JIANGUO",0,1,-1
18324,5000390041,SI,109 BENZIGER AVENUE,01,B2,"HUANG, TIANTING",0,1,-1
18325,5000510212,SI,120 WESTERVELT AVENUE,01,B2,"ABERCROMBIE, ANTHONY",1,2,-1
18326,2029530035,BX,816 EAST 176 STREET,10,G7,816 E.176TH STREET LLC,0,1,-1
18327,5001160020,SI,174A BRIGHTON AVENUE,10,G0,GILBERT P. MURPHY,0,1,-1
18328,5001300023,SI,776 BRIGHTON AVENUE,01,B3,"CASTELLON, RAUL",1,2,-1
18329,4020080070,QN,108-27 53 AVENUE,01,B2,"ENCALADA , MANUEL",1,2,-1
18330,5080030075,SI,1 BENTLEY STREET,07,U6,MTA - STATEN ISLAND RAILWAY,2,3,-1
18331,5001850152,SI,1641 RICHMOND TERRACE,06,E2,MBDB LLC,1,2,-1
18332,4116910055,QN,116-21 135 STREET,01,A1,"AMRIT, KRISHNA",2,3,-1
18333,4019290080,QN, ALSTYNE AVENUE,10,G0,"URENA, KEVIN",0,1,-1
18334,4117490080,QN,128 STREET,11,V0,"FREEBURG, FREDERICKP",0,1,-1
18335,4114570028,QN,155-42 SAPPHIRE STREET,01,B2,"FRAIEGARI, SILVIA",1,2,-1
18336,5003020015,SI,27 HOWE STREET,01,B2,"ZHENG, ZHUO JIN",0,1,-1
18337,5003660030,SI,56 CONSTANT AVENUE,01,A1,LOUIS HERNANDEZ,1,2,-1
18338,4119310123,QN,109 AVENUE,11,V0,"RAMCHARAN, VEDESH T",0,1,-1
18339,4039360005,QN,5-07 119 STREET,01,B1,"TIAN, DAN DAN",1,2,-1
18340,4142531503,QN,164 AVENUE,11,V0,ROBERT STEWART,0,1,-1
18341,4116030038,QN,122-07 111 AVENUE,01,B1,"LATCHMAN, SATYA",1,2,-1
18342,4040950046,QN,129 STREET,11,V1,MARINELLI CONSTRUCTION/C,0,1,-1
18343,5004960275,SI, THOMPSON STREET,07,U7,MTA - STATEN ISLAND RAILWAY,0,1,-1
18344,5005140036,SI,75 BREWSTER STREET,01,B2,"LIU, BI JIANG",0,1,-1
18345,5005630099,SI,222 GORDON STREET,01,B2,GARY CLYBURN,1,2,-1
18346,2033290070,BX,3607 BAINBRIDGE AVENUE,10,G7,"3607 BAINBRIDGE, LLC.",0,1,-1
18347,4026220008,QN,59-17 57 STREET,10,G1,ASSOCIATED SEVEN INC,1,2,-1
18348,3022317502,BK,63 LYNCH STREET,02,R1,UNAVAILABLE OWNER,1,2,-1
18349,3071840073,BK,70G LANCASTER AVENUE,10,G0,"CHALOUH, CHAMAA",0,1,-1
18350,3044730023,BK, AMBER STREET,11,V0,PENNELLA GIOVANNA,0,1,-1
18351,3045270082,BK,333 EUCLID AVENUE,07,G9,HJC HOLDING CORP,0,1,-1
18352,3045280012,BK, CRESCENT STREET,11,V0,"RIVAS, GUADALUPE",0,1,-1
18353,3026530037,BK,185 NASSAU AVENUE,04,S4,"BUSY BEE PROJECT, LL",1,2,-1
18354,4122120030,QN,150-44 120 AVENUE,01,A5,"CLARKE, MADGE",1,2,-1
18355,5010420150,SI,155 CORTLANDT STREET,01,A1,ROSEANN CURATTALO,1,2,-1
18356,3046420017,BK,50 EAST 56 STREET,01,B2,"BERTRANT, IMMACULA",1,2,-1
18357,5010430059,SI,53 DECKER AVENUE,01,B2,"GUO, QIUFENG",2,3,-1
18358,4142280212,QN, BAYVIEW AVENUE,01,Z0,FURSTMAN REVOCABLE TRUST DTD 5/23/2019,0,1,-1
18359,4043780009,QN,31 ROAD,11,V1,"BOOTS HOLDING ASSOCIATES,LLC",0,1,-1
18360,1007790008,MN,253 WEST 29 STREET,10,G6,8TH AVE LUMBER YARD CORP,0,1,-1
18361,4011300052,QN,30-41 81 STREET,02,C0,30-41 81ST STREET LLC,0,1,-1
18362,4141480029,QN,94 STREET,07,U2,CON ED CO OF N Y,0,1,-1
18363,1010420054,MN,WEST 52 STREET,10,G6,SCHWARTZ NILES,0,1,-1
18364,4123850131,QN,168-27 BAISLEY BOULEVARD,06,E7,EVA KUKIELKA,1,2,-1
18365,3069020019,BK,73 BAY 47 STREET,03,D1,73 BAY 47TH STREET LLC,1,2,-1
18366,3031600146,BK, JEFFERSON STREET,11,V1,15 JEFFERSON LLC,0,1,-1
18367,5014780492,SI,97 HOUSTON STREET,01,A9,"PALMIERI, LISA",2,3,-1
18368,5014810217,SI,248 WILLOWBROOK ROAD,01,A2,"SHAREEF, FATIMA",1,2,-1
18369,5040850019,SI,145 MARINE WAY,01,A2,"OAKWOOD ESTATES, LLC",1,2,-1
18370,4139710094,QN,158 AVENUE,11,V0,MARIO CONTE,0,1,-1
18371,5019710041,SI, BRIELLE AVENUE,11,V0,"MATHAI, VARUGHESE",0,1,-1
18372,4121100024,QN,147 STREET,11,V0,DOROTHY SINCLAIR,0,1,-1
18373,5024520196,SI,231 WELLINGTON COURT,01,B9,URSZULA CZAJKA,1,2,-1
18374,4121120043,QN,150 STREET,11,V0,"MANIRAM, KUBEER N",0,1,-1
18375,4038690097,QN,82-75 88 PLACE,01,B1,ELEANOR JETTER,1,2,-1
18376,3051520020,BK,2101 EAST 21 STREET,04,C7,"2101 CORTELYOU, LTD",1,2,-1
18377,4139130258,QN, BAYVIEW AVENUE,,Z9,15527 BAYVIEW REALTY LLC,0,1,-1
18378,5028200030,SI,861 BAY STREET,07,U6,MTA - STATEN ISLAND RAILWAY,0,1,-1
18379,4161030110,QN,BEACH 84 STREET,11,V9,NYC DEPARTMENT OF CITYWIDE ADMINISTRATIVE SERVICES,0,1,-1
18380,5028460275,SI, ST MARYS AVENUE,11,V0,"DO LOS REYES, REMEDI",0,1,-1
18381,4005980001,QN,30-01 NEWTOWN AVENUE,02,C1,30-01 NEWTOWN AVE. REALTY LLC,1,2,-1
18382,5042310005,SI,126 BEACH AVENUE,01,A1,"MOHAMED, AZZA",2,3,-1
18383,4006150102,QN,30 31 STREET,11,V1,3085 31ST PROPERTY LLC,0,1,-1
18384,4034510013,QN,55-17 MYRTLE AVENUE,04,S9,55-13 MYRTLE AVENUE HOLDING LLC,1,2,-1
18385,4038550126,QN,88-35 75 AVENUE,01,A1,MICHAEL MARTINEZ,1,2,-1
18386,3054320065,BK,1645 45 STREET,08,M9,CONG NACHLAS BORUCH O,1,2,-1
18387,3035700001,BK,167 LIVONIA AVENUE,09,Q2,NYC DEPARTMENT OF PARKS AND RECREATION,2,3,-1
18388,4125260018,QN,127 AVENUE,11,V0,P HEILIG,0,1,-1
18389,3078220029,BK,1327 EAST 40 STREET,01,A9,"LOGAN, MARCIA",2,3,-1
18390,5033420100,SI,153 SEAVIEW AVENUE,07,U9,MTA - STATEN ISLAND RAILWAY,0,1,-1
18391,4125840013,QN, GUY R BREWER BLVD,07,U4,VERIZON NEW YORK INC,0,1,-1
18392,4092240014,QN,86-16 111 STREET,01,A1,"PAUL, CARMEN",1,2,-1
18393,2032310265,BX, WEST FORDHAM ROAD,11,V0,DS FORDHAM LANDING 1 LLC,0,1,-1
18394,4139130251,QN, BAYVIEW AVENUE,,Z9,"SPADARO, CONCETTA",0,1,-1
18395,4126830018,QN,120-32 198 STREET,01,B1,"THOMAS, MATTHEW",1,2,-1
18396,3038750002,BK,737 HINSDALE STREET,01,B1,UNAVAILABLE OWNER,0,1,-1
18397,4142421342,QN,163 DRIVE,11,V0,JOHN CAMPI,0,1,-1
18398,3073200005,BK, AVENUE U,07,U8,NYC TRANSIT AUTHORITY,1,2,-1
18399,3057220057,BK, FT HAMILTON PARKWAY,07,U7,NYC TRANSIT AUTHORITY,0,1,-1
18400,3057810036,BK,6006 4 AVENUE,02,C2,6002 4AV LLC,1,2,-1
18401,4155470059,QN, VIRGINIA STREET,01,A7,WOLFSON  AARON,0,1,-1
18402,4155530011,QN, MOBILE ROAD,10,G0,"TRACHTENBERG, THEODORE",0,1,-1
18403,5043130002,SI,3206 MORLEY AVENUE,01,A5,"MARTINEZ, CARLOS",1,2,-1
18404,5045780001,SI,210 CORBIN AVENUE,09,Q2,GREAT KILLS LITTLE LE,4,5,-1
18405,4160920068,QN,7008 CORAL REEF WAY,01,B2,"MOISEEV, SVETLANA",1,2,-1
18406,4130800004,QN,184-11 144 AVENUE,01,B2,"SABLON, JEAN L",1,2,-1
18407,4157490219,QN,10-27 BAY 32 STREET,01,B2,"CEDER, MICHAEL",1,2,-1
18408,4005890032,QN,31-21 30 STREET,02,C0,SNT F/B/O JOSEPH MARCIANO U/W OF MARIE M ARCIANO,1,2,-1
18409,5052680143,SI,284 WINCHESTER AVENUE,01,A1,JOHN B DONNELLY,1,2,-1
18410,5053060063,SI,224 WIMAN AVENUE,01,A5,LRB PROPERTIES LLC,1,2,-1
18411,4159050110,QN,182 WHITE SANDS WAY,01,B2,"CHENG, GUANGCUI",1,2,-1
18412,5017000074,SI,22 EUNICE PLACE,01,A1,"BONAMO, ANGELA A",1,2,-1
18413,5053220075,SI,44 OCEANIC AVENUE,10,G0,MARILYN K ADAMS,0,1,-1
18414,4160650026,QN, BURCHELL AVENUE,11,V0,"AUTUMN EQUITIES, LLC",0,1,-1
18415,4160920140,QN,7208 WATER WAY,01,B2,"CASTELLANO, VINCENT",1,2,-1
18416,5054970165,SI, ELTINGVILLE BLVD,10,G0,ARTHUR W TAYLOR,0,1,-1
18417,5055070204,SI,38 RIDGEWOOD AVENUE,01,A2,BETTE LEIGH GOLDSTEIN,1,2,-1
18418,2022800038,BX,464 EAST 136 STREET,11,V0,NYC DEPARTMENT OF PARKS AND RECREATION,0,1,-1
18419,5056960059,SI,87 DETROIT AVENUE,01,A1,"BRIENZA, SUSAN",1,2,-1
18420,5057350346,SI,192 PRESENTATION CIRCLE,01,A5,"DORSEY, CHRISTINA",1,2,-1
18421,5062210021,SI,1026 ARDEN AVENUE,01,A2,WILLIAM WEBER,1,2,-1
18422,5062300073,SI, IONIA AVENUE,11,V0,DER OSTEC VON,0,1,-1
18423,5006870003,SI,25 ARBOR COURT,01,A3,JACK A.MAILMAN,1,2,-1
18424,4137410067,QN,241-23 147 DRIVE,01,B3,"HYLTON, GLORIA A.",1,2,-1
18425,4162380072,QN,142 BEACH 129 STREET,01,B2,WILLIAM P. KELLY,1,2,-1
18426,4136890015,QN,259-32 148 DRIVE,01,A2,"CALANDRIELLO, VINCENT FRANCIS",1,2,-1
18427,3060560003,BK,33 BATTERY AVENUE,01,B1,DSS BATTERY LLC,1,2,-1
18428,5069440128,SI,17 FONDA PLACE,01,B2,UNAVAILABLE OWNER,0,1,-1
18429,5070200479,SI,30 DEXTER AVENUE,01,A5,"SALZHAUER , MARK",1,2,-1
18430,5073170025,SI,28 MANDY COURT,01,A5,DOMENICA DIANA STILLM,1,2,-1
18431,5075340170,SI,6365 AMBOY ROAD,07,U2,MTA - STATEN ISLAND RAILWAY,1,2,-1
18432,5075720080,SI, MADSEN AVENUE,11,V0,NJJU DEVELOPMENT LLC,0,1,-1
18433,5075720113,SI,101 MADSEN AVENUE,01,A1,"LAMIA, DONNA FRANCES",1,2,-1
18434,5075720120,SI,115 MADSEN AVENUE,01,B2,CHRISTOPHER FERRARA,1,2,-1
18435,5075780003,SI,169 RICHMOND VALLEY ROAD,01,A1,GERALD WALSH,2,3,-1
18436,4162960039,QN,429 BEACH 145 STREET,01,A2,"RUGGIERO, NICHOLAS",1,2,-1
18437,3062080033,BK,2180 73 STREET,01,B3,"MALANGA, ANNA",2,3,-1
18438,5044670047,SI, CLARKE AVENUE,11,V0,NYS DEPARTMENT OF TRANSPORTATION,1,2,-1
18439,4163050027,QN,333 BEACH 148 STREET,01,A1,"JOANNE BRANDES, AS TRUSTEE",1,2,-1
18440,5000210047,SI,122 HAMILTON AVENUE,01,A1,MARK EADICICCO TRUST,1,2,-1
18441,3044520703,BK,1136 ESSEX STREET,01,A5,"LAYNE, ALFREDO R",1,2,-1
18442,3045700120,BK,1145 GRANT AVENUE,01,B1,"THOM, KEISHA",1,2,-1
18443,5001190049,SI,180 STANLEY AVENUE,01,B1,J SENATORE,1,2,-1
18444,4073320123,QN,214-34 45 ROAD,01,A1,JOSEPH P SZOKOLI,1,2,-1
18445,5001840254,SI, RICHMOND TERRACE,11,V1,T F QUINLAN SON INC,0,1,-1
18446,5001970022,SI,69 BARKER STREET,01,B2,"MILLIEN, PATRICK",1,2,-1
18447,1004460032,MN,75 1 AVENUE,03,D3,75 FIRST AVE CLUB LLC,0,1,-1
18448,4139220200,QN, SHERIDAN AVENUE,09,Q0,NYC DEPARTMENT OF PARKS AND RECREATION,0,1,-1
18449,4142340872,QN,10233 RUSSELL STREET,01,A1,WARREN J SCHIEREN,1,2,-1
18450,4134330051,QN,183 STREET,11,V1,A A & G REALTY CORP.,0,1,-1
18451,4142501480,QN,164 AVENUE,01,Z0,"TOMEO, RACHEL",0,1,-1
18452,4151000200,QN,159 STREET,07,U7,NYC TRANSIT AUTHORITY,0,1,-1
18453,4131600049,QN,134-30 233 STREET,01,A1,ODOM RENA M,1,2,-1
18454,5002470030,SI,146 WALDRON AVENUE,01,A1,UNAVAILABLE OWNER,0,1,-1
18455,3064960007,BK,714 EAST 9 STREET,02,C0,"ZHAO, MIN",1,2,-1
18456,1011417502,MN,2021 BROADWAY,04,RM,THE NEVADA OWNERS INC,1,2,-1
18457,1011840028,MN,5 RIVERSIDE DRIVE,03,D4,5 RIVERSIDE CP,1,2,-1
18458,2028880033,BX,366 EAST 173 STREET,02,C0,BRONX 173 LLC,1,2,-1
18459,4130300101,QN,217-15 137 ROAD,01,B2,CHRISTOPHER PARUCKER,0,1,-1
18460,3072260052,BK, AVENUE Z,07,U7,NYC TRANSIT AUTHORITY,0,1,-1
18461,5003180016,SI,802 CURTIS AVENUE,01,B2,ANTHONY R SANNA,1,2,-1
18462,5003230053,SI,934A CLOVE WAY,01,A5,"YOGAVINAYKAN, DUSHYANTHI",1,2,-1
18463,5003690152,SI,91 CROWELL AVENUE,01,A1,"RODRIGUEZ, MARY D",1,2,-1
18464,5003690154,SI,95 CROWELL AVENUE,01,B2,ROBERT SPISTO,1,2,-1
18465,4155030005,QN,BEACH 12 STREET,07,U7,LIRR,0,1,-1
18466,2031490081,BX, RYER AVENUE,11,V0,2104 RYER LLC,0,1,-1
18467,4128750027,QN,128-27 234 STREET,01,A2,"MONDESIR, NYRVA",1,2,-1
18468,2032630130,BX,3805 ORLOFF AVENUE,01,B9,"POLLAN, ELLEN M.",1,2,-1
18469,5003770611,SI,138 KEMBALL AVENUE,01,A0,"HEFFERNAN, PETER",1,2,-1
18470,4155510037,QN,11-42A BEACH 9 STREET,10,G0,JOSEPH LIEBER,0,1,-1
18471,4125460235,QN,176-25 133 AVENUE,01,B1,"A2Z PROPERTIES, LLC",1,2,-1
18472,2033640005,BX,4298 VAN CORTLANDT PARK E,01,A9,"FOLEY, SILEANN",1,2,-1
18473,4155710038,QN,7-71 CORNAGA AVENUE,01,A1,ABRAHAM FINKELSTEIN,1,2,-1
18474,5012240050,SI, BUSH AVENUE,11,V1,2970 RICHMOND TERRACE CORP,0,1,-1
18475,2030950051,BX, CLINTON AVENUE,10,G7,CHIEU KIEN BUDDHISTCENTER,0,1,-1
18476,5005050004,SI,380 BAY STREET,05,G8,REYES REALTY LLC,1,2,-1
18477,5005280050,SI,710 BAY STREET,01,A1,"OFFENBERG, JOSEPH",1,2,-1
18478,5046800042,SI,498 TARRYTOWN AVENUE,01,A5,"PAGAN, TERESA L",1,2,-1
18479,2038450143,BX,2409 HALSEY STREET,02,C1,HALSEY COURT LLC,1,2,-1
18480,4039350010,QN,8 AVENUE,11,V0,"CHEN, ZHIBIN",0,1,-1
18481,2032980046,BX,2955 BAINBRIDGE AVENUE,02,C4,2955-57 BAINBRIDGE AVE REALTY CORP,1,2,-1
18482,5008540037,SI,5 DUTCHESS AVENUE,01,A2,MCCARTNEY FRANCES,1,2,-1
18483,4121120035,QN,130 AVENUE,11,V0,DELORIS M. LEWIS,0,1,-1
18484,5009480055,SI,97 BEACON AVENUE,01,A1,"U.S. BANK TRUST, N.A., AS TRUSTEE FOR",1,2,-1
18485,5028900012,SI,384 BRITTON AVENUE,01,B2,"WANG, MINGWEI",1,2,-1
18486,2034320150,BX, SURF DRIVE,11,V0,SHOREHAVEN HOMEOWNERS ASSOCIATION INC,0,1,-1
18487,2045640037,BX, SEXTON PLACE,10,G0,AHMED ALAMARI,0,1,-1
18488,2046450049,BX, OLINVILLE AVENUE,10,G0,"WASHINGTON, HEFLYN L.",0,1,-1
18489,4162720011,QN,2-75 BEACH 138 STREET,01,A1,HELEN FELDMAN REVOCA,1,2,-1
18490,3052890007,BK,10 AVENUE,07,U8,NYC TRANSIT AUTHORITY,0,1,-1
18491,5012110100,SI, ORINOCO PLACE,11,V0,2860 RICHMOND TERRACE LLC,0,1,-1
18492,2046680027,BX,EAST 220 STREET,11,V0,"RICHARDSON, MONA LAVERNE",0,1,-1
18493,2046730054,BX,814 EAST 215 STREET,02,C0,"SILVERBERG, MARTIN",1,2,-1
18494,2046730058,BX,820 EAST 215 STREET,01,B3,"HENRY, CLAUDE",1,2,-1
18495,2034480001,BX,2009 CORNELL AVENUE,11,V0,NYC DEPARTMENT OF CITYWIDE ADMINISTRATIVE SERVICES,5,6,-1
18496,3065970004,BK,42 AVENUE O,04,S1,GIORGIO CATAUDELLA,1,2,-1
18497,3053310032,BK,819 FRIEL PLACE,01,B3,MOHAMMAD I ASGAR,2,3,-1
18498,5014350086,SI,108 RIEGELMANN STREET,01,A1,FRANK RABSATT,1,2,-1
18499,2049290010,BX,1110 EAST 233 STREET,02,C0,PALMER LASCELLES,1,2,-1
18500,2049660011,BX, PRATT AVENUE,10,G0,ANGEL L RIVERA,0,1,-1
18501,3070160111,BK,2873 WEST 23 STREET,01,A5,PAN SUI XIONG,1,2,-1
18502,5016680055,SI,462 LISK AVENUE,01,Z0,UNAVAILABLE OWNER,0,1,-1
18503,4157620009,QN, BROOKHAVEN AVENUE,10,G7,NEW SURFSIDE REALTY LLC,0,1,-1
18504,5017000020,SI,463A VAN NAME AVENUE,10,G0,SAL PISCICELLI,0,1,-1
18505,2054060089,BX,3139 WATERBURY AVENUE,01,A1,"RIVERA, BRENDA L",1,2,-1
18506,5023700352,SI,25 TRAVIS AVENUE,01,A5,KIM FUNG LAU,1,2,-1
18507,5023900338,SI,351 KLONDIKE AVENUE,01,B9,CLAIRE KENNEDY,1,2,-1
18508,2055450135,BX,738 QUINCY AVENUE,01,B1,"DUSENBERRY, CHRISTOPHER",1,2,-1
18509,4114570075,QN,155-23 77 STREET,01,B2,"BAJWA, SHAHIDA I.",1,2,-1
18510,3050470176,BK,225 WINTHROP STREET,02,C1,UNAVAILABLE OWNER,1,2,-1
18511,5000420061,SI,95 SCRIBNER AVENUE,01,B2,WANG YU INC.,1,2,-1
18512,3083420100,BK, RALPH AVENUE,09,Q9,UNAVAILABLE OWNER,0,1,-1
18513,5026610038,SI,4320 VICTORY BLVD,10,G7,VALENCIA DEVELOPERS ASSOCIATES L P,0,1,-1
18514,3071280044,BK,2157 EAST 1 STREET,11,V0,CONEY ISLAND PENTECOSTAL CHURCH,1,2,-1
18515,2056520195,BX, PARK DRIVE,10,G0,RICHARD C. GARVEY,0,1,-1
18516,2057650710,BX,5805 BROADWAY,05,K5,LEEMILTS PETROLEUM INC,0,1,-1
18517,4027130011,QN, GRAND AVENUE,10,G7,"RUSSO, VITTORIO",0,1,-1
18518,5028320055,SI,15 COURTNEY LOOP,01,A5,MILLY SIU HUNG FONG,1,2,-1
18519,5028320066,SI,68 COURTNEY LOOP,01,A5,"BISLIMI, BAHRI",1,2,-1
18520,4112340156,QN,217-15 114 ROAD,04,S1,LOUIS SEVERE,1,2,-1
18521,4042220005,QN,119 STREET,11,V1,NYC DEPARTMENT OF CITYWIDE ADMINISTRATIVE SERVICES,0,1,-1
18522,5028390091,SI,48A NORWOOD AVENUE,10,G0,SUSANA ALOVERA,0,1,-1
18523,5028470145,SI,121 VIRGINIA AVENUE,01,B1,"CAMERA, CHRISTOPHER J",1,2,-1
18524,5000850049,SI,113 BRIGHTON AVENUE,01,A1,JOSEPH RICCA,1,2,-1
18525,5028990143,SI,107 MOSEL AVENUE,01,A5,STANLEY CHENG,1,2,-1
18526,5029300032,SI,144 MOSEL AVENUE,01,A5,FRANCISCA GOMEZ,1,2,-1
18527,2031280123,BX,948 EAST 181 STREET,02,C0,"ODIASE, CHARLES",1,2,-1
18528,5016687501,SI,66A WOLKOFF LANE,02,R3,CITY WEST 1,86,87,-1
18529,3054940060,BK,1880 55 STREET,01,B3,ABRAHAM & FARIDA TRUST,1,2,-1
18530,5031020014,SI,37 HASTINGS STREET,01,B1,"CHRISTIE, ANN",1,2,-1
18531,4043150062,QN,119 STREET,11,V9,NYC DEPARTMENT OF CITYWIDE ADMINISTRATIVE SERVICES,0,1,-1
18532,3015140011,BK,340 CHAUNCEY ST,02,C2,KINGSLAND CHAUNCEY LLC,1,2,-1
18533,3015170021,BK,1776 BROADWAY,02,C1,BROADWAY PEARL LLC,0,1,-1
18534,5052870050,SI,23 PACIFIC AVENUE,01,A1,"SHOCK, HOWARD",1,2,-1
18535,3072470001,BK, CONEY ISLAND AVENUE,11,V1,NYC DEPARTMENT OF SMALL BUSINESS SERVICES,0,1,-1
18536,3046580020,BK,222 EAST 53 STREET,02,C3,"JOSEPH, NATHANIA",1,2,-1
18537,3069970200,BK,2973 STILLWELL AVENUE,11,V6,NYC DEPARTMENT OF SMALL BUSINESS SERVICES,0,1,-1
18538,5032900084,SI,17 BURGHER AVENUE,01,A1,"BROKER, ROBERT W",1,2,-1
18539,5002250044,SI,204 ELIZABETH STREET,01,B2,"SERRA, CHRISTOPHER",1,2,-1
18540,5033680018,SI,1562 HYLAN BOULEVARD,05,K1,TRANCHINA PROPERTIES LLC,0,1,-1
18541,3055840038,BK,3910 FT HAMILTON PARKWAY,04,S2,"BALBUENA, ALBERTO",1,2,-1
18542,5002920071,SI,142 HARVEST AVENUE,01,A1,PORTELLO RICHARD O,1,2,-1
18543,3018990058,BK,110 SKILLMAN STREET,02,C1,"BH SKILL, LLC",0,1,-1
18544,3019140135,BK,904 BEDFORD AVENUE,03,D3,97 PROSPECT LLC,1,2,-1
18545,5034720013,SI, SEAVIEW AVENUE,11,V0,"SHERRY, AUDREY JILL",0,1,-1
18546,3019840004,BK,65 IRVING PLACE,03,D3,63 IRVING PLACE DEVELOPMENT LLC,0,1,-1
18547,5034910104,SI,415 FATHER CAPODANNO BL,01,B9,NIKOLAY ZAPISETSKY,1,2,-1
18548,5002950037,SI,721 OAKLAND AVENUE,01,A1,"TSIHLIS, SARANTOS I",1,2,-1
18549,5036710006,SI, BOUNDARY AVENUE,11,V0,US BANK NATIONAL ASSOCIATION AS TRUSTEE,0,1,-1
18550,4044390033,QN,5 BOULEVARD,01,A1,"VILLEGAS, EMILIO",1,2,-1
18551,4044440036,QN,11-40 WHITESTONE EXPWY,01,A2,"DE LISI, PATRICK J",1,2,-1
18552,2047780005,BX,3147 EDSON AVENUE,01,A2,"DAVIS-IGLE, CLARISSA",1,2,-1
18553,5015080024,SI,351 WILLOW ROAD EAST,01,A2,ALBERT ABBRIANO,1,2,-1
18554,3028010021,BK,543 GARDNER AVENUE,10,G7,"MICHAEL REALTY OF NEW YORK, LLC",0,1,-1
18555,3031960102,BK,141 CENTRAL AVENUE,01,B2,HILARIO GONZALEZ,1,2,-1
18556,3032370023,BK,1601 DEKALB AVENUE,10,G6,TWO GUYS FROM GLENDALE I,0,1,-1
18557,3036650032,BK,2509 ATLANTIC AVENUE,04,S2,2509 ATLANTIC REALTY LLC,1,2,-1
18558,4108160039,QN,188-23 WOODHULL AVENUE,02,C0,"LIU, QIN",0,1,-1
18559,3037150027,BK,156 HINSDALE STREET,06,F5,HILSDALE PROPERTY LLC,2,3,-1
18560,5054150085,SI,91 WAKEFIELD ROAD,01,A1,"GOMEZ, RITCHIE L",1,2,-1
18561,2040400018,BX,1652 WALLACE AVENUE,02,C0,VINCENT A CANTARELLA,1,2,-1
18562,4000490025,QN,45-36 11 STREET,01,B1,"45-36 11TH STREET REALTY, LLC",1,2,-1
18563,5052820031,SI,78 WILLIAM AVENUE,01,A1,KRKUT RUZDI,1,2,-1
18564,4105010022,QN,87-18 SANTIAGO STREET,01,A1,"INNISS, AFFERLEEN",1,2,-1
18565,5052990111,SI,75 PERONA LANE,01,A5,"RUBINSHTEYN, ALINA",1,2,-1
18566,5011867501,SI,23 VAN NAME AVENUE,02,R3,UNAVAILABLE OWNER,1,2,-1
18567,5005560138,SI,20 HILL STREET,01,A5,"ZYMARIS, NICHOLAS",1,2,-1
18568,3045700134,BK,1108 ELDERT LANE,01,B1,"JOSEPH, PHILLIP L",1,2,-1
18569,5057350377,SI,50 PRESENTATION CIRCLE,01,A5,"EL-SHERIF, KHALID",1,2,-1
18570,2040480032,BX,1862 AMETHYST STREET,01,B2,"BALRAM, ANAND",1,2,-1
18571,5061460118,SI,783 ROSSVILLE AVENUE,01,B9,OFIR A KEREN,1,2,-1
18572,5007240068,SI,53 BRADLEY AVENUE,01,A2,"D. JUPITER REALTY, LLC",1,2,-1
18573,5006210030,SI,85 PLEASANT VALLEY AVE,01,A2,PHILIP OLT,1,2,-1
18574,4018880022,QN,50-21 96 STREET,02,C0,"LALLOO, KAIMRAJ",1,2,-1
18575,5069750142,SI,6135 AMBOY ROAD,01,A1,RC CHURCH ST JOSEPH,1,2,-1
18576,2053770010,BX,2870 DUDLEY AVENUE,02,C0,"DEANE, JAMES A.",2,3,-1
18577,4038110016,QN,77-30 74 STREET,02,C3,77-30 74TH STREET LLC,1,2,-1
18578,4072400035,QN,179-12 KILDARE ROAD,01,A3,"MATATOV, ROBERT",1,2,-1
18579,3081600048,BK, FARRAGUT ROAD,11,V0,DERYCK B GILL,0,1,-1
18580,5078510042,SI,163 NANCY LANE,01,B2,MICHAEL PALMER,1,2,-1
18581,3044520216,BK,419 SCHROEDERS AVENUE,01,A5,NEHEMIAH SPRING CREEK AFFORDABLE HOMEOWN ERSHIP,1,2,-1
18582,2040890006,BX,1576 YATES AVENUE,10,G0,ORABONA JENNIE,1,2,-1
18583,3083690343,BK,1345 EAST 70 STREET,01,B2,"NGUYEN, HAU V. P.",1,2,-1
18584,3083690386,BK,1336 EAST 70 STREET,01,B2,"POGGIOLI-RIAD, LISA",1,2,-1
18585,3054280012,BK,200 PARKVILLE AVENUE,11,V0,THE PARKVILLE LOFT LLC,0,1,-1
18586,1000020003,MN, MARGINAL STREET,07,Y7,NYC DEPARTMENT OF SMALL BUSINESS SERVICES,0,1,-1
18587,2042260073,BX, WATERS PLACE,11,V1,HUTCH REALTY PARTNERS LLC,0,1,-1
18588,3044520260,BK,728 WALKER STREET,01,A5,"STOUTE, ROYTON A",1,2,-1
18589,3043170051,BK,745 WILLIAMS AVENUE,,Z9,ARGENTINA BROTHERS REALTY CORP,0,1,-1
18590,4127110015,QN, MERRICK BOULEVARD,10,G7,224-11 LINDEN CORP,0,1,-1
18591,1006650072,MN, MARGINAL STREET,07,T2,NYS DEPARTMENT OF TRANSPORTATION,1,2,-1
18592,5011940075,SI,210 SIMONSON AVENUE,01,A1,"LYNN, RANDY",1,2,-1
18593,1007220039,MN,233 9 AVENUE,04,S5,233 NINTH CORP,1,2,-1
18594,1007540044,MN,415 8 AVENUE,10,G6,KEDEM REALTY 415 LLC,0,1,-1
18595,3032450001,BK,1335 MYRTLE AVENUE,04,S2,1335 MYRTLE AVE REALTY CORP.,1,2,-1
18596,3030560032,BK, MESEROLE STREET,07,U8,LIRR,3,4,-1
18597,5010390230,SI,29 HAUGHWOUT AVENUE,01,B2,JOHN M KOSINSKI,1,2,-1
18598,3022260027,BK,208 RUTLEDGE STREET,02,C0,SIMON PASKES,1,2,-1
18599,1022430255,MN, BROADWAY,10,G6,U.S. DEPARTMENT OF TREASURY,0,1,-1
18600,3089320748,BK,33 EBONY COURT,01,A1,"DAMATO, GEORGE",2,3,-1
18601,4006260011,QN,30-85 34 STREET,02,C1,"PASHALIDIS, DESPINA",1,2,-1
18602,5010820026,SI,191 SHARPE AVENUE,01,B2,MILLER AUDREY,1,2,-1
18603,1011710013,MN,WEST 72 STREET,11,V1,NYC DEPARTMENT OF PARKS AND RECREATION,0,1,-1
18604,1011830050,MN,340 WEST 72 STREET,03,D4,CHATSWORTH REALTY CORPORATION,1,2,-1
18605,4101060030,QN, GUY R BREWER BLVD,07,U7,LIRR,0,1,-1
18606,3062410060,BK,2139 77 STREET,01,B2,"CHAN YAU, WILLIAM",1,2,-1
18607,4156850040,QN,15-30 DUNBAR STREET,01,A1,"BRISSETT, MAUREEN MARCIA",1,2,-1
18608,3062970014,BK,1920 81 STREET,01,B2,BOUMOUSSA ANTHONY,1,2,-1
18609,1013737501,MN,455 MAIN STREET,04,RM,UNAVAILABLE OWNER,1,2,-1
18610,3020340134,BK,112 ST EDWARDS STREET,03,D3,UNAVAILABLE OWNER,0,1,-1
18611,3017030068,BK,797 HERKIMER STREET,01,B1,"NODJOUMI, SARA",0,1,-1
18612,3015440042,BK, TRUXTON STREET,10,G1,ALCIBIADES M MC FARLANE,0,1,-1
18613,3065150020,BK,1050 EAST 3 STREET,01,A3,1050-52 EAST 3RD ST LLC,0,1,-1
18614,5005770010,SI, CRESTON PLACE,10,G0,"ERTURK, ERKAN",0,1,-1
18615,5011160016,SI, JOHN STREET,,Z9,ZHW LLC,0,1,-1
18616,4006130059,QN,31-48 32 STREET,02,C2,ELPIDA MICHAEL LLC,1,2,-1
18617,5011550176,SI, PULASKI AVENUE,11,V1,"BRIDGEVIEW PARK, LLC. BY JOHN THOMPSON",0,1,-1
18618,4007330080,QN,48 STREET,,Z9,ACE AIR COND CP,0,1,-1
18619,4023050044,QN,51-38 48 STREET,02,C0,"XU, XUN",1,2,-1
18620,4007840005,QN,21-73 43 STREET,01,B3,"BALICH, MICHAEL A",1,2,-1
18621,2029070009,BX,4050 PARK AVENUE,10,G7,B-15 S-5 TOM 20 INC.    JOHN THOMAS,0,1,-1
18622,4051750024,QN, BOOTH MEMORIAL AVE,10,G0,CHENG PETER K M,0,1,-1
18623,2046710051,BX,801 TILDEN STREET,03,D4,TILDEN TOWERS  II,2,3,-1
18624,5011940124,SI,300 SIMONSON AVENUE,01,A1,LISA SIMONELLI,1,2,-1
18625,5012000010,SI,1989 FOREST AVENUE,05,GW,TOUCHLESS CAR WASH INC,0,1,-1
18626,5012080008,SI,3075 RICHMOND TERRACE,06,E9,RICHMOND INDUSTRIAL CENTER INC,1,2,-1
18627,2047110030,BX, OAKLEY STREET,10,G0,"PYATT, PATRICIA",0,1,-1
18628,3067080005,BK, AVENUE I,07,U7,NYC TRANSIT AUTHORITY,0,1,-1
18629,5031040033,SI,72 MAJOR AVENUE,01,B1,"DIBARTOLO , MICHAEL",1,2,-1
18630,2032470010,BX,1 WEST KINGSBRIDGE RD,08,Y4,NY STATE MILITIA,0,1,-1
18631,4052990047,QN,35-32 172 STREET,02,C0,JOSEPH BONVENTRE,1,2,-1
18632,2048530069,BX,836 EAST 229 STREET,01,A1,"BAILEY, PATRICIA",1,2,-1
18633,3067340024,BK,1409 LOCUST AVENUE,07,G2,SECURELY YOURS INC.,1,2,-1
18634,4037760043,QN,78-33 67 ROAD,01,B3,JAMES GRAFF,1,2,-1
18635,4013830049,QN,30-45 85 STREET,02,C0,"CHOWDHURY, FERDOUS",1,2,-1
18636,5004870080,SI, MINTHORNE STREET,10,G7,ANGIULI BUICK,0,1,-1
18637,3069750003,BK,4107 MANHATTAN AVENUE,01,B2,"KOVACH, TAMIR",1,2,-1
18638,5019910030,SI,49 CONRAD AVENUE,01,A5,"MICHEL, MICHEL",1,2,-1
18639,3070240095,BK,4126 MANHATTAN AVENUE,02,C0,"GAWRYS, JOANNA",1,2,-1
18640,5021110034,SI,70 MULBERRY CIRCLE,01,A5,SOLIMAN MOHAMED,1,2,-1
18641,2049900063,BX,2215 NUVERN AVENUE,11,V0,"KWANKAM, MAUREEN",0,1,-1
18642,4024840081,QN,52-80 73 STREET,01,A5,"NGAN, TERRY YIUCHEUNG",1,2,-1
18643,5003900096,SI,53 ELDRIDGE AVENUE,01,A1,GILDARDO MEJIA,1,2,-1
18644,4007460092,QN,24-48 49 STREET,05,O5,UNAVAILABLE OWNER,0,1,-1
18645,4019860043,QN,104-71 43 AVENUE,01,A9,LEO MACBRYDE,1,2,-1
18646,2050380037,BX, MATILDA AVENUE,10,G0,CHISOLM MARSHALL,0,1,-1
18647,5028350013,SI, HARBORVIEW PLACE,11,V0,BRIAN K. PAYNE,0,1,-1
18648,2040940017,BX, FOWLER AVENUE,11,V0,PALOMBELLA CARMINE,0,1,-1
18649,4058070054,QN,23-55 207 STREET,01,A0,"STELLMANN, CRISTINA",1,2,-1
18650,3074050748,BK,2365 EAST 27 STREET,01,B1,"HU , KAIJIE",1,2,-1
18651,4094650032,QN,97-29 124 STREET,02,C0,KULWANT & KULWANT,2,3,-1
18652,5028770140,SI,13 NUNLEY COURT,01,A1,THOMAS W NELSON,2,3,-1
18653,2044450050,BX,2555 RADCLIFF AVENUE,02,C0,2555 RADCLIFF LLC,2,3,-1
18654,4037130025,QN,80 AVENUE,10,G0,"QUINTANA, JR., ERNESTO",0,1,-1
18655,4024840079,QN,52-76 73 STREET,01,A5,"DAI, JUN WEN",1,2,-1
18656,5028990148,SI,95 MOSEL AVENUE,01,A5,MARY E DE ROSA,1,2,-1
18657,5028990157,SI,85 MOSEL AVENUE,01,A5,UNAVAILABLE OWNER,1,2,-1
18658,4025750054,QN,49 STREET,07,U7,LIRR,0,1,-1
18659,4035690024,QN,58-42 ST FELIX AVENUE,10,G0,GEORGE W. KONZ,0,1,-1
18660,5029960011,SI,19 ROCKWELL AVENUE,01,B2,"WU, JIAN HE",1,2,-1
18661,4026310009,QN,59-13 56 STREET,02,C0,JOSEPH A BIANCO,1,2,-1
18662,2054110210,BX,1530 MACDONOUGH PLACE,01,B2,HIGHFUSION LLC,1,2,-1
18663,4034100190,QN,18-13 FLUSHING AVENUE,06,E1,"EMJAY ASSOCIATES,LLC",1,2,-1
18664,4007680006,QN,23 AVENUE,11,V0,"GONZALEZ-ROIS, FERNANDO",0,1,-1
18665,5011170063,SI,140 NICHOLAS AVENUE,01,A5,"CHALCO, WILSO",1,2,-1
18666,2050210070,BX,4151 WILDER AVENUE,10,G0,"SAHIF, BIBI REHANNA",0,1,-1
18667,2056440342,BX, FORDHAM PLACE,11,V1,BARRON JOHN,0,1,-1
18668,2056510047,BX, SHORE DRIVE,11,V0,ELM ASSOCIATES,0,1,-1
18669,2049910042,BX, BELL AVENUE,11,V0,"RUMALDO, ANUBIS",0,1,-1
18670,4032650038,QN,203 ASCAN AVENUE,01,A5,JACQUELINE A. JONES LIVING TRUST,1,2,-1
18671,4032950071,QN, UNION TURNPIKE,10,G0,"TENG , ANN",0,1,-1
18672,4033390057,QN,75 ROAD,10,G0,"ELIZABETH SYLVAN, LAUREN",0,1,-1
18673,2053280017,BX,1119 STADIUM AVENUE,02,C0,"MURPHY, SILVIA",1,2,-1
18674,5057350383,SI, PRESENTATION CIRCLE,11,V0,UNAVAILABLE OWNER,0,1,-1
18675,4033390101,QN,75 ROAD,10,G0,"ORCHARD FIELDS, LLC",0,1,-1
18676,4141720201,QN,102 STREET,11,V0,"NOLAN, JOHN J",0,1,-1
18677,5057350403,SI,94 PRESENTATION CIRCLE,01,A5,"CAMINITI JR, ANTHONY",1,2,-1
18678,4000280044,QN,5-50 46 ROAD,01,B9,ALEXANDER FINN,1,2,-1
18679,4001510030,QN,47-08 GREENPOINT AVENUE,04,K4,"BAZON, MOSHE",1,2,-1
18680,4003100122,QN,37 STREET,10,G7,37TH STREET LIC INC.,0,1,-1
18681,4068250050,QN,158-25 76 ROAD,02,C9,158-06/10 REALTY LLC,3,4,-1
18682,2057750208,BX,316A WEST 240 STREET,07,G9,"ANNAGHLI, LLC",0,1,-1
18683,4036180057,QN,64-57 MADISON STREET,01,B3,ROSANNA CONNORS AS CO-GUARDIAN OF,1,2,-1
18684,5036160058,SI,278 PRESCOTT AVENUE,01,B2,"NIKA, ISMET",1,2,-1
18685,4099490060,QN, GRAND CENTRL PARKWAY,07,U4,NYC DEPARTMENT OF ENVIRONMENTAL PROTECTION,0,1,-1
18686,4031400061,QN,85-21 66 ROAD,01,A5,"WONG, KAI KWONG",1,2,-1
18687,2056260176,BX,7 REYNOLDS STREET,01,A2,"NATIW, WALTER",1,2,-1
18688,4037750027,QN,75-38 67 DRIVE,10,G0,J CESAREO,0,1,-1
18689,2056530316,BX, FLINT AVENUE,11,V0,MCGUIRE HARRY,0,1,-1
18690,2057760611,BX,4578 MANHATTAN COLLEGE PY,11,V0,4578 MCPW CONDO DEVELOPMENT LLC,0,1,-1
18691,4038120110,QN, COOPER AVENUE,11,V0,NYS DEPARTMENT OF TRANSPORTATION,0,1,-1
18692,5036250033,SI,21 STEELE AVENUE,01,B2,MIKHAIL ABOV,1,2,-1
18693,4008830037,QN,21-32 HOYT AVENUE SOUTH,02,C0,"CHAND, SANORY",1,2,-1
18694,4009440067,QN,75-03 21 AVENUE,01,B3,ELENIS JOHN,1,2,-1
18695,4012620030,QN,34-46 76 STREET,01,A5,"COHEN, DAVID",1,2,-1
18696,5036490044,SI,184 JACQUES AVENUE,01,B2,"WU, QING YONG",2,3,-1
18697,2056440351,BX,351 FORDHAM PLACE,01,A2,"FORDHAM PLACE DEVELOPMENT, INC.",2,3,-1
18698,4032950056,QN, UNION TURNPIKE,10,G0,METRO QUEENS VENTURES INC.,0,1,-1
18699,4033330021,QN,84-31 BEVERLY ROAD,01,B3,167 WEST 231 STREET REALTY LLC,1,2,-1
18700,5037930053,SI, BADEN PLACE,11,V0,VITO GENTILE,0,1,-1
18701,5037970004,SI,33 MAPLETON AVENUE,01,A5,"NEYMAN, OLENA",1,2,-1
18702,5038210015,SI,316 MORELAND STREET,01,A6,MEZZANO FAMILY IRREVOCABLE TRUST DTD 06/ 26/2019,1,2,-1
18703,4099060019,QN,90-24 185 STREET,01,B2,UBALDINO HERNANDEZ,1,2,-1
18704,5038860045,SI,373 FREEBORN STREET,01,A5,"ZHANG, WEI",0,1,-1
18705,3070260042,BK,4220 BEACH 42 STREET,01,B2,WADDELL ELENA,0,1,-1
18706,4035550012,QN,1614 SUMMERFIELD STREET,06,F9,1614 SUMMERFIELD STREET LLC,1,2,-1
18707,5043110010,SI,14 EBONY STREET,01,B2,"DAMATO, LUCY",1,2,-1
18708,5065480114,SI, KINGDOM AVENUE,10,G0,"MANDATO, JOHN",0,1,-1
18709,5053030120,SI, TENNYSON DRIVE,11,V1,PORT REGALLE CONDOMINIUMS I,0,1,-1
18710,3013740007,BK,207 ROCHESTER AVENUE,02,C1,203 ROCHESTER LLC,2,3,-1
18711,3016820032,BK, DECATUR STREET,11,V0,UNAVAILABLE OWNER,0,1,-1
18712,4048620047,QN,157-61 24 AVENUE,01,A0,BINANTI ANGELO & GAETANA,1,2,-1
18713,5056320004,SI, ANNADALE ROAD,11,V1,NYC DEPARTMENT OF PARKS AND RECREATION,0,1,-1
18714,5057350317,SI,149 PRESENTATION CIRCLE,01,A5,HOKSANG LAU,1,2,-1
18715,4023060228,QN,51-53 48 STREET,01,B1,BORGES MARTHA,1,2,-1
18716,4051190013,QN,56-39 135 STREET,01,B2,"WANG, XING MING",1,2,-1
18717,3017500044,BK,391 WILLOUGHBY AVENUE,05,O5,389 WILLOUGHBY LLC,0,1,-1
18718,2053570111,BX, LA SALLE AVENUE,11,V0,"SCHOEPS, DARCIE",0,1,-1
18719,3017950015,BK,22 VAN BUREN STREET,01,B1,"GONZALEZ, J. ANTHONY",0,1,-1
18720,5069790190,SI,27 MALIBU COURT,01,B9,LAM & JIANG LLC,1,2,-1
18721,4033040061,QN,206 GREENWAY NORTH,01,A3,HELEN L BLOCH,1,2,-1
18722,4036090019,QN,63-08 TRAFFIC AVENUE,10,G1,TRAFFIC THREE LLC,1,2,-1
18723,4054190130,QN,43-23 161 STREET,10,G0,MULLAN WILLIAM J AKA,0,1,-1
18724,1018110142,MN,2570 1 AVENUE,07,T2,MTA B&T,0,1,-1
18725,2055350017,BX, SWINTON AVENUE,10,G0,DESTEFANO ANITA,0,1,-1
18726,4032990017,QN,75 ROAD,10,G0,"BEYDOUN, FOUAD",0,1,-1
18727,4033300045,QN,83-51 ABINGDON ROAD,01,A3,HO YVEN CHING,1,2,-1
18728,5064990051,SI, JANSEN STREET,11,V1,NYC DEPARTMENT OF PARKS AND RECREATION,0,1,-1
18729,4036150006,QN, TRAFFIC AVENUE,10,G0,"JENKELEIT, RALPH",0,1,-1
18730,5065820020,SI, ANDROVETTE AVENUE,11,V0,"ZILINSKI, CHRISTOPHER",0,1,-1
18731,4034980056,QN,66-16 60 PLACE,02,C0,"ZARANKOV, PLAMEN",1,2,-1
18732,5069060035,SI,148 FOSTER ROAD,01,A2,DOREEN M SOMMA,1,2,-1
18733,4036360015,QN, SHALER AVENUE,10,G0,VEGA ANTONIO,0,1,-1
18734,5069980043,SI,17 IGROS COURT,01,A5,UNAVAILABLE OWNER,1,2,-1
18735,4037080041,QN,70 STREET,10,G0,SIRAGUSA MARIA,0,1,-1
18736,5069680036,SI,1087 RENSSELAER AVENUE,01,A5,"DELLAVALLE, MICHAEL",1,2,-1
18737,4038180016,QN,79-44 77 ROAD,01,A5,"YODICE, CHERYL A",1,2,-1
18738,3026920036,BK,773 MEEKER AVENUE,01,A9,"CARTER, JEFFREY",1,2,-1
18739,3027250028,BK,169 RICHARDSON STREET,04,O8,"VENTURA, CYNTHIA L",1,2,-1
18740,4063570120,QN,134 STREET,10,G0,ANTONIO ARCIENEGA,0,1,-1
18741,3020020090,BK, FORT GREENE PLACE,,Z7,ATLANTIC CENTER FORT GREENE AS L P,0,1,-1
18742,5070940060,SI,48 BERKSHIRE LANE,01,A5,"JULIANO, DONATO",1,2,-1
18743,5073140030,SI,47 STORER AVENUE,06,E2,"STORER AVENUE GROUP, LLC",1,2,-1
18744,5074870235,SI,3030 VETERANS ROAD WEST,06,E1,3030 VETERANS ROAD WEST TRUST,2,3,-1
18745,5075500049,SI,6651 AMBOY ROAD,01,A1,LOUIS RUSSELL,1,2,-1
18746,4081160084,QN,42-06 247 STREET,01,A5,PAUL MONTELLA,1,2,-1
18747,5075780234,SI,64 MADSEN AVENUE,08,N2,UNITED CEREBRAL PALSY OF NYS INC,1,2,-1
18748,4046400012,QN,145-12 23 AVENUE,01,B2,"ALBANESE, MAURICE",1,2,-1
18749,4082630080,QN,48-44 GLENWOOD STREET,01,A1,"GIDEON, LIOR",1,2,-1
18750,3033660028,BK,982 MADISON STREET,03,D3,982 MADISON GROUP LLC,0,1,-1
18751,4082670040,QN,255-18 IOWA ROAD,01,A1,"LEE, YEO BAEK",1,2,-1
18752,3020450055,BK,66 CLERMONT AVENUE,01,B1,LM PROPERTY GROUP LLC,0,1,-1
18753,5075960146,SI,15 TOPSIDE LANE,01,A5,THE VASSALLO QUALIFIED PERSONAL RESIDENC E TRUST,1,2,-1
18754,5070940033,SI,115 BERKSHIRE LANE,01,B9,UNAVAILABLE OWNER,1,2,-1
18755,3035750050,BK,682 ROCKAWAY AVENUE,04,S9,682 ROCKAWAY REALTY CORP.,0,1,-1
18756,4051740035,QN,146-35 BOOTH MEMORIAL AVE,01,B1,"KWOK, CHUN FOR",1,2,-1
18757,5077100087,SI, RICHARD AVENUE,11,V0,"ASHLAND BUILDING, LLC",0,1,-1
18758,4090420020,QN, ATLANTIC AVENUE,07,U7,LIRR,0,1,-1
18759,4140810031,QN,165 AVENUE,01,Z0,FRANK RUSSO,0,1,-1
18760,5007440064,SI,85 MARTIN AVENUE,01,B3,"BELKIN, ADAM",1,2,-1
18761,2054160043,BX, RESEARCH AVENUE,10,G0,"GIUFFRIDA, STEPHAN J",0,1,-1
18762,4038290088,QN,78-38 79 LANE,01,A9,"TRAUTMANN, MARIEANNA E",1,2,-1
18763,4053040013,QN,35-31 UTOPIA PARKWAY,01,B3,M LANGONE,1,2,-1
18764,3040420028,BK,494 HENDRIX STREET,01,B1,494 HENDRIX LLC,1,2,-1
18765,1006130061,MN,57 GREENWICH AVENUE,02,C4,1 PERRY STREET LLC,1,2,-1
18766,3028570036,BK,77 KINGSLAND AVENUE,02,C1,77 KINGSLAND AVE LLC,0,1,-1
18767,4091830001,QN,85-01 102 STREET,08,W1,NYC DEPARTMENT OF EDUCATION,2,3,-1
18768,4057680013,QN,166-16 24 ROAD,01,A1,"MARGARET DEVINE ARONSOHN, AS CO-TRUSTEE",1,2,-1
18769,2053950037,BX,1504 PLYMOUTH AVENUE,01,B3,"MERCADO, HAROLD",1,2,-1
18770,5003580038,SI, KINGSLEY AVENUE,10,G0,"POGGI, THOMAS",0,1,-1
18771,4015220076,QN,43-01 76 STREET,01,B1,"LOLIS, PANTELIS",1,2,-1
18772,4016020010,QN,45 AVENUE,07,U7,LIRR,0,1,-1
18773,4038940009,QN,89-10 70 AVENUE,01,A1,DENNIS M MURRAY,1,2,-1
18774,5072670293,SI,29 JADE COURT,01,A5,"BELLANTUONO, CARLO",1,2,-1
18775,4093930009,QN,109-18 ATLANTIC AVENUE,07,G2,"LOIA, BRUNO",0,1,-1
18776,3047860081,BK, GLENWOOD ROAD,07,U6,LIRR,0,1,-1
18777,4140800028,QN,87 STREET,11,V0,ANNE CURCIO,0,1,-1
18778,3081200026,BK,EAST 94 STREET,11,V1,SALNICK REALTY CORP,0,1,-1
18779,1008440035,MN,EAST 17 STREET,10,G6,6 EAST 17TH STREET L,0,1,-1
18780,1010190010,MN,253 WEST 47 STREET,05,K5,253 W. 47TH LLC,0,1,-1
18781,4065011160,QN,136 STREET,11,V0,CEDAR GROVE CEMETRY A,0,1,-1
18782,1011830022,MN,325 WEST 71 STREET,04,D7,71ST STREET LLC,1,2,-1
18783,4067260008,QN,57-08 160 STREET,01,A0,"CAO FAMILY, LLC",1,2,-1
18784,5003470062,SI,220 FAIRVIEW AVENUE,01,B2,"OVERTON, THOMAS",1,2,-1
18785,4044830047,QN,147-09 217 STREET,01,A1,NORMAN LENIS,2,3,-1
18786,4076670048,QN,232-03 67 AVENUE,01,B3,"CHENG, JOHN HEN",2,3,-1
18787,3039420021,BK,3007 FULTON STREET,,Z9,GHAZI KARAMULLAH,0,1,-1
18788,4080270049,QN,21 BEVERLY ROAD,01,A3,"ONG,  KENNETH  R.",1,2,-1
18789,5002940073,SI,804 DAVIS AVENUE,01,A2,MARY ALICE ROWAN,1,2,-1
18790,3083660147,BK,6643 AVENUE N,01,A9,"ZHANG, JANET H",1,2,-1
18791,1021800127,MN, FT WASHINGTON AVENUE,07,U7,NYC TRANSIT AUTHORITY,0,1,-1
18792,4095120001,QN,107-02 103 AVENUE,01,A1,DURPATTY DHUPAN,1,2,-1
18793,4085850021,QN,82-34 LITTLE NECK PARKWAY,01,A2,"SHAH, ASHOK BHAGUBHAI",1,2,-1
18794,2023920071,BX,420 EAST 167 STREET,10,G6,PARK BROOK LLC,0,1,-1
18795,5010890007,SI,170 CHARLES AVENUE,01,B2,"ZAWISNY, JANINA",1,2,-1
18796,4087220210,QN,80-55 266 STREET,01,A1,"KHUBBA, DIANAND",1,2,-1
18797,4090290001,QN,89-02 95 AVENUE,02,C3,"MIAH, AKBOR",2,3,-1
18798,4090350082,QN, WOODHAVEN BOULEVARD,10,G0,"FARAG, FADIA",0,1,-1
18799,4031800006,QN, YELLOWSTONE BLVD,07,U7,CITY OF NEW YORK,1,2,-1
18800,3054790048,BK,5318 18 AVENUE,01,B1,MENDEL LERNER,1,2,-1
18801,4100450009,QN,144-18 106 AVENUE,01,B2,"HALDER, SHUVA",0,1,-1
18802,4018530028,QN,90-42 51 AVENUE,01,A5,M MC NAMARA,1,2,-1
18803,4091790008,QN,85-26 102 STREET,01,B1,LGF HOLDINGS LLC,1,2,-1
18804,2032900018,BX, BAINBRIDGE AVENUE,10,G0,"KHEMRAJ, RICHARD A",0,1,-1
18805,4093270084,QN,87-35 117 STREET,01,A1,HOSEIN  MARIA,1,2,-1
18806,4050520023,QN,147-19 BARCLAY AVENUE,01,B1,"LIN, LI MING",1,2,-1
18807,2033290068,BX,3605 BAINBRIDGE AVENUE,01,B1,"HICIANO, RICARDO A",1,2,-1
18808,2055160098,BX,8 ALDEN PARK,01,A8,EDGEWATER PARK OWNRSETC,3,4,-1
18809,2033370047,BX,3321 ROCHAMBEAU AVENUE,08,I9,MONTEFIORE HOSPITAL AND MEDICAL CENTER,1,2,-1
18810,3059000013,BK,7116 8 AVENUE,01,A5,"CHEN, MEI QIN",1,2,-1
18811,4104440003,QN,90-27 188 STREET,01,A1,"HOSSAIN, MD BELLAL",1,2,-1
18812,3038840297,BK,69 BULWER PLACE,01,A1,"DOLOR, SHAWOOD S",1,2,-1
18813,5074950010,SI,15 PLEASANT PLAINS AVE,01,A1,"PHAM, MINH",1,2,-1
18814,3088850010,BK, HAZEL COURT,11,V0,"LOCCISANO, REGINA",0,1,-1
18815,3062870012,BK,2014 80 STREET,01,B1,"HERSKOWITZ, BINYAMIN",1,2,-1
18816,3083660149,BK,6647 AVENUE N,01,A9,"WILLIAMS-LEWIS, SANDRA",1,2,-1
18817,4005860052,QN,32-30 30 STREET,01,B3,BROWNE ROBERT,1,2,-1
18818,3064410175,BK,BAY 23 STREET,11,V1,JOSEPH CASTELLI,0,1,-1
18819,4095910013,QN,104-24 132 STREET,01,B1,"NAUTH, MONICA",1,2,-1
18820,3064960060,BK,785 EAST 8 STREET,01,A1,"BRODY, JOEL",1,2,-1
18821,4051510043,QN,137-17 MULBERRY AVENUE,11,V0,"YANG, JI HONG",0,1,-1
18822,4089940069,QN,91-09 97 STREET,02,C0,CESAR BUENO,1,2,-1
18823,4090730125,QN,99-05 97 STREET,01,B2,99-01 97 STREET LLC,1,2,-1
18824,4031770024,QN,90-16 POLO PLACE,01,A5,"MUELLER, RENATE",1,2,-1
18825,1002890001,MN,1 BOWERY,08,W1,NYC ED CONSTRUCTIONFUND,2,3,-1
18826,4098950069,QN,90-36 179 PLACE,01,B3,"ABDULLAH, SHAHEEN",1,2,-1
18827,4100180012,QN,138-36 101 AVENUE,10,G7,FERREIRA JOAO,0,1,-1
18828,3045700129,BK,1126 ELDERT LANE,01,B1,"ORTEGA, JUAN",1,2,-1
18829,2039140029,BX, COMMONWEALTH AVENUE,10,G0,"OLIVERAS, JESSICA",0,1,-1
18830,4008290148,QN,32 STREET,10,G0,"SULTANA, AS TRUSTEE, ROSE J",0,1,-1
18831,4019507501,QN,57-50 GRANGER STREET,04,RM,GRANGER 5750 LLC,1,2,-1
18832,4103180007,QN, JAMAICA AVENUE,05,GU,178-28 JAMAICA AVENUE LLC,0,1,-1
18833,1001940036,MN,413 BROADWAY,10,G6,"411-413 BROADWAY, LLC",0,1,-1
18834,4104100020,QN,185-11 ILION AVENUE,01,A1,"JONES, MONICA",1,2,-1
18835,2056260185,BX,24 PELL PLACE,01,B3,"PALMA, NICHOLAS",1,2,-1
18836,4093970008,QN,111-16 ATLANTIC AVENUE,05,K5,UNAVAILABLE OWNER,0,1,-1
18837,2041780021,BX,3525 BRUCKNER BOULEVARD,01,A2,FERNANDO JUSTINIANO,1,2,-1
18838,3046450014,BK,310 EAST 91 STREET,02,C3,BARRETT KENNETH,1,2,-1
18839,4108590021,QN,190-30 103 AVENUE,01,B3,"SANTIAGO, ULYSSES O",1,2,-1
18840,4116630018,QN, ROCKAWAY BOULEVARD,,Z9,JBK AUTO & REALTY IMPROVEMENT CO INC,0,1,-1
18841,4017830005,QN,38-15 111 STREET,02,C2,SEVEN HEAVEN REALTY INC,1,2,-1
18842,3046460013,BK,300 EAST 92 STREET,02,C3,"CAREY 2ND, CLIFFORD G",1,2,-1
18843,2043010005,BX, LYDIG AVENUE,11,V0,PEPPINO CICIA,0,1,-1
18844,4053040023,QN,35-11 UTOPIA PARKWAY,01,A1,ANTHONY CANIANO,1,2,-1
18845,4054410021,QN,45-39 162 STREET,04,S9,E & V CONTROL MANAGEMENT INC,0,1,-1
18846,4013730037,QN,25-60 100 STREET,01,A5,"COOPER, LOUISE",1,2,-1
18847,3067360048,BK,1617 AVENUE M,05,O2,EVERS LIMITED PARTNERSHIP,1,2,-1
18848,4013770037,QN,26-26 98 STREET,08,M3,ST GABRIELS R C CHURC,1,2,-1
18849,5077100280,SI, FLOWER AVENUE,11,V0,MERRITT JOHN H,0,1,-1
18850,3071010187,BK, AVENUE T,11,V0,230 VAN SICKLEN STREET LLC,0,1,-1
18851,4121780141,QN,112-40 DILLON STREET,01,B3,"MCCLARY, DARRELL",1,2,-1
18852,4077540053,QN,220-09 77 AVENUE,01,A2,NAVNITLAL NAVSARIA,1,2,-1
18853,2045270021,BX,2740 BOUCK AVENUE,01,B3,GODERICK MURRAY,1,2,-1
18854,4061750018,QN,35-28 215 STREET,01,B2,JAMES 28 LLC,1,2,-1
18855,4012990037,QN,40-14 68 STREET,11,V1,68 M&C REALTY LLC.,1,2,-1
18856,5002760062,SI,20 LAWRENCE AVENUE,02,C3,"LIN, CHUAN",2,3,-1
18857,4115520080,QN,97-41 ECKFORD AVENUE,01,A1,"MARTINEZ DE JESUS, HERIBERTO",1,2,-1
18858,3050140048,BK,3920 FARRAGUT ROAD,01,A9,"LEVY, TREVOR",1,2,-1
18859,5010860105,SI,82 TREADWELL AVENUE,01,A1,WILFREDO MILAN,1,2,-1
18860,4116580052,QN,114-39 132 STREET,01,B3,"MOHAMED, JANET L",1,2,-1
18861,4116830020,QN,116-30 127 STREET,01,B3,"NATH, NIRMALA",1,2,-1
18862,2059570409,BX,6045 RIVERDALE AVENUE,01,A1,"MCNAMARA, PHILOMENA J M",2,3,-1
18863,4023810021,QN,53-35 65 PLACE,01,B3,"ALAGNA, GIOVANNA F",1,2,-1
18864,5077020290,SI,32 PENTON STREET,01,A5,MICHAEL J SICILIANO,1,2,-1
18865,3001810020,BK,280 ATLANTIC AVENUE,04,S4,"WRB 280 ATLANTIC AVE., LLC.",0,1,-1
18866,4024850002,QN,51-69 72 PLACE,01,B3,GME I REALTY LLC,1,2,-1
18867,4121030017,QN,148 STREET,11,V0,"JAGERNAUTH, INDRANIE",0,1,-1
18868,2049220004,BX, MAROLLA PLACE,11,V0,"MYRIE-OYEWO, JULIA J",0,1,-1
18869,4121370020,QN,153-90 ROCKAWAY BOULEVARD,08,N2,"AIR HOST REALTY, L.L.C",1,2,-1
18870,5075960277,SI,25 TILLER COURT,01,A5,"VG TILLER, LLC",1,2,-1
18871,5077860039,SI,187 BEDELL AVENUE,01,B3,"LA ROCCA, VINCENT",1,2,-1
18872,4094450053,QN,94-17 129 STREET,11,V0,"SINGH LONGIA, MARBNAJAN",0,1,-1
18873,2050710013,BX,4434 FURMAN AVENUE,10,G7,"AZWIM, MOHAMED",0,1,-1
18874,3079320212,BK, PRESTON COURT,,Z9,CAPTAIN HOLDINGS CORP.,0,1,-1
18875,3073860166,BK,2251 EAST 29 STREET,02,C0,"SHAH, ABID",0,1,-1
18876,4026290022,QN,55 STREET,10,G0,"DRAGONIDES, ANTON",0,1,-1
18877,4123800009,QN, BAISLEY BOULEVARD,10,G7,NEW JERUSALEM BAPTIST CHURCH OF JAMAICA,0,1,-1
18878,4018330177,QN,127-14 WILLETS POINT BLVD,07,G2,YLRM CORP,1,2,-1
18879,4136880130,QN,259-51 148 DRIVE,01,B3,"JAGDEO, ANNE BYRD",1,2,-1
18880,3005740035,BK,160 DIKEMAN STREET,06,F5,160 DIKEMAN STREET LLC,0,1,-1
18881,4127800077,QN,119-22 221 STREET,01,A2,"CAMPBELL, FREDRICA",1,2,-1
18882,4094780012,QN,95-14 133 STREET,01,B3,"JHINGER, AMAR SINGH",3,4,-1
18883,4128890011,QN,129-29 BROOKVILLE BOULEVARD,01,B2,"NARANJIT, NARMESH",2,3,-1
18884,4142471312,QN,102-11 JAMES COURT,11,V0,"OWEN, CHRISTOPHER",0,1,-1
18885,4153040001,QN,331 BERT ROAD,01,A1,SALVATORE CORRAO,3,4,-1
18886,2053060152,BX,2743 GIFFORD AVENUE,10,G0,MOIRA GATELY,0,1,-1
18887,4157490213,QN,10-45 BAY 32 STREET,01,B2,VALENCIA BLACKWOOD,1,2,-1
18888,4028080053,QN,72 PLACE,11,V0,"LI, HUA ZHONG",0,1,-1
18889,2053500038,BX,3106 EAST TREMONT AVENUE,04,S3,3106 EAST TREMONT HOLDINGS LLC,1,2,-1
18890,4132660039,QN, SOUTH CONDUIT AVENUE,07,U9,NYC DEPARTMENT OF CITYWIDE ADMINISTRATIVE SERVICES,0,1,-1
18891,3006100002,BK, CONOVER STREET,,Z9,NECHANAH & REFAEL,0,1,-1
18892,2054030054,BX,1424 HOLLYWOOD AVENUE,01,B3,ANTONACCHIO SALLY,2,3,-1
18893,4000060001,QN,2 STREET,09,Q1,NYC DEPARTMENT OF PARKS AND RECREATION,0,1,-1
18894,2054060057,BX,3146 RAWLINS AVENUE,01,A1,"PASIUK, GEORGE",1,2,-1
18895,3079480022,BK,5338 KINGS HIGHWAY,07,G2,KINGS HIGHWAY & FARRAGUT ROAD,1,2,-1
18896,3081680024,BK,EAST 99 STREET,07,U7,NYC TRANSIT AUTHORITY,0,1,-1
18897,5000390055,SI,137 BENZIGER AVENUE,01,B2,"UNG, JENNY",0,1,-1
18898,2054080411,BX,1341 SIEGFRIED PLACE,01,B1,JOSEPHINE G. MONTELLA LIVING TRUST,1,2,-1
18899,4141630106,QN, CROSS BAY BOULEVARD,11,V1,"BELLONA, JOSEPH F",0,1,-1
18900,4142250138,QN, VAN DER LINN STREET,11,V0,"HOYLER, KEVIN CARL",0,1,-1
18901,4129340130,QN,131-21 224 STREET,01,A5,"CHALK, LINDSAY",1,2,-1
18902,5001320332,SI,16 ABBY PLACE,01,A1,GIAMMARIONO ROSEANNE,1,2,-1
18903,5001380111,SI,122 BARD AVENUE,01,B2,"CHENG, GEE",0,1,-1
18904,4089420062,QN,91-09 ELDERT LANE,02,C0,"ZHENG, RIHAO",1,2,-1
18905,4082330438,QN,50-19 MORENCI LANE,01,A2,"CLARK, PATRICIA",2,3,-1
18906,4079970063,QN,92-56 240 STREET,01,A1,"GONZALEZ, JOHNNY",1,2,-1
18907,3078800055,BK,1410 EAST 56 STREET,01,A9,"JOHNSON, STACIA ALLISON",1,2,-1
18908,5002540189,SI,40 PARK COURT,01,A1,"FRANCIS, WILLIAM",1,2,-1
18909,5002180079,SI,617 DELAFIELD AVENUE,11,V0,"RIVERA JR., ROBERTO",0,1,-1
18910,4004210017,QN, QUEENS PLAZA SOUTH,07,Y8,NYS DEPARTMENT OF TRANSPORTATION,0,1,-1
18911,4158910030,QN, ROCKAWAY BEACH BLVD,07,U7,NYC DEPARTMENT OF GENERAL SERVICES,0,1,-1
18912,4160910063,QN,2-48 BEACH 77 STREET,01,B2,"SHI, FAN",1,2,-1
18913,4160960027,QN,73-05 SPINNAKER DRIVE,01,B2,"DENG, JING",1,2,-1
18914,4029170049,QN,57-47 81 STREET,01,A5,YUEN STEVEN,1,2,-1
18915,3076080014,BK,1075 EAST 26 STREET,01,A9,"REINMAN, WILLIAM",1,2,-1
18916,5002760040,SI,555 DAVIS AVENUE,02,C0,"SITU, CANNIAN",1,2,-1
18917,2055920068,BX,270 SWINTON AVENUE,01,A1,VICTOR J ESCALONA,1,2,-1
18918,4162220038,QN,126-10 ROCKAWAY BEACH BLVD,01,B3,PAEZ HAROLD,1,2,-1
18919,5003480035,SI,4 HODGES PLACE,01,B1,CHRISTINA HARMON,1,2,-1
18920,4162370076,QN,150 BEACH 128 STREET,02,C5,"FRJ 1031, LLC",1,2,-1
18921,4162700071,QN,2-42 BEACH 137 STREET,01,A1,"STONE, MAURA",1,2,-1
18922,4162790087,QN,182 BEACH 135 STREET,01,A1,"KESTENBAUM, JOEL",1,2,-1
18923,4163190067,QN,188 BEACH 146 STREET,01,A2,"RAYHAM, MARINA",1,2,-1
18924,2056360177,BX,703 MINNIEFORD AVENUE,04,K4,JOHN PIRRAGLIA,1,2,-1
18925,5001010020,SI, CASTLETON AVENUE,10,G7,FUND ADVANCEMENT MENTAL HEALTH,0,1,-1
18926,4009680022,QN,21-36 73 STREET,01,A2,"MELONE, PASQUINO",1,2,-1
18927,2051100023,BX,661 EAST 243 STREET,01,B1,"KELLY, MINETTE",1,2,-1
18928,5003600041,SI,185 MAINE AVENUE,01,A1,MARK A MILLER,1,2,-1
18929,4096760052,QN,89-37 146 STREET,01,B3,"SEN, SUKANTA",2,3,-1
18930,4013320114,QN,58-68 41 DRIVE,01,A5,"MCNEILL, JOHN",1,2,-1
18931,2050380054,BX,4350 MATILDA AVENUE,01,A1,PENNINGTON  HENRY,1,2,-1
18932,5003130009,SI,637 CLOVE ROAD,01,A1,H CANLON,1,2,-1
18933,5003320141,SI,75 DRAKE AVENUE,01,A1,C&E POWERS,1,2,-1
18934,5003780148,SI,298 WESTCOTT BOULEVARD,01,B2,"RAFFONE, DAVID",1,2,-1
18935,5003620018,SI, COLLEGE AVENUE,10,G0,"MCKENNA, MYLES P",0,1,-1
18936,4015440027,QN,83-02 BROADWAY,04,K4,JDZ HOLDING LLC,2,3,-1
18937,2057230042,BX,60 KNOLLS CRESCENT,03,D4,KNOLLS COOP SECT I INC,1,2,-1
18938,5004750070,SI,316 CRYSTAL AVENUE,01,A2,"FU, LILLY",1,2,-1
18939,2058690638,BX, TYNDALL AVENUE,11,V0,MURRAY SEAN,0,1,-1
18940,5006060029,SI,128 DUDLEY AVENUE,01,A2,ROBERT STEPHENS,1,2,-1
18941,4097240143,QN,86-05 144 STREET,01,A1,"ALBRO, RICHARD A.",1,2,-1
18942,4018770027,QN,94-64 CORONA AVENUE,04,S2,VELASQUEZ GABRIEL,1,2,-1
18943,4029290053,QN,74 STREET,07,U6,NEW YORK CENTRAL LINES,0,1,-1
18944,5007220020,SI,16 QUINLAN AVENUE,01,A1,"ULLOA, STEPHEN",1,2,-1
18945,4080660047,QN,239 38 ROAD,10,G0,MAVRO WILLIAM,0,1,-1
18946,5007450056,SI,595 WOOLLEY AVENUE,01,A2,"MAHALINGAM, MATHINI",1,2,-1
18947,4083940001,QN,260-04 58 AVENUE,01,A2,"PO-CHING WANG, AS CO-TRUSTEE",1,2,-1
18948,5007600080,SI,187 GANSEVOORT BOULEVARD,01,B3,"FLINTENSTEIN, SHLOMO CHAIM",1,2,-1
18949,5007020009,SI,883 MANOR ROAD,01,B2,"FAZZINO, ANTHONY",1,2,-1
18950,5008240120,SI,73 SUNSET AVENUE,01,B2,YIP LINDA,1,2,-1
18951,5078600019,SI,24 SEA BREEZE LANE,01,A5,THE RUSSO FAMILY IRREVOCABLE TRUST,1,2,-1
18952,4080990113,QN,235 STREET,10,G6,LIRR,0,1,-1
18953,4026940002,QN,57-65 59 STREET,10,G1,TAURUS SUPPLY INC,1,2,-1
18954,5007510011,SI,651 WILLOWBROOK ROAD,05,O5,FRANK MOR REALTY CORP,2,3,-1
18955,4025010015,QN,69 LANE,10,G0,ANGELA MANN,0,1,-1
18956,4082330444,QN,50-31 MORENCI LANE,01,A3,"TO, CHI WAI",2,3,-1
18957,5007950038,SI,727 WILLOWBROOK ROAD,01,B1,ANTONIO H NEPOMUCENO,1,2,-1
18958,4028010040,QN,69-97 CALDWELL AVENUE,10,G0,"DIMITROPOULOS, CHRISTINA",0,1,-1
18959,5011580063,SI,18 HOUSMAN AVENUE,01,B2,"JIANG, MEI QIN",0,1,-1
18960,5011650071,SI,164 LAKE AVENUE,01,B2,"POZNAK, JOHN",1,2,-1
18961,3086640444,BK,37 BRIGHTON 4 COURT,01,A2,37 BRIGHTON 4 LLC,1,2,-1
18962,4029030015,QN,83 STREET,10,G0,"LIU, RUO BING",0,1,-1
18963,5012200007,SI, CONFEDERATION PLACE,11,V0,JOMEL PROPERTIES LLC,0,1,-1
18964,5008210066,SI, ROOSEVELT AVENUE,10,G0,"ZIRKIN, YEHUDAH",0,1,-1
18965,5014410018,SI,45 BRYSON AVENUE,01,A1,WILLIAM OETTING,1,2,-1
18966,5046130009,SI,203A-C GIFFORDS LANE,04,S2,B & M HOT BAGEL AND GROCERIES,1,2,-1
18967,5015080122,SI,59 CANTERBURY AVENUE,01,A2,"CIRANNI, THOMAS",1,2,-1
18968,5016440010,SI,54 DOMAIN STREET,01,A2,"ROGERS, CAITLIN",1,2,-1
18969,5008650300,SI, HILLVIEW PLACE,01,Z0,BLOCK 865 LOT 300 LLC,0,1,-1
18970,3085210065,BK,2054 EAST 36 STREET,01,A1,"MARCIANO , ARLENE A",2,3,-1
18971,5019910045,SI,122 ASHWORTH AVENUE,01,A5,"GVILI, ADAM",1,2,-1
18972,5019920076,SI,108 LOVELL AVENUE,01,A5,"KOVELMAN, ALEXANDER",1,2,-1
18973,5020350029,SI,57 SENECA LOOP,01,A5,RAUL E CRUZ JR,1,2,-1
18974,5021650080,SI, SOUTH AVENUE,11,V7,PORT AUTHORITY OF NY AND NJ,0,1,-1
18975,4078800500,QN,239-40 UNION TURNPIKE,08,I1,"INDIAN CULTURAL AND COMMUNITY CENTER, IN C",0,1,-1
18976,3083690407,BK,1343 EAST 69 STREET,01,B9,"DRACHUK, ALEKSANDR",1,2,-1
18977,5028310147,SI,106 ABBOTT STREET,01,A1,KUPROWKSI RYSZARD,1,2,-1
18978,5028450001,SI,35 ORMOND PLACE,01,B9,"GENOVESE, ANSELMO",1,2,-1
18979,5028980026,SI,659 ELBE AVENUE,01,A5,ELBE AVENUE LLC,0,1,-1
18980,5029300022,SI,180 MOSEL AVENUE,01,A5,KAIWEN LIN,1,2,-1
18981,5029300026,SI,164 MOSEL AVENUE,01,A5,SHAO YING HUANG,1,2,-1
18982,4032950057,QN, UNION TURNPIKE,10,G0,"MOUSTAFELLOS, TRUSTEE, TINA",0,1,-1
18983,5030030052,SI, MEYER LANE,11,V0,DAVID CUCCO,0,1,-1
18984,5031210093,SI,25A WATERFORD COURT,10,G0,PROVENZANO EUGENIO,0,1,-1
18985,4032950070,QN, UNION TURNPIKE,10,G0,"CIARAVOLO, ANNA",0,1,-1
18986,5031690013,SI,526 ODER AVENUE,01,A5,"NYU, SOON KEAT",1,2,-1
18987,4032990006,QN,75 ROAD,10,G0,"LLAMAS, ROBERTO",0,1,-1
18988,5032850031,SI, SAVIN COURT,11,V0,F SOMMA,0,1,-1
18989,5033230020,SI,25 OREGON ROAD,01,B2,E3K LLC,1,2,-1
18990,4033240014,QN,82 DRIVE,07,U9,NYC DEPARTMENT OF ENVIRONMENTAL PROTECTION,0,1,-1
18991,5010730125,SI, RICHMOND TERRACE,,Z9,CANTALUPO OF SI LLC,0,1,-1
18992,5034910001,SI,427 FATHER CAPODANNO BL,01,B9,"ZUKOWSKI, MARIUSZ",1,2,-1
18993,4088300079,QN,87-71 LITTLE NECK PARKWAY,01,A2,BISSOONDYAL RAMDYAL,1,2,-1
18994,4034920015,QN,62-71 FOREST AVENUE,01,B1,EMMA WEISS,1,2,-1
18995,3007600066,BK,835 47 STREET,02,C0,RIGERMAN LEONID,1,2,-1
18996,5036710015,SI,107 HAVEN AVENUE,01,B2,"WANG, HUI",0,1,-1
18997,5037130048,SI, SEAVER AVENUE,11,V0,"MACARI, JOHN",0,1,-1
18998,5010580060,SI,254 DECKER AVENUE,01,A1,"RODRIDGUEZ, CATALINA",2,3,-1
18999,5038320035,SI, IONA STREET,11,V0,ESL5 PROPERTIES LLC,0,1,-1
19000,4032950067,QN, UNION TURNPIKE,10,G0,"MEDRANO, JOHN",0,1,-1
19001,5040690042,SI,108 HETT AVENUE,01,A1,TOMMASO CASTROGIOVANNI,1,2,-1
19002,4090060012,QN, ROCKAWAY BOULEVARD,05,G8,ROCKAWAY & ATLANTIC PROPERTY INC.,0,1,-1
19003,4036610025,QN,70 STREET,10,G0,EWALD SCOTT,0,1,-1
19004,4017190038,QN,34 AVENUE,10,G0,FAUSTO CRESPO,0,1,-1
19005,5046910001,SI,131 BROOK AVENUE,01,A5,MARILYNN PALLADINO,1,2,-1
19006,5051120022,SI,14 KEEGANS LANE,01,A2,WILLIAM PETRINO,1,2,-1
19007,4036840047,QN,71-68 69 PLACE,01,B2,RUSSO VINCENZO,1,2,-1
19008,5052930026,SI,111 RIDGECREST AVENUE,01,B3,"GUCCIARDO, ANTHONY",1,2,-1
19009,4037250060,QN, CYPRESS AVENUE,09,Z8,KNOLLWOOD PARK CEMETERY INC,0,1,-1
19010,4029010007,QN,60 DRIVE,10,G0,EDWARD GIBBONS,0,1,-1
19011,5056600032,SI,8 NOTUS AVENUE,01,A5,"IMBEMBA, TIMOTHY J",1,2,-1
19012,4100680216,QN,109 AVENUE,11,V0,"KLAIBER, GUYBERTIS",0,1,-1
19013,5062380006,SI, JEFFERSON BOULEVARD,11,V0,PETER NOTO,0,1,-1
19014,4038000068,QN,79-39 69 ROAD,01,A5,"SANTIAGO, RUTH E",1,2,-1
19015,5062640021,SI,224 RATHBUN AVENUE,01,A1,JIMMY NICOLI,1,2,-1
19016,5065860013,SI,11 ANDROVETTE AVENUE,01,B2,"TYTMAN, JADWIGA",0,1,-1
19017,4038100334,QN,81-27 77 AVENUE,01,A5,CAROL N FELLENZ,1,2,-1
19018,5068530040,SI, ADDISON AVENUE,11,V0,RALPH MONTEFORTE,0,1,-1
19019,5018150175,SI, BLOOMFIELD ROAD,11,V1,"ROCKYS CONSTRUCTION, INC",0,1,-1
19020,4038340076,QN,78-61 83 STREET,01,B2,"NOCI, NIKOLA",1,2,-1
19021,5069790178,SI,16 MALIBU COURT,01,B9,"DONG, YING",1,2,-1
19022,5070930037,SI,27 HARRIS LANE,01,A5,"KREYMAN, ALEXANDER",1,2,-1
19023,5019910039,SI,134 ASHWORTH AVENUE,01,A5,"HERNANDEZ, ELLOITT",1,2,-1
19024,4062080015,QN,40-29 205 STREET,01,B1,HUNG CHUNG CHUN,1,2,-1
19025,5020000124,SI,41 MONARCH COURT,01,A5,"MENTO , JOSEPH P",1,2,-1
19026,5075840117,SI,60 SOUTH BRIDGE STREET,05,K2,R.A. PROPERTIES LLC,0,1,-1
19027,4092990062,QN,87-31 109 STREET,01,A1,"FELICIANA, LUIS A",1,2,-1
19028,5077750121,SI,54 OTTAVIO PROMENADE,01,A3,"FARID, NERMEEN",1,2,-1
19029,5077920315,SI,212 CHEEVERS LANE,01,A3,NICHOLAS FERLITO,1,2,-1
19030,5021620178,SI,3599 VICTORY BOULEVARD,04,S1,VICTORY & TRAVIS LLC,2,3,-1
19031,2049610048,BX, AMUNDSON AVENUE,10,G0,"DAZLE, IRA",0,1,-1
19032,5078850011,SI, BRIGHTON STREET,11,V0,CHRISTINE F TULL,0,1,-1
19033,3081720025,BK,627 EAST 103 STREET,01,B2,MCCORMICK 106 LLC,1,2,-1
19034,4033390102,QN,75 ROAD,10,G0,CHRISTIANA CARLA,0,1,-1
19035,4059940065,QN,209-03 32 AVENUE,01,A2,"WANG, YIQUN",1,2,-1
19036,3079490025,BK, KINGS HIGHWAY,07,U7,LIRR,0,1,-1
19037,1001560001,MN,38 LAFAYETTE STREET,05,O9,US GENERAL SERVICES ADMINISTRATION,1,2,-1
19038,2046610068,BX,3613 BARNES AVENUE,02,C2,3613 BARNES LLC,0,1,-1
19039,1005790035,MN, SPRING STREET,10,G6,EDISON NEW YORK PARKING LL,0,1,-1
19040,3076340079,BK,1278 EAST 35 STREET,01,A3,"MELOOL, EYDIE",1,2,-1
19041,4044760038,QN,9 AVENUE,11,V0,VARVATSOULIS PETER,0,1,-1
19042,4059440054,QN,15-10 215 STREET,11,V0,BAYSIDE 215TH REALTY LLC,0,1,-1
19043,4053030156,QN,36-25 172 STREET,11,V0,5848 REALTY LLC,2,3,-1
19044,4030700016,QN,66-45 79 PLACE,01,A1,THE LUANA ZANGRILLI IRREVOCABLE TRUST,1,2,-1
19045,4046100065,QN, UTOPIA PARKWAY,01,Z0,STYLIANOU ANDREAS,0,1,-1
19046,4046220061,QN,14-08 146 STREET,01,A1,"HIGGINS, MARTIN V/TRU",2,3,-1
19047,4046270056,QN,145-17 17 ROAD,01,A3,KETTENRING KARL E,1,2,-1
19048,4047330033,QN,154-19 20 AVENUE,01,A1,EDWARD RUDOWSKI,1,2,-1
19049,5028830047,SI,8 MARY STREET,02,C0,XIN XIN ZENG,1,2,-1
19050,5029300029,SI,150 MOSEL AVENUE,01,A5,"YANG, QING BAO",1,2,-1
19051,5046130114,SI, GIBSON AVENUE,10,G0,"BUCHELL, PAUL",0,1,-1
19052,4101730110,QN,164-15 108 DRIVE,02,C0,"WALLERSON, WENDELL B",1,2,-1
19053,1015870001,MN,1712 YORK AVENUE,08,P5,NYC DEPARTMENT OF PARKS AND RECREATION,2,3,-1
19054,4042600050,QN,122-23 26 AVENUE,01,A2,"CHEN, YONG",1,2,-1
19055,4032950065,QN, UNION TURNPIKE,10,G0,MICHAEL J MINISCHETTI,0,1,-1
19056,4033390022,QN,75 ROAD,10,G0,HAKIM PATRICIA,0,1,-1
19057,5033390051,SI,229A PERINE AVENUE,10,G0,"DOYLE, THOMAS",0,1,-1
19058,1020670075,MN,1867 AMSTERDAM AVENUE,08,I5,1867-1871 AMSTERDAM AVENUE LLC,1,2,-1
19059,4053530021,QN,40-12 189 STREET,01,B1,"WU, SHENGKANG",1,2,-1
19060,4054150122,QN,43-25 157 STREET,01,B1,ZHONG YI ZHANG,1,2,-1
19061,2026000142,BX,512 SOUTHERN BOULEVARD,05,K1,512-514 SOUTHERN BOULEVARD,2,3,-1
19062,4054580005,QN,46-51 159 STREET,01,A1,"CHEN, ZHEN",1,2,-1
19063,3063620100,BK, BENSON AVENUE,11,V0,THE BENNETT LANE TRUST,0,1,-1
19064,2028740001,BX,1395 NELSON AVENUE,04,D7,"NATECO HOLDING, LLC",0,1,-1
19065,3074657503,BK,3041 OCEAN AVENUE,03,R4,UNAVAILABLE OWNER,0,1,-1
19066,4033750087,QN,19-25 FLUSHING AVENUE,06,F9,"MP2, LLC",1,2,-1
19067,2031440004,BX,2086 VALENTINE AVENUE,11,V0,NOA-LIOR LLC,0,1,-1
19068,4089910181,QN,93-14 93 AVENUE,01,B2,"CUEVAS, PERSIO E",1,2,-1
19069,4039160200,QN,5 AVENUE,,Z7,TITAN SOUNDVIEW POINTE LLC,0,1,-1
19070,4060540075,QN,32-24 214 STREET,01,A1,"PELEKANOS, EURIPIDES",1,2,-1
19071,2034290009,BX, CORNELL AVENUE,11,V0,HDG PK HOMOWN ASSN,0,1,-1
19072,4035300011,QN,60-14 MADISON STREET,01,B1,W SCHLEGEL,1,2,-1
19073,4102230034,QN,169-09 104 AVENUE,01,A1,"JASSAN, KRISHENDAYE",1,2,-1
19074,4062400012,QN,38-15 214 PLACE,01,A1,PINERIO BARBARA M,1,2,-1
19075,2037640049,BX, TAYLOR AVENUE,10,G0,"LEIVA, ROSA M",0,1,-1
19076,3064910382,BK, SHORE PARKWAY,10,G7,BAYSIDE PROPERTIES,0,1,-1
19077,4035690061,QN,58-29 78 AVENUE,01,Z0,58-27 & 58-29 78TH AVE. LLC,0,1,-1
19078,2045470030,BX,2960 CRUGER AVENUE,01,A1,DALE GREEN,1,2,-1
19079,4067220011,QN,57-12 156 STREET,01,B3,"SHI, JIAN PING",1,2,-1
19080,4035190032,QN,60-68 METROPOLITAN AVENUE,04,K4,"LA RUSSA, ANTHONY",2,3,-1
19081,4036620043,QN,70-20 71 PLACE,01,A1,"BEHRET, HARRY",1,2,-1
19082,4038180007,QN,77-51 79 PLACE,01,A1,FERRISO KAREN A,1,2,-1
19083,4094700037,QN,9519A 127 STREET,10,G0,"BIDHADAR, SATMATTEE",0,1,-1
19084,3017720059,BK,187 PULASKI STREET,02,C3,187 PULASKI LLC,0,1,-1
19085,3032710001,BK,181 WYCKOFF AVENUE,04,S4,SCW REALTY INC,1,2,-1
19086,5047540036,SI,475 PROMENADE AVENUE,11,V0,HOUSING TRUST FUND CORP.,1,2,-1
19087,3018000031,BK,646 GREENE AVENUE,02,C3,JOHN FOUST JR,1,2,-1
19088,2045970013,BX,3214 CRUGER AVENUE,02,C1,3216 CRUGER LLC,1,2,-1
19089,4040510001,QN,116-01 14 ROAD,04,S9,116-03 REALTY INC,1,2,-1
19090,5080480024,SI,223 BUTLER AVENUE,01,A2,ANTONELLI-VEGA ELIZABETH E,1,2,-1
19091,5053160018,SI,76 ROBINSON AVENUE,01,A2,"THE CACACE FAMILY IRREVOCABLE TRUST, DAT ED 11/1/18",1,2,-1
19092,4092050037,QN,109-25 JAMAICA AVENUE,04,S0,MORENO SR FRANK H,1,2,-1
19093,4042490069,QN,23-50 144 STREET,01,B3,"TILIGADAS, CONSTANTINOS",1,2,-1
19094,1001937511,MN,60 WHITE STREET,04,RM,60 WHITE STREET CONDOMINIUM,1,2,-1
19095,2048510050,BX,812 EAST 227 STREET,02,C0,DERRICK S GEORGE,1,2,-1
19096,2031250034,BX, HONEYWELL AVENUE,11,V0,2140 HONEYWELL LLC,0,1,-1
19097,5009500011,SI,39 ROCKLAND AVENUE,01,A1,"COLANDREA, MICHAEL",1,2,-1
19098,2049730012,BX,3926 MULVEY AVENUE,11,V1,3926 MULVEY AVENUE LLC,0,1,-1
19099,3022960012,BK,97 NORTH 10 STREET,05,O5,UNAVAILABLE OWNER,1,2,-1
19100,2050210011,BX,4126 DE REIMER AVENUE,11,V0,BROWN MADGE,0,1,-1
19101,4091360232,QN,77 STREET,01,Z0,"TEJADA, MAYRA",0,1,-1
19102,4091810060,QN,101 STREET,11,V0,"MARIA FALCO, AS JOINT LIFE TENANTS",0,1,-1
19103,2051060038,BX, MATILDA AVENUE,10,G0,"RAMPERSAUD, NIRMALA",0,1,-1
19104,3032750036,BK,96 HIMROD STREET,02,C1,100 HIMROD STREET LLC,0,1,-1
19105,5056190061,SI,64 MOFFETT STREET,01,A5,R IANNIZZOTTO,1,2,-1
19106,1004250031,MN,167 CHRYSTIE STREET,04,K4,167 CHRYSTIE STREETCORP,1,2,-1
19107,4036670384,QN,67-44 73 PLACE,10,G0,STANISLAW BALDYGA,0,1,-1
19108,4104590009,QN,195 STREET,10,G0,"ARCHIBALD, JEAN M",0,1,-1
19109,5010060074,SI,50 A RICHMOND TERRACE,11,V2,MICHAEL PENCAK,0,1,-1
19110,2055210189,BX, MULLAN PLACE,01,Z0,"MESTOUSIS, NICHOLAS",0,1,-1
19111,2029370056,BX, LAFAYETTE PLACE,10,G0,"CAMPBELL, WILL M",0,1,-1
19112,4094070024,QN,97-40 106 STREET,01,B2,"TULSIDAS, CHUNILALL",1,2,-1
19113,2056040062,BX,2818 SCHURZ AVENUE,01,B1,WENDE WAI LAN LEE TRUST,1,2,-1
19114,5063230024,SI, AMBOY ROAD,11,V0,JOHN W HARMON,0,1,-1
19115,2056250179,BX,69 BUCKLEY STREET,01,A1,CAESAR MARIE,1,2,-1
19116,4017110027,QN,33-44 97 STREET,02,C0,"ALTAMIRANO, JOSE",2,3,-1
19117,5067280104,SI,611 JOHNSTON TERRACE,01,A5,ANN CHRISTIE,1,2,-1
19118,3074790059,BK, FORD STREET,11,V0,1000 COYLE ST RLTY CORP,0,1,-1
19119,5069680033,SI,1083 RENSSELAER AVENUE,01,A5,"FIOTTA, SANTINA",1,2,-1
19120,4036900066,QN,71-00 CENTRAL AVENUE,10,G0,"LENKIEWICZ, CECYLIA",0,1,-1
19121,2058750911,BX,264 WEST 261 STREET,10,G0,BRENDAN SHEAHAN,0,1,-1
19122,5069790220,SI,20 SANTA MONICA LANE,01,B9,"PALMIERI, ANNA",1,2,-1
19123,5070930060,SI,21 CRABTREE AVENUE,01,A5,ANDREW COHEN,1,2,-1
19124,4052770014,QN,40-19 158 STREET,01,A1,RAYMOND CICCOLILLI,1,2,-1
19125,5007740182,SI,633A WESTWOOD AVENUE,01,A5,"TSIKLIK, FANIA",1,2,-1
19126,3004800034,BK,WEST 9 STREET,07,U0,NYC DEPARTMENT OF TRANSPORTATION,0,1,-1
19127,3006340019,BK,194 18 STREET,01,A4,"KAHAN, ADAM",1,2,-1
19128,3006440178,BK,754 3 AVENUE,06,E9,750 3RD AVE REALTY CO,2,3,-1
19129,5075580435,SI, WEST SHORE PARKWAY,09,Q0,NYC DEPARTMENT OF PARKS AND RECREATION,0,1,-1
19130,5077410012,SI,361 RICHARD AVENUE,01,B2,ANGELO SPANO,0,1,-1
19131,4100040024,QN,95 AVENUE,11,V0,MELO DOMINGO E,0,1,-1
19132,3008440013,BK,122 57 STREET,06,E1,DK HOLDING GROUP LLC,1,2,-1
19133,3008790025,BK,270 18 STREET,01,B2,VENERANDA VILLANUEVA,1,2,-1
19134,4033720071,QN,21-01 MENAHAN STREET,06,E1,"GRIMALDI'S HOME OF BREAD, INC.",1,2,-1
19135,5078600020,SI,30 SEA BREEZE LANE,01,A5,ANTHONY SAIA,1,2,-1
19136,5001850100,SI, RICHMOND TERRACE,07,U6,NYC ECONOMIC DEVELOPMENT CORPORATION,0,1,-1
19137,3011340012,BK, PACIFIC STREET,10,G7,1050 PACIFIC LLC,1,2,-1
19138,4100850022,QN,106-50 WALTHAM STREET,01,B3,TERESA BRUNSON,1,2,-1
19139,3069430130,BK,BAY 41 STREET,11,V1,1900 ACQUISITION LLC,0,1,-1
19140,4102190110,QN,170 STREET,07,U7,LIRR,0,1,-1
19141,3070510133,BK,2860 WEST 29 STREET,08,P3,UNAVAILABLE OWNER,0,1,-1
19142,3014700003,BK,547 RALPH AVENUE,02,C0,NYC HOUSING AUTHORITY,3,4,-1
19143,3038710001,BK,10601 AVENUE D,07,G9,NYC ECONOMIC DEVELOPMENT CORPORATION,1,2,-1
19144,4102550014,QN,172 STREET,11,V0,"STOLL, TIMOTHY",0,1,-1
19145,1001420050,MN,208 WEST STREET,08,W5,BMCC PERFORMING ARTS CENTER,1,2,-1
19146,4032220027,QN,70-46 MANSE STREET,01,A1,KATHRYN A BOURGOINE,1,2,-1
19147,3017520035,BK,156 SANDFORD STREET,06,F5,VAN BLARCOM CLOSURES INC,1,2,-1
19148,3017530033,BK,168 NOSTRAND AVENUE,10,G7,TSFS LTD.,0,1,-1
19149,3017610008,BK,224 VERNON AVENUE,02,C1,VERNON PARK LLC,0,1,-1
19150,4058650150,QN, BELL BOULEVARD,11,V0,BELSHIRE MANOR PROP,0,1,-1
19151,1002270052,MN,27 GRAND STREET,05,HB,THOR JAMES HOTEL INVESTOR LLC,1,2,-1
19152,3019687502,BK,169 LEXINGTON AVENUE,02,R1,UNAVAILABLE OWNER,1,2,-1
19153,4026300013,QN,59-06 56 STREET,02,C0,BURGOS ALBERTO,1,2,-1
19154,4129280076,QN,218 STREET,11,V0,"FLOWERS, EUGENE ROBERT",0,1,-1
19155,3023580016,BK, METROPOLITAN AVENUE,04,D7,"106 NORTH THIRD, LLC",0,1,-1
19156,3023840124,BK,56 MARCY AVENUE,04,S2,UNAVAILABLE OWNER,0,1,-1
19157,4106310056,QN,92-05 215 STREET,01,A1,ISAURO A. ROMAN,1,2,-1
19158,4096220032,QN, HILLSIDE AVENUE,10,G7,LORENZO ROSANO,0,1,-1
19159,3034220054,BK,129 SCHAEFER STREET,02,C3,143 DEVELOPMENT LLC,0,1,-1
19160,4108780039,QN,210 STREET,10,G0,ARRO OF QUEENS INC,0,1,-1
19161,4103700012,QN,104-14 185 STREET,01,B3,"HUNTE, JOHN G",1,2,-1
19162,3072010058,BK,68 PARKWAY COURT,01,A5,"DORIA, JOHN A",1,2,-1
19163,3030730097,BK,83 BUSHWICK PLACE,02,C1,BUSHWICK PLACE VENTURE LLC,0,1,-1
19164,3031710053,BK,61 TROUTMAN STREET,02,C1,61 TROUTMAN LLC,0,1,-1
19165,3046460015,BK,306 EAST 92 STREET,02,C2,306 E 92ND LLC,1,2,-1
19166,3073500023,BK,EAST 18 STREET,11,V0,MEHMET KALKAN,0,1,-1
19167,4039730045,QN,125-08 9 AVENUE,01,B2,JOHN MALACK,1,2,-1
19168,5007590077,SI,175 MOUNTAINVIEW AVENUE,01,A1,ROBERT T MARRONE,1,2,-1
19169,3071470067,BK,16 VILLAGE COURT,01,B3,"SIMONISHVILI, EKATERINE",1,2,-1
19170,3022260022,BK,198 RUTLEDGE STREET,01,B9,"DEUTSCH, MOSHE",1,2,-1
19171,4112740043,QN,228-40 114 DRIVE,01,A0,MARIE J LASCASE,1,2,-1
19172,4115010060,QN,133 AVENUE,07,U7,NYC TRANSIT AUTHORITY,0,1,-1
19173,4036880029,QN,72 STREET,10,G0,"GADEK, ROBERT",0,1,-1
19174,1016270051,MN,1563 LEXINGTON AVENUE,10,G6,"1559 LEXINGTON AVENUE REALTY, LLC",0,1,-1
19175,1016350046,MN,162 EAST 108 STREET,10,G6,TEAM PROPERTIES LLC,0,1,-1
19176,3044520935,BK,578 SCHROEDERS AVENUE,01,A5,"WELCH, CHERYL A",1,2,-1
19177,4061700048,QN,36-21 211 STREET,01,A1,LAI WILLIAM,1,2,-1
19178,3071310074,BK,2171 EAST 4 STREET,01,B3,"ELO, ELLIOT",1,2,-1
19179,4117540028,QN,119-59 130 STREET,01,A1,"SALIARD, TRINETTE",1,2,-1
19180,3047830007,BK,4818 GARAGE FOSTER AVENUE,10,G0,"DELAND, GASTON V",0,1,-1
19181,1022430270,MN,5089 BROADWAY,05,GU,"BROADWAY MF, LLC",0,1,-1
19182,3048130054,BK,737 FENIMORE STREET,11,V0,L & O CAPITAL LLC,0,1,-1
19183,4117580217,QN,134 STREET,11,V0,"SINGH, BALJIT",0,1,-1
19184,4120350013,QN,120-17 142 STREET,01,B3,"LONGMORE, ROBERT",1,2,-1
19185,2024320019,BX,283 EAST 164 STREET,10,G7,164 PROPERTY GROUP LLC,0,1,-1
19186,3065220006,BK,916 AVENUE I,08,W9,YESHIVAH OF FLATBUSH,1,2,-1
19187,4118030060,QN,135-42 117 STREET,01,A5,"BUDHOO, SURESH",1,2,-1
19188,4013760043,QN,26-31 96 STREET,02,C3,"MITCHUM , RONICA L",1,2,-1
19189,2027220035,BX,884 TIFFANY STREET,08,M1,R C CHURCH ST ATHANAS,2,3,-1
19190,4010000019,QN,49-23 ASTORIA BOULEVARD N,,Z9,"VARIOUS SHAREHOLDERS OF CBS OUTDOOR AMER ICAS, INC",0,1,-1
19191,4046140010,QN,14-63 166 STREET,01,A2,"KELLY, JOHN",1,2,-1
19192,2029660113,BX,1480 LOUIS NINE BOULEVARD,01,A2,Edward Parker,1,2,-1
19193,4122850053,QN,159 STREET,11,V0,"PERSAUD, SANDRA",0,1,-1
19194,2032460025,BX, SEDGWICK AVENUE,09,Q1,NYC DEPARTMENT OF PARKS AND RECREATION,0,1,-1
19195,2032550004,BX, GILES PLACE,10,G0,"MITCHELL, VERA M",0,1,-1
19196,2032650001,BX,2811 EXTERIOR STREET,03,D3,NYC HOUSING AUTHORITY,4,5,-1
19197,2032990007,BX,3012 BAINBRIDGE AVENUE,02,C0,"TACKIE, ESTHER",2,3,-1
19198,5033010059,SI, CROMWELL AVENUE,10,G0,"BIANCO, MARGARET",0,1,-1
19199,4008710030,QN,20-24 CRESCENT STREET,02,C9,CENTAL ASTORIA,10,11,-1
19200,3056120013,BK,1420 44 STREET,02,C0,1420 44 STREET ENTERPRISES LLC,1,2,-1
19201,4128250138,QN,226-06 FRANCIS LEWIS BLVD,08,M9,CONGREGATION OHEL,1,2,-1
19202,2051100014,BX,671 EAST 243 STREET,01,B3,"AYALA, DANNY",1,2,-1
19203,3080680059,BK,1514 REMSEN AVENUE,01,B2,PHILIP WEBSTER,1,2,-1
19204,3080840060,BK,1459 EAST 87 STREET,01,B9,"TAPPER-CLARKE, SHAWN",1,2,-1
19205,4133630030,QN,146-60 SPRINGFIELD BLVD,10,G0,COUNTRY HOMES NY LLC,0,1,-1
19206,2040240045,BX,1608 TAYLOR AVENUE,01,B9,"RAMIREZ, JR., PEDRO S",1,2,-1
19207,4049420057,QN,32-02 COLLEGE POINT BLVD,06,E1,A.J. PEGNO CONSTRUCTION CORP.,1,2,-1
19208,4090650019,QN,97-38 92 STREET,01,B9,"REYNOLD, PAUL",2,3,-1
19209,4091460017,QN,105-24 86 STREET,01,A1,QUINTIN T. DELGADO,2,3,-1
19210,5001650128,SI,372 SHEFFIELD STREET,01,B3,"OCCHIPINTI, RANDAL J",1,2,-1
19211,3057550035,BK, NEW UTRECHT AVENUE,11,V1,YU & SONS LLC,0,1,-1
19212,2045590053,BX, HERING AVENUE,11,V0,PAULINE EDWARDS,0,1,-1
19213,1010897502,MN,533 11 AVENUE,04,RR,UNAVAILABLE OWNER,2,3,-1
19214,2046160066,BX,3221 TENBROECK AVENUE,01,A5,"NKWA, PIERRE O",1,2,-1
19215,4155710013,QN,8-36 DORIAN COURT,01,A1,"BLOOM, YECHIEL",1,2,-1
19216,3058710036,BK,254 BAY RIDGE AVENUE,05,K2,252 BAYRIDGE REALTY LLC,1,2,-1
19217,2028020035,BX,1857 ANTHONY AVENUE,01,A7,"DEANS, MARCEL",1,2,-1
19218,4160420065,QN,4-13 BEACH 68 STREET,01,B2,"JAMES, SHERWIN",1,2,-1
19219,4091690020,QN, LIBERTY AVENUE,10,G7,DOROTHY K O'HEARN,0,1,-1
19220,3058020040,BK,7 AVENUE,07,U7,NYC TRANSIT AUTHORITY,0,1,-1
19221,4120910134,QN, INWOOD STREET,11,V0,LEE MOORE,0,1,-1
19222,4038180044,QN,79-63 78 AVENUE,02,C0,"MURATOVIC, SAIT",1,2,-1
19223,3082950025,BK,EAST 92 STREET,11,V0,"IFILL, DESIREE",0,1,-1
19224,4093060223,QN,98 STREET,11,V0,"MUNESHWAR, BIMAL",0,1,-1
19225,4162530033,QN,411 BEACH 130 STREET,01,A1,"MITTERWAY, PHILIP",1,2,-1
19226,2047900036,BX,2912 WICKHAM AVENUE,01,B2,W2910 LLC,0,1,-1
19227,4163210024,QN,165 BEACH 147 STREET,01,A1,"DI SCIPIO, IRENE",1,2,-1
19228,5000390047,SI,121 BENZIGER AVENUE,01,B2,"SHI, DANYANG",0,1,-1
19229,3066190014,BK,1622 WEST 12 STREET,01,B2,"ZENG, QUN CHANG",1,2,-1
19230,5000400047,SI,55 HENDRICKS AVENUE,01,A1,ORTIZ CESAR,1,2,-1
19231,5001150076,SI,365 VICTORY BOULEVARD,01,B2,WILLIAM H BROCK,1,2,-1
19232,3030520019,BK,150 MESEROLE STREET,04,D7,169 GRAHAM LLC,0,1,-1
19233,3084701140,BK,2124 MILL AVENUE,10,G7,MILL BASIN LLC,4,5,-1
19234,2050990057,BX,4425 SETON AVENUE,02,C0,CHUNILALL SINGH,1,2,-1
19235,5071040035,SI, WESTFIELD AVENUE,,Z9,BROWN PROPERTIES LLC,0,1,-1
19236,3085270063,BK,2048 HENDRICKSON STREET,01,B3,"PAN, CHENG HUI",1,2,-1
19237,2052500011,BX,3343 PROVOST AVENUE,11,V1,"PROVOST, LLC",0,1,-1
19238,4112170120,QN,113 AVENUE,11,V0,"PIERRE,  LOUIS  JEAN",0,1,-1
19239,3032540058,BK,79 STANHOPE STREET,02,C1,UNAVAILABLE OWNER,0,1,-1
19240,3087600050,BK,1830 SHORE BOULEVARD,08,W3,KINGSBOROUGH COMMUNITY COLLEGE AUXILIARY  ENTERPRISES CORPORATION,0,1,-1
19241,4095790087,QN,104-15 125 STREET,01,B2,C BURKE,1,2,-1
19242,5003600025,SI, COLLEGE AVENUE,10,G0,"SALAMON, JOHN",0,1,-1
19243,4114570065,QN,155-35 77 STREET,01,B2,"BHUIYAN, MOHAMMED",1,2,-1
19244,3069170042,BK,128 BAY 50 STREET,02,C0,"JAVED, SHAMEEM",1,2,-1
19245,2055190034,BX, WISSMAN AVENUE,11,V0,LIVRIERI EDWARD J J,0,1,-1
19246,5070930064,SI,27 CRABTREE AVENUE,01,A5,ALEKSANDR GALPERIN,1,2,-1
19247,5005190101,SI,50 SMITH TERRACE,01,A1,O'CONNOR ERIN M,1,2,-1
19248,2055780034,BX, CALHOUN AVENUE,11,V0,"MORALES, ALEXIS",0,1,-1
19249,2055920115,BX,2814 COLLIS PLACE,01,A5,"MOUSSOT, MARY",1,2,-1
19250,5005440043,SI,633 VAN DUZER STREET,01,B2,"DUFF, ALONZO",1,2,-1
19251,4013550053,QN,72-21 45 AVENUE,01,B2,"ZALAZAR, ROBERT",2,3,-1
19252,2056040060,BX,2814 SCHURZ AVENUE,01,B1,DELATORRE EDWARD,1,2,-1
19253,2056067504,BX,1 ANGELAS PLACE,02,R3,UNAVAILABLE OWNER,15,16,-1
19254,2025390071,BX, MAJ WM DEEGAN BLVD,07,U6,MTA - METRO NORTH,0,1,-1
19255,5007540011,SI,369 FANNING STREET,01,B9,"HUANG, TONY",1,2,-1
19256,3072330004,BK,2619 SHORE PARKWAY,02,C0,"SCHIRO, GIUSEPPE",1,2,-1
19257,5008350020,SI,53 SPRING STREET,01,A2,MARIA CAVALLUZZI,1,2,-1
19258,4098730009,QN,169-03 84 AVENUE,01,B3,"TAM, ANNIE",2,3,-1
19259,4051750029,QN,148 STREET,10,G0,"LAU, CHUNCHEE",0,1,-1
19260,3073190027,BK,2050 EAST 15 STREET,02,C0,2050 E 15 PARTNERS LLC,1,2,-1
19261,3073250067,BK,2491 OCEAN AVENUE,03,D1,ASTER GARDEN LLC,1,2,-1
19262,5009420030,SI, RICHMOND ROAD,07,U2,CON EDISON,0,1,-1
19263,1020480044,MN,610 ST NICHOLAS AVENUE,02,C1,ICER OF 610 ST NICHOLAS LLC,1,2,-1
19264,4051750035,QN,148 STREET,10,G0,"REN, GUAN YING",0,1,-1
19265,5010650064,SI,120 SMITH PLACE,01,B3,ZAHARESCU LACRAMIOARA M,1,2,-1
19266,5011690053,SI,326A PULASKI AVENUE,01,A5,JOHNSON ROSALIND,1,2,-1
19267,4118630027,QN,135-19 129 STREET,11,V0,GILBERTO RIOS,0,1,-1
19268,3078230063,BK,1950 TROY AVENUE,01,B2,"EDWARDS, KEVERN",2,3,-1
19269,5011940092,SI,234 SIMONSON AVENUE,01,B2,CYNTHIA TIRONE,1,2,-1
19270,1019170025,MN,113 WEST 132 STREET,01,B9,"GIBBONS, WILLIAM C",1,2,-1
19271,3079320208,BK, PRESTON COURT,,Z9,CAPTAIN HOLDINGS CORP.,0,1,-1
19272,3079490230,BK,31 PRESTON COURT,10,G7,ANGELO STALLONE,0,1,-1
19273,4052350023,QN,152-18 33 AVENUE,01,A5,"CHEN, LIN",1,2,-1
19274,4126040015,QN,118-20 190 STREET,01,B3,"BIGGS, EROL",1,2,-1
19275,4102220131,QN,168-37 104 AVENUE,01,B2,SHIWRAM LALARAM,1,2,-1
19276,5013180009,SI,3418 RICHMOND TERRACE,11,V1,NYC DEPARTMENT OF PARKS AND RECREATION,0,1,-1
19277,5014400073,SI,50 BRYSON AVENUE,01,A2,"VENUTO, RICHARD",2,3,-1
19278,4059710023,QN,28-46 200 STREET,01,A1,"GONZALEZ, DANNY",1,2,-1
19279,3085240003,BK,3817 AVENUE T,01,A5,"WU, RUI YIN",2,3,-1
19280,5014730020,SI,161 COLLFIELD AVENUE,01,A1,"LOUIS URSOMANNO, TRUSTEE",1,2,-1
19281,3067640072,BK,1565 EAST 17 STREET,01,A1,SIDNEY STERN AND FAY ROCHELLE STERN 2015  JT REV TR,1,2,-1
19282,4011010261,QN,24-28A 90 PLACE,10,G0,ANA TOIRAC,0,1,-1
19283,5015080218,SI,391 CASWELL AVENUE,01,A2,ANTHONY A VARRIANO,1,2,-1
19284,5019910034,SI,57 CONRAD AVENUE,01,A5,"PAN, WEI BIN",1,2,-1
19285,3009310001,BK,45 5 AVENUE,04,C7,FIFTH AND BERGEN HOUSING DEVELOPMENT FUN D CORP,1,2,-1
19286,5021020014,SI,181 FREEDOM AVENUE,01,A5,AVISHY SHAER,1,2,-1
19287,3066020070,BK,1553 WEST 5 STREET,01,B3,"LOMORO, VINCENZO",1,2,-1
19288,3069160021,BK,106 BAY 49 STREET,10,G0,"BABER, AQSA",0,1,-1
19289,4000390002,QN, BORDEN AVENUE,07,U6,PENN RR CO,0,1,-1
19290,4002120006,QN,38-05 HUNTERS POINT AVENUE,05,H4,HUNTERS POINT PARTNERS LLC,1,2,-1
19291,4003570002,QN, VERNON BOULEVARD,07,U0,UNAVAILABLE OWNER,0,1,-1
19292,4005770013,QN,30-63 CRESCENT STREET,01,B9,3063 CRESCENT LLC,1,2,-1
19293,3066100034,BK,EAST 4 STREET,11,V0,COLUCCIO JOSEPH,0,1,-1
19294,4104370029,QN,188-52 ILION AVENUE,01,B2,ILLION HOLDING CORP.,1,2,-1
19295,3031360022,BK,34 BELVIDERE STREET,02,C1,GW BELVEDERE LLC,0,1,-1
19296,4121780228,QN,112-66 DILLON STREET,01,B2,NGOZI F. OSU,1,2,-1
19297,5028980021,SI,665 ELBE AVENUE,01,A5,ELBE AVENUE LLC,0,1,-1
19298,5028990163,SI,65 MOSEL AVENUE,01,A5,"NG, SAU H",1,2,-1
19299,4006140075,QN,31-82 33 STREET,02,C2,31-82 33RD STREET REALTY LLC,1,2,-1
19300,5030380056,SI,10 RODERICK AVENUE,01,A5,"CAI, JIA YING",0,1,-1
19301,5031020105,SI,58 SAVO LANE,01,A5,DOUGINETS EUGENE,1,2,-1
19302,3014090001,BK,1651 CARROLL STREET,04,C7,PERS REALTY LLC,1,2,-1
19303,4126380012,QN,118-36 204 STREET,01,A2,"MORRIS, WAYNE",1,2,-1
19304,4010090024,QN,22-36 78 STREET,02,C0,"AZZAM, OSSAMA",1,2,-1
19305,5032770040,SI,440 MC CLEAN AVENUE,01,A3,"DISALVO, STEVEN J",1,2,-1
19306,4100620017,QN,148 STREET,11,V2,"105 148TH ST., LLC",0,1,-1
19307,5033250100,SI,161 OLD TOWN ROAD,07,U9,MTA - STATEN ISLAND RAILWAY,0,1,-1
19308,4008770013,QN,23 STREET,07,U6,NATIONAL RAILROAD PASSENGER CORP,0,1,-1
19309,4055230120,QN,201-08 NORTHERN BOULEVARD,04,K4,JKAYC LLC,1,2,-1
19310,3034680050,BK,11 DE SALES PLACE,03,D3,OUR LADY OF LOURDES HOUSING DEVELOPMENT  FUND CORP,1,2,-1
19311,4059800076,QN,203-37 28 AVENUE,01,B3,THE BARBARA A. CAREY IRREVOCABLE TRUST,1,2,-1
19312,4140750084,QN,91-09 164 AVENUE,01,B3,"ISOLANO, JOSEPH R.",1,2,-1
19313,4060220005,QN,29-01 JORDAN STREET,01,B1,"XIAO, YUNZHANG",1,2,-1
19314,4038440047,QN,78-05 85 STREET,01,A5,"CAREY, THOMAS C",1,2,-1
19315,4017610010,QN,37-12 99 STREET,01,B2,"LUGO-ESPAILLAT, LAUR",1,2,-1
19316,3061870050,BK,1161 73 STREET,01,B1,"CARLUZZO, PIETRO G",1,2,-1
19317,4017780161,QN,108-48 37 DRIVE,01,B2,108-48 LLC,0,1,-1
19318,4060230022,QN,29-34 201 STREET,10,G0,"GOBIC, MIROSLAV",0,1,-1
19319,4017910052,QN,130-31 NORTHERN BOULEVARD,,Z9,NYS DEPARTMENT OF TRANSPORTATION,3,4,-1
19320,4018310001,QN,127-43 36 AVENUE,,Z9,SEMCO INC,3,4,-1
19321,3024150022,BK,60 SOUTH 2 STREET,05,O5,FREEWYTHE LLC,2,3,-1
19322,5044370011,SI, CENTER STREET,10,G0,GORDON DEANGELIS,0,1,-1
19323,3024390008,BK,261 UNION AVENUE,02,C2,"263 UNION AVENUE, LLC",0,1,-1
19324,4061560037,QN,35-33 207 STREET,01,A1,SHI MING CHU,1,2,-1
19325,3026290017,BK,263 NORTH HENRY STREET,,Z9,HENRYK LLC,1,2,-1
19326,5057350416,SI,85 PRESENTATION CIRCLE,01,A5,"EBERLE, MARK J",1,2,-1
19327,1020160010,MN,7 AVENUE,07,U7,NYC TRANSIT AUTHORITY,0,1,-1
19328,5062570003,SI, JEFFERSON BOULEVARD,11,V1,"TORNQUIST, AUGUST D",0,1,-1
19329,5063320056,SI,867 HUGUENOT AVENUE,07,U6,MTA - STATEN ISLAND RAILWAY,0,1,-1
19330,5064520021,SI,470 POILLON AVENUE,01,B9,"SANGUINEDO, DOROTHY",2,3,-1
19331,5065840020,SI, ANDROVETTE AVENUE,11,V0,JULIE A DE LUZIO,0,1,-1
19332,3027770025,BK,317 HUMBOLDT STREET,02,C1,317 HUMBOLD ST LLC,0,1,-1
19333,3060730019,BK,8814 7 AVENUE,01,A5,COLLINS ANGELA M,1,2,-1
19334,5069790304,SI,167 EL CAMINO LOOP,01,B9,"GERSHENGORN, ROMAN",1,2,-1
19335,4014770062,QN,37-35 89 STREET,01,B1,SHU FANG ZHENG,1,2,-1
19336,4005160035,QN,12-16 30 ROAD,02,C0,"TORIBIO, ARACELI",1,2,-1
19337,5070920115,SI,92 CRABTREE AVENUE,01,B9,STEPHEN PARASCONDOLA,1,2,-1
19338,5072670296,SI,17 JADE COURT,01,A5,JERRY KUMAR,1,2,-1
19339,5073560386,SI,146 CHURCHILL AVENUE,01,A5,NAVARRA CATHERINE,1,2,-1
19340,3030560070,BK, BUSHWICK PLACE,,Z9,25 BUSHWICK REALTY LLC,0,1,-1
19341,4028680016,QN,86-40 55 ROAD,01,A1,"LIN, QIAO YAN",1,2,-1
19342,4142310191,QN, PEDESTRIAN WAY,11,V0,NYC DEPARTMENT OF CITYWIDE ADMINISTRATIVE SERVICES,0,1,-1
19343,3055310061,BK,1661 63 STREET,06,E1,M&S RE REALTY LLC,0,1,-1
19344,4030280058,QN,71 STREET,11,V0,"PLUT, ANN",0,1,-1
19345,4130360048,QN,218-47 139 AVENUE,01,A1,RAYMOND WARREN,1,2,-1
19346,4142531522,QN,164 ROAD,11,V0,"DEL BIANCO, LAURA",0,1,-1
19347,4033100027,QN, BURNS STREET,10,G0,ALLISON WILLIAM S,0,1,-1
19348,4033390023,QN,75 ROAD,10,G0,SHRADER ERWIN,0,1,-1
19349,4033390052,QN,1143 76 AVENUE,10,G0,ELKAST CORP,0,1,-1
19350,3017770012,BK,238 PULASKI STREET,03,D1,REALTY PULASKI LLC,0,1,-1
19351,4036000097,QN,74-13 65 STREET,10,G0,ABID PARVEZ,0,1,-1
19352,4131850012,QN,139-47 230 STREET,01,B3,GAETAN BEAUZILE,1,2,-1
19353,4126820008,QN,120 AVENUE,11,V0,UNITED STATES A VA,0,1,-1
19354,3039120039,BK,24 HIGHLAND PLACE,02,C0,"GRANT , DAWN  J",1,2,-1
19355,1011830053,MN,342 WEST 72 STREET,03,D4,CHATSWORTH REALTY CORPORATION,2,3,-1
19356,4038100086,QN,73-12 88 STREET,05,O2,COMMUNICAR INC,1,2,-1
19357,4039360038,QN,119-54 POPPENHUSEN AVENUE,01,A2,MEE LIAN LIM,2,3,-1
19358,4133460081,QN,182ND STREET,11,V0,PK QUEENS LLC,1,2,-1
19359,1006130068,MN,174 7 AVENUE SOUTH,05,K2,HUANG'S HOLDING  CORP,1,2,-1
19360,4055200037,QN,196-41 44 AVENUE,01,B2,CHARALAMBOUS FAMILY TRUST,2,3,-1
19361,4042240046,QN,120-13 25 AVENUE,01,B1,"CHAN, KIU YAN",1,2,-1
19362,4017490027,QN,35-14 108 STREET,04,S2,DOMINGUEZ AURISTELA,1,2,-1
19363,4044580027,QN,145-60 9 AVENUE,01,A2,SUEN FONG CHIN,1,2,-1
19364,4135730011,QN,141-32 247 STREET,01,B2,CESAR CARL,1,2,-1
19365,1010330041,MN,314 WEST 43 STREET,10,G6,ARDEON REALTY CORP,0,1,-1
19366,4046580035,QN,147-43 24 AVENUE,01,A5,"KU, JUM RAE",2,3,-1
19367,1007440047,MN,310 WEST 21 STREET,02,C4,"PROLIFIA, LLC",0,1,-1
19368,4136050019,QN,140-39 255 STREET,01,A2,"KELLY, PATRICK",1,2,-1
19369,1011370010,MN,1945 BROADWAY,08,W3,LINCOLN CENTER PERFORMING ARTS,1,2,-1
19370,4049770033,QN,137-34 NORTHERN BOULEVARD,07,U4,NEW YORK TELEPHONE CO,1,2,-1
19371,1012570001,MN,476 5 AVENUE,08,P8,NEW YORK PUBLIC LIBRARY,3,4,-1
19372,1004250030,MN,169 CHRYSTIE STREET,05,K2,BEH CORP.,1,2,-1
19373,4018280013,QN,33-24 127 PLACE,07,G2,"EMPIRE GROUP I, INC",1,2,-1
19374,4059380007,QN,18-15 215 STREET,03,D4,1815 215TH STREET OWNERS CORP,10,11,-1
19375,1018660002,MN,30 MORNINGSIDE DRIVE,03,D3,DS 30 MORNINGSIDE DRIVE LLC,3,4,-1
19376,4019430024,QN,103-50 52 AVENUE,01,B2,"BACULIMA, JULIO",1,2,-1
19377,1021360300,MN,899 RIVERSIDE DRIVE,09,Q1,NYC DEPARTMENT OF PARKS AND RECREATION,0,1,-1
19378,4137100017,QN,147-26 230 PLACE,01,B2,BOADU DANIEL,1,2,-1
19379,2027690090,BX,532 BRYANT AVENUE,06,E1,530-532 BRYANT LLC,0,1,-1
19380,4039600027,QN,129-15 7 AVENUE,01,B2,"SOUSOURIS, MARIA",1,2,-1
19381,2029550052,BX, FAIRMOUNT PLACE,10,G0,SADF HOLDINGS LLC,0,1,-1
19382,5033430064,SI,209 LIBERTY AVENUE,01,B2,"MUJAJ, XHAFER",0,1,-1
19383,3087520006,BK,161 IRWIN STREET,01,A1,ALEXEY KUPTSOV,2,3,-1
19384,4075120019,QN,56-33 CLOVERDALE BOULEVARD,01,A3,"LIU, WEI",1,2,-1
19385,3042710070,BK, LINCOLN AVENUE,07,U7,NYC TRANSIT AUTHORITY,0,1,-1
19386,4105320010,QN,197-27 FOOTHILL AVENUE,01,A1,LOUIS J BALDWIN,1,2,-1
19387,4082600211,QN,253-49 PEMBROKE AVENUE,01,A2,DAVID JANG,1,2,-1
19388,3081240009,BK,9115 FOSTER AVENUE,01,B2,"CHARLES, ALFRED T",1,2,-1
19389,3045580099,BK,658 SAPPHIRE STREET,01,B2,"SOSA, RICHARD M",1,2,-1
19390,3053840058,BK, DAHILL ROAD,10,G7,DAHILL 477 LLC,0,1,-1
19391,4155100023,QN, HARRIS STREET,10,G0,"SALAMON, MICHAEL   J",0,1,-1
19392,3085400062,BK,2138 COLEMAN STREET,01,A1,"MOSTOVOY, ROMAN",1,2,-1
19393,4090790024,QN,101-23 78 STREET,01,B2,"CHIRAGH, MICHAEL",1,2,-1
19394,3048910037,BK,315 EAST 37 STREET,01,B9,"HILL, MITCHELL",1,2,-1
19395,4027300181,QN,60 AVENUE,11,V0,JOHN J LESNIAK,0,1,-1
19396,3048800016,BK,832 TROY AVENUE,01,A1,WILSON MILANY H,1,2,-1
19397,4092680046,QN,85-11 122 STREET,01,A1,HOCHSTER REBECCA,1,2,-1
19398,3083690353,BK,7013 AVENUE N,01,B2,"TROMAN, MICHAEL",1,2,-1
19399,4124420008,QN, EVERITT PLACE,07,U2,CON EDISON CO,0,1,-1
19400,3084701092,BK, STRICKLAND AVENUE,,Z9,UNAVAILABLE OWNER,0,1,-1
19401,3086160120,BK, BODY OF WATER,09,Q9,RAFAEL SARIKOV,0,1,-1
19402,4142010082,QN,163-45 CROSS BAY BOULEVARD,05,K1,FWS REALTY LLC,1,2,-1
19403,3051070101,BK,880 ROGERS AVENUE,07,G2,"MCEWEN, VIBERT",1,2,-1
19404,3086950433,BK,3029 STILLWELL AVENUE,09,P6,"SINGER CONEY, LLC",0,1,-1
19405,3051110041,BK,1544 NOSTRAND AVENUE,02,C1,1544 NOSTRAND LLC,1,2,-1
19406,3052520070,BK,2096 NOSTRAND AVENUE,08,M1,ROCK OF HOLINESS DELIVERANCE FAITH,1,2,-1
19407,2041300012,BX,1847 HAIGHT AVENUE,01,A1,DANIEL A SURVILLO,1,2,-1
19408,4099070062,QN,90-43 185 STREET,01,B2,CARLOS M GOMEZ,1,2,-1
19409,4101150091,QN, LIBERTY AVENUE,07,U7,LIRR,0,1,-1
19410,4126170015,QN,117-18 197 STREET,01,B2,"RAFIQI, RAHIM ABDUL",0,1,-1
19411,2041570046,BX,1633 PILGRIM AVENUE,01,A1,"TANGREDI, ROSEMARIE",2,3,-1
19412,5080430072,SI,202 FISHER AVENUE,10,G0,GERARD JENSEN,0,1,-1
19413,3057480044,BK,1415 65 STREET,07,G2,RALPH FABBRICINO,1,2,-1
19414,3088830974,BK,14 GOTHAM AVENUE,01,B2,"RUSSO, STEVEN",1,2,-1
19415,4142340866,QN, RUSSELL STREET,11,V0,"SEVILLA, JOSEPH A",0,1,-1
19416,4103820003,QN, NEWBURG STREET,11,V0,"VIVES, VICTOR A",0,1,-1
19417,2046760033,BX,815 EAST 217 STREET,01,A1,"LEWIS, FITZROY M",1,2,-1
19418,5000390037,SI,32 HENDRICKS AVENUE,01,B2,"YANG, RUI FENG",0,1,-1
19419,4106600006,QN,89-88 217 STREET,01,A1,"BHUIYAN, RASHIDUL H",1,2,-1
19420,4004610006,QN,9-07 43 AVENUE,01,B2,VICENTE MARTINEZ,1,2,-1
19421,4107210039,QN,91 ROAD,11,V0,"THOMAS, INDEIRA",0,1,-1
19422,4159050065,QN,174 SEA GRASS LANE,01,B2,"LEI, CHENG I",1,2,-1
19423,4108430003,QN,99 AVENUE,11,V0,"BETHUNE , LEON",0,1,-1
19424,4131930050,QN,228-14 MENTONE AVENUE,01,A1,"BOATSWAIN, HAZEL",1,2,-1
19425,4049420017,QN,34-32 COLLEGE POINT BLVD,06,E9,DAME REALTY LLC,2,3,-1
19426,5007250022,SI,123 PERRY AVENUE,01,B2,"SAULO, ALFRED  V",1,2,-1
19427,4136600101,QN, CRAFT AVENUE,09,Q1,NYC DEPARTMENT OF CITYWIDE ADMINISTRATIVE SERVICES,0,1,-1
19428,2052320019,BX,3301 HUNTER AVENUE,01,B2,"JACKSON, GLORIA",1,2,-1
19429,2052630132,BX,2210 REEDS MILL LANE,06,E1,"CDK ENTERPRISES OF NEW YORK, LLC",1,2,-1
19430,2053280024,BX,1115 STADIUM AVENUE,01,Z0,"MACLI, ALFRED",0,1,-1
19431,2053570113,BX, LA SALLE AVENUE,11,V0,GLADYS TEDESCHI,0,1,-1
19432,4136610040,QN,255-49 147 ROAD,01,B2,"MARTINEZ, JORGE L",1,2,-1
19433,3041050046,BK, CRESCENT STREET,,Z9,"URBAN REAL ESTATE HOLDINGS, LTD.",0,1,-1
19434,4113730004,QN,134-13 SITKA STREET,01,B2,"MURGOLO, PATRICIA",1,2,-1
19435,4106440033,QN,90-32 212 PLACE,01,B3,"ORTIZ, JESUS S.",1,2,-1
19436,4115350138,QN, HAWTREE STREET,09,Q6,THE NEW YORK RACING ASSOCIATION INC,0,1,-1
19437,4142511609,QN,164 DRIVE,11,V0,L.O.G. PROPERTIES LLC,0,1,-1
19438,5078380053,SI,207 SPRAGUE AVENUE,01,A1,ALEXANDER J. TOTH JR,1,2,-1
19439,3056587502,BK,856 52ND STREET,04,RM,USA HUAMEI SANXIN TRADING LLC,1,2,-1
19440,4070440041,QN,82-76 165 STREET,01,A5,"CHOY, CHING FAI",2,3,-1
19441,2056260125,BX,66 REYNOLDS STREET,01,A2,KATHLEEN GREEN,1,2,-1
19442,4117960044,QN,135 PLACE,11,V0,"SEWNANON, HEMATT",0,1,-1
19443,4162440012,QN,557 BEACH 132 STREET,01,A2,MC GRORY THERESA,1,2,-1
19444,4120030023,QN,145 STREET,07,U9,NYC DEPARTMENT OF ENVIRONMENTAL PROTECTION,0,1,-1
19445,4007730148,QN,46 STREET,11,V0,CITY OF NEW YORK,0,1,-1
19446,4042310035,QN,127-14 23 AVENUE,01,B2,"GAO, XIAO HANG",1,2,-1
19447,4157130050,QN, BEACH CHANNEL DRIVE,10,G0,"AUGUERA, REYNA",0,1,-1
19448,3058510060,BK,447 SENATOR STREET,01,B2,WU XI HUI,2,3,-1
19449,4162900080,QN, CHANNEL ROAD,11,V0,NATIONAL PARK SERVICE,0,1,-1
19450,2059290047,BX,4663 PALISADE AVENUE,01,A1,"DONG, BIN",1,2,-1
19451,5077100526,SI,430 RICHARD AVENUE,01,A0,"BUNGAY, EUGENE",1,2,-1
19452,4155430060,QN,11-57 NEILSON STREET,10,G0,CLAYTON MORGAN,0,1,-1
19453,4155700023,QN,7-48 CORNAGA COURT,01,A1,"EDELSTEIN , ADINA",1,2,-1
19454,4126750012,QN,120-10 194 STREET,01,B1,"SINCHI, LUIS F",0,1,-1
19455,4126750059,QN,193 STREET,07,U9,NYC DEPARTMENT OF ENVIRONMENTAL PROTECTION,0,1,-1
19456,3083690351,BK,7005 AVENUE N,01,B2,"LAURAIN-BYRNES, NICOLE",1,2,-1
19457,4156210144,QN,385 BEACH 13 STREET,01,B2,"KORMAN, BENJAMIN",1,2,-1
19458,4128600056,QN,121-24 234 STREET,01,A2,ATKINSON ANDREW,1,2,-1
19459,4128690054,QN,128 DRIVE,07,U9,NYC DEPARTMENT OF ENVIRONMENTAL PROTECTION,0,1,-1
19460,4130200042,QN,180-19 140 AVENUE,01,B1,"LEWIS, DIONNE SAMANTHA",1,2,-1
19461,4013520055,QN,72-02 74 STREET,01,B2,ESNEDA CESPEDES,1,2,-1
19462,3005000001,BK,92 HAMILTON AVENUE,11,V9,NYC ECONOMIC DEVELOPMENT CORPORATION,0,1,-1
19463,4131380012,QN,224 STREET,10,G0,"MIDDLETON-LEWIS, CATHY",0,1,-1
19464,4013970005,QN,85-08 31 AVENUE,01,B3,CAJELI NARCISA,1,2,-1
19465,3064180050,BK,7 AVENUE,09,Q1,UNITED STATES ARMY,0,1,-1
19466,4016030058,QN, ALSTYNE AVENUE,10,G0,GUILLERMO IDARRAGA,0,1,-1
19467,5006540055,SI, ONTARIO AVENUE,11,V0,JOSEPH & MARYANN GRANELLO,0,1,-1
19468,3008440030,BK,57 STREET,10,G7,CHEN'S MANAGEMENT COMPANY INC,0,1,-1
19469,4159050283,QN,64-23 OCEAN AVENUE SOUTH,01,B2,"SEMPER, MELVINA",1,2,-1
19470,3009030365,BK,39 STREET,10,G7,"CHOU, BEN SHIH PIN",0,1,-1
19471,4017100032,QN,33-40 96 STREET,02,C0,"PEREZ, JACQUELINE A",1,2,-1
19472,3010160038,BK,360 10 STREET,05,K1,HWZ,0,1,-1
19473,4163500358,QN, ROCKAWAY POINT BLVD,11,V0,NYC DEPARTMENT OF CITYWIDE ADMINISTRATIVE SERVICES,0,1,-1
19474,4150060055,QN,145 ROAD,10,G7,EAST CANYON LLC,1,2,-1
19475,4160660040,QN,72-24 THURSBY AVENUE,,Z9,"POEHLMAN, JOSEPH",0,1,-1
19476,4160920096,QN,173 SCHOONER STREET,01,B2,"DIRESTO, GLENN",1,2,-1
19477,5074000050,SI,638 SHARROTTS ROAD,06,E9,AC DESIGN PROPERTY AND EQUIPMENT CORP,0,1,-1
19478,5070940070,SI,16 BERKSHIRE LANE,01,A5,"BARRERA, GEORGE R",1,2,-1
19479,4162770027,QN,161 BEACH 132 STREET,01,B3,GIRLANDO NANCY,1,2,-1
19480,4158390051,QN,335 BEACH 47 STREET,10,G0,NYC HOUSING PRESERVATION AND DEVELOPMENT,0,1,-1
19481,4159050112,QN,188 WHITE SANDS WAY,01,B2,"NEGRON, STEVEN",1,2,-1
19482,4159050218,QN,156 BEACH 67 STREET,01,B2,"FISCHER, TROY D",1,2,-1
19483,4038990032,QN,89-39 70 DRIVE,01,A1,"WYMAN, SCOTT D",0,1,-1
19484,4041600050,QN,20 STREET,11,V1,20-24 119TH STREET LLC,0,1,-1
19485,5000690075,SI, VAN BUREN STREET,,Z9,"EVITON, INC",0,1,-1
19486,4160920070,QN,7016 CORAL REEF WAY,01,B2,"NYULASI, JENNIE M",1,2,-1
19487,4160920093,QN,183 SCHOONER STREET,01,B2,"LABORDE, GAMAL",1,2,-1
19488,5000390039,SI,28 HENDRICKS AVENUE,01,B2,"QIU LIN, GUO",0,1,-1
19489,3017710048,BK,123 PULASKI STREET,02,C1,123 PULASKI HOLDINGS LLC,1,2,-1
19490,4162270069,QN,174A BEACH 118 STREET,10,G0,"FUSCO, VINCENT",0,1,-1
19491,4162280067,QN,168 BEACH 119 STREET,02,C0,"LI, LINA",2,3,-1
19492,4162290046,QN, OCEAN PROMENADE,11,V0,"REI, CAROLINE",0,1,-1
19493,5000390045,SI,117 BENZIGER AVENUE,01,B2,"SKLIAR, DMITRI",0,1,-1
19494,3017810054,BK,289 KOSCIUSZKO STREET,11,V0,289 KOSCIUSKO ST LLC,0,1,-1
19495,5001010646,SI,89 VALENCIA AVENUE,01,A2,"THE BARBARA STACK IRREV TRUST DATED JAN 16, 2018",1,2,-1
19496,3083660083,BK,6637 AVENUE N,01,A9,"SARANITI, ANTHONY  J",1,2,-1
19497,5000490157,SI, WESTERVELT AVENUE,10,G0,222 WESTERVELT AVE LLC,0,1,-1
19498,5001490181,SI,25 PELTON AVENUE,01,B2,"WILMINGTON SAVINGS FUND SOCIETY, FSB",1,2,-1
19499,4024320009,QN,69-02 QUEENS BOULEVARD,11,V1,QB DEVELOPMENT OWNER LLC,1,2,-1
19500,3067050150,BK,1209 AVENUE J,05,K2,RUBKIZ LLC,1,2,-1
19501,3020010050,BK, ASHLAND PLACE,07,U0,ALABI JIMOH A,0,1,-1
19502,4025640010,QN,49 STREET,10,G7,WEST MASPETH REALTY LTD.,0,1,-1
19503,5001140085,SI,55 OXFORD PLACE,02,C0,GREICO FAMILY PREMISES TRUST,1,2,-1
19504,5001150080,SI,377 VICTORY BOULEVARD,02,C0,MUHAREM DURAKOVIC,1,2,-1
19505,4160920059,QN,6914 CORAL REEF WAY,01,B2,UNAVAILABLE OWNER,1,2,-1
19506,4026490063,QN,56 STREET,07,U7,LIRR,0,1,-1
19507,5002200093,SI,867 FOREST AVENUE,01,B1,FORET JARDIN CORP,1,2,-1
19508,3082780171,BK,EAST 95 STREET,11,V0,"CARTER, ALPHA",0,1,-1
19509,4161100068,QN,315 BEACH 84 STREET,01,B1,GOTHAM BEACH 84 LLC,1,2,-1
19510,5002490050,SI,27 UNIVERSITY PLACE,01,A1,PAUL MCDONALD,1,2,-1
19511,5002540191,SI,44 PARK COURT,01,A1,ROSE ANN FRIEDMAN,1,2,-1
19512,5002540244,SI, ROSE COURT,11,V0,GARCIA PETER,0,1,-1
19513,3029270168,BK,300 MASPETH AVENUE,06,E9,ROADWAY PACKAGE SYSTEMS INC,3,4,-1
19514,4005330013,QN,31 ROAD,10,G0,KULWANT DEOL,0,1,-1
19515,5003460272,SI,133 STURGES STREET,02,C3,ROBERT ROTELLI,2,3,-1
19516,5003580056,SI, COLLEGE AVENUE,11,V0,REGINA M PALEAU,0,1,-1
19517,4046300022,QN,145-38 19 AVENUE,01,A1,"BISCIOTTI, VINCENT A",1,2,-1
19518,3031450103,BK,18 FORREST STREET,01,B1,"DE JESUS, MYRIAM",1,2,-1
19519,5070200105,SI,14 DEXTER AVENUE,01,A5,PAUL HANSEN,1,2,-1
19520,4028050016,QN,74-16 GRAND AVENUE,06,F9,74-16 GRAND AVENUE LLC,1,2,-1
19521,5000370015,SI, WINTER AVENUE,11,V0,TERRY TROIA,0,1,-1
19522,4086680213,QN,87 DRIVE,11,V0,HENRY R. MORALES,0,1,-1
19523,4029240005,QN,61-69 69 STREET,01,A5,FILIPPO CANE,1,2,-1
19524,5004750084,SI,344 CRYSTAL AVENUE,01,A2,"ROTONDO, LOUIS",1,2,-1
19525,5003420075,SI, KNOX PLACE,10,G0,JAMES COSTELLO,0,1,-1
19526,3034470100,BK, MOFFAT STREET,07,U6,CONRAIL,0,1,-1
19527,5005100043,SI,10 CONGRESS STREET,07,G2,DOWNTOWN GARAGE LLC,1,2,-1
19528,3080200066,BK,EAST 84 STREET,01,Z0,SATTI REALTY LLC,0,1,-1
19529,3034880017,BK,25 SUNNYSIDE AVENUE,11,V0,25 SUNNYSIDE LLC,0,1,-1
19530,5005560130,SI,40 HILL STREET,01,A5,"MONIR, MOHAMMAD DOBIR",1,2,-1
19531,5005750017,SI,212 VICTORY BOULEVARD,02,C2,VICTORY ISLAND GROUP INC.,2,3,-1
19532,3047510036,BK,9102 AVENUE A,01,B1,JANET A JOHNSON,1,2,-1
19533,5046800032,SI,518 TARRYTOWN AVENUE,01,A5,"MAXWELL, OKSANA",1,2,-1
19534,5006500026,SI,531 VANDERBILT AVENUE,01,B2,"LI, LIANG YU",0,1,-1
19535,3017530132,BK, SANDFORD STREET,,Z9,DJORDJE GAJEVIC,0,1,-1
19536,5007260063,SI,114 PERRY AVENUE,01,A1,"IVANICKI, NICHOLAS",1,2,-1
19537,5000280069,SI,24 CRESCENT AVENUE,01,A1,MICHELLE E,1,2,-1
19538,4162610048,QN,410 BEACH 139 STREET,01,B3,SIRGIOVANNI  RICHARD,1,2,-1
19539,5000730132,SI,133 HENDERSON AVENUE,01,B2,"REYES, NICHOLAS",1,2,-1
19540,3043180032,BK,437 DE WITT AVENUE,08,N9,DEWITT SUPPORTIVE HOUSING LP,0,1,-1
19541,5003940078,SI,555 COLLEGE AVENUE,01,B2,CLIFFORD GARRETT,1,2,-1
19542,5002300127,SI,34 ARCADIA PLACE,01,B2,"JARECKI, MARCIN",1,2,-1
19543,5004380040,SI,292 WILLARD AVENUE,01,B3,"MONDELLO, FRANK JR",1,2,-1
19544,5009500108,SI,54 SUMMIT AVENUE,01,B3,JOHN BISCUTI,1,2,-1
19545,4032940051,QN, QUEENS BOULEVARD,10,G0,"BROWN, JONATHAN R",0,1,-1
19546,4032950051,QN, UNION TURNPIKE,10,G0,"MALACH, ABRAHAM",0,1,-1
19547,5002450068,SI,120 CHESHIRE PLACE,01,A0,BARBARA MATTIA,2,3,-1
19548,4159050023,QN,63-19 OCEAN AVENUE SOUTH,01,B2,"ELLER, ROGER",1,2,-1
19549,4034850038,QN,2061 GATES AVENUE,04,S5,ABA III LLC,1,2,-1
19550,4035190033,QN, METROPOLITAN AVENUE,10,G7,"MOUNT SINAI PROPERTIES, INC.",0,1,-1
19551,3048270024,BK,324 WINTHROP STREET,10,G6,BENEFICIAL FUND FOR THE DOWNSTATE MEDICA L CENTER O,0,1,-1
19552,5069790114,SI,32 MORENO COURT,01,B9,"ESPOSITO, ANTHONY",1,2,-1
19553,5005560162,SI,41 SUSAN COURT,01,A5,DAWN MORGAN,1,2,-1
19554,5006020064,SI,1 DUDLEY AVENUE,01,A2,"MCDONALD, DAVID",1,2,-1
19555,3077650026,BK,1151 EAST 39 STREET,02,C0,"ST. FLEUR, PATRICK",1,2,-1
19556,5020000137,SI,40 MONARCH COURT,01,A5,"MAZZONE, ROSANNA",1,2,-1
19557,5052450038,SI,25 HILLCREST AVENUE,01,B9,KRZYSZTOF BAJEK,1,2,-1
19558,5021150134,SI,73 PLYMOUTH ROAD,01,B9,"MACK, ROBERT",1,2,-1
19559,5022360145,SI,24 DANNY COURT,01,A5,"LIM, FLORENCE",1,2,-1
19560,5023900335,SI,343 KLONDIKE AVENUE,01,A5,"D'AMBRA, MASSIMO",1,2,-1
19561,3076940008,BK,3201 AVENUE P,01,B1,DOODNAUTH BISNATH,1,2,-1
19562,4039160026,QN,121 STREET,11,V0,NYC DEPARTMENT OF CITYWIDE ADMINISTRATIVE SERVICES,0,1,-1
19563,3042700028,BK,1376 SUTTER AVENUE,10,G0,"GUZMAN, MANUEL",0,1,-1
19564,5028990200,SI,45 GEO COURT,01,A5,"WONG, YIK TAK ALTAK",1,2,-1
19565,5029740013,SI, FLETCHER STREET,11,V0,"GIFFEN, RAYMOND JR",0,1,-1
19566,5006220071,SI,72 PLEASANT VALLEY AVE,01,A1,ANGEL ORTIZ,1,2,-1
19567,5001680082,SI,723 FOREST AVENUE,05,K1,"ARISTERA PROPERTIES, LLC",0,1,-1
19568,4042020001,QN,127 STREET,07,U2,"CONSOLIDATED EDISON CO.OF N.Y.,INC.",0,1,-1
19569,3035220032,BK,120 THATFORD AVENUE,05,H2,SUNRAISE EQUITY GROUP LLC,0,1,-1
19570,3079320207,BK, PRESTON COURT,,Z9,CAPTAIN HOLDINGS CORP.,0,1,-1
19571,5032920048,SI,29 ATLANTIC AVENUE,01,B2,"YE, JUI WEN",1,2,-1
19572,5032990005,SI,1504 RICHMOND ROAD,05,O7,NST REALTY LLC,1,2,-1
19573,3055100036,BK,1670 59 STREET,02,C0,"PERLSTEIN, YITZCHOK",0,1,-1
19574,3079670039,BK,8815 BEDELL LANE,01,B1,HENRY W KENNEDY,2,3,-1
19575,5002540273,SI,50 ROSE COURT,01,A1,"TREZZINO, THOMAS",1,2,-1
19576,5033600037,SI,192 EVERGREEN AVENUE,01,B2,LJIKOVIC IDRIZ,1,2,-1
19577,5033770060,SI, ALTER AVENUE,11,V0,"CARONE, NATALIE A",0,1,-1
19578,5001850177,SI,1689 RICHMOND TERRACE,06,E1,RUCCI OIL CO INC,1,2,-1
19579,5033950045,SI,279 QUINTARD STREET,01,A5,"ZHENG, ZONGGIAO",0,1,-1
19580,5007470014,SI,18 CRAFTON AVENUE,01,A1,"DOSCHER, ANNE MARIE",1,2,-1
19581,5035360068,SI, LIBERTY AVENUE,11,V0,MARIA T SEAMAN,0,1,-1
19582,3032650014,BK,50 STANHOPE STREET,02,C2,50 STANHOPE DEVELOPMENT LLC,1,2,-1
19583,5035600018,SI,215 HULL AVENUE,01,A2,HENRY GWASDA,1,2,-1
19584,3056200018,BK,1030 46 STREET,01,B3,HERSH ROSNER,1,2,-1
19585,5038730060,SI, HEMPSTEAD AVENUE,11,V0,UNAVAILABLE OWNER,0,1,-1
19586,3057690036,BK,67 STREET,11,V0,"APESA, FRANK",0,1,-1
19587,5040370079,SI,169 TITUS AVENUE,01,A5,"LIU, WILSON",0,1,-1
19588,3084720062,BK,1852 MADISON PLACE,01,A9,"KINSBERG, ARI",1,2,-1
19589,5042740123,SI,150 PETER AVENUE,01,A2,"NELSON, AS TRUSTEE, BRUCE A",1,2,-1
19590,5043130043,SI, CRANFORD AVENUE,01,Z0,"MACK, ROBERT",0,1,-1
19591,4046140001,QN,14-44 BURTON STREET,01,A2,"LAPUMA, MABELLE",1,2,-1
19592,5001980202,SI, BARKER STREET,11,V0,UNAVAILABLE OWNER,0,1,-1
19593,5044680069,SI,338 CLARKE AVENUE,01,A1,"KOKAKIS, JAMES",1,2,-1
19594,5051470001,SI,121 CLEVELAND AVENUE,08,M1,CHRIST LUTHERAN CHURCH,2,3,-1
19595,5009050001,SI,900 TODT HILL ROAD,09,Q5,NYS DEPARTMENT OF ENVIRONMENTAL CONSERVATION,1,2,-1
19596,5052680183,SI,185 RIDGECREST AVENUE,01,B2,WIMAN BUILDING CORP.,1,2,-1
19597,3031700009,BK,1157 MYRTLE AVENUE,04,C7,1157 MYRTLE LLC,0,1,-1
19598,3073000002,BK,2106 AVENUE S,01,A9,ROBYN SHMOEL,1,2,-1
19599,5054940106,SI, CORTELYOU AVENUE,11,V0,UNAVAILABLE OWNER,0,1,-1
19600,4046510025,QN,17-34 149 STREET,01,B2,EUROLENDING INC.,1,2,-1
19601,5003180029,SI,782 CURTIS AVENUE,01,B2,TDF CURTIS LLC,1,2,-1
19602,5003290005,SI,57 SANFORD PLACE,01,A1,WILLIAM MEYER,1,2,-1
19603,5003640001,SI,196 COLLEGE AVENUE,01,A1,"AMENO, MICHAEL",1,2,-1
19604,3065300057,BK,1069 EAST 9 STREET,01,A1,GALAPO ALBERT,2,3,-1
19605,4155660050,QN,BEACH 19 STREET,10,G7,CHURCH CHARITY CORP,0,1,-1
19606,4090450130,QN,98-03 97 AVENUE,06,E1,"AIOSA, SANDRO",1,2,-1
19607,3070000050,BK,3725 NEPTUNE AVENUE,01,B2,BELLA SHABASHEV,1,2,-1
19608,5064690014,SI, COMMUNITY LANE,11,V1,NYC DEPARTMENT OF PARKS AND RECREATION,0,1,-1
19609,4155030088,QN,11-46 BRUNSWICK AVENUE,01,B3,GARNOY REVOCABLE TRUST DATED 12/24/2018,1,2,-1
19610,5066940100,SI, TRENTON COURT,11,V0,"PRINCESS BAY BOATMEN'S ASSOCIATION, INC",0,1,-1
19611,3029270310,BK, REWE STREET,,Z9,A & I REALTY CORP,0,1,-1
19612,5010800025,SI,16 HARRISON AVENUE,01,A1,D'ANNA KENNETH,1,2,-1
19613,5003910304,SI,521 COLLEGE AVENUE,10,G0,SUTER KARL,0,1,-1
19614,4008960217,QN,18-14 21 ROAD,01,B3,HARRY G SERGIOU,1,2,-1
19615,5069790280,SI,50 SANTA MONICA LANE,01,B9,DORFMAN ALEKSANDR,1,2,-1
19616,5010940018,SI,117 BLACKFORD AVENUE,01,B2,"ANDRUZZI, LOUIS",1,2,-1
19617,3054420032,BK,47 STREET,10,G0,ARNOLD FISCHMAN,0,1,-1
19618,3046450031,BK,336 EAST 91 STREET,02,C3,"LAWRENCE, ALISTER",1,2,-1
19619,5072670298,SI,11 JADE COURT,01,A5,"SEBINIANO, SARINA",1,2,-1
19620,3065910020,BK,1436 EAST 10 STREET,01,A3,"ROMANO, TEDDY",1,2,-1
19621,4011010024,QN,24-25 89 STREET,10,G0,"GULINO, ANTHONY",1,2,-1
19622,5077920279,SI,390 PAGE AVENUE,11,V0,7792 PARTNERS LLC,0,1,-1
19623,2059330012,BX,5441 PALISADE AVENUE,01,A3,NIKITAS DRAKOTOS,1,2,-1
19624,4091190158,QN,103-23 96 STREET,01,B1,"ZHENG, CHENG PENG",0,1,-1
19625,4012130009,QN,58-07 39 AVENUE,01,B2,"INGA, JOSE S",1,2,-1
19626,5006500001,SI,1037 VAN DUZER STREET,01,A1,"POPOVIC, DANIJEL",0,1,-1
19627,4012950044,QN,63-29 TRIMBLE ROAD,01,B1,PAUL J KWAN,1,2,-1
19628,4059630051,QN,26-21 172 STREET,01,A1,"DIRADO, IDA",1,2,-1
19629,4063050013,QN,42-16 215 PLACE,01,B3,ZIMMERMAN CHARLES,2,3,-1
19630,4068660385,QN,169 STREET,11,V0,SAINT JOHN'S CEMETARY,0,1,-1
19631,4015100013,QN,89-22 ROOSEVELT AVENUE,04,K4,"JANE HO REALTY, INC",1,2,-1
19632,3044520215,BK,1228 JEROME STREET,01,A5,NEHEMIAH SPRING CREEK AFFORDABLE HOMEOWN ERSHIP,1,2,-1
19633,5012630013,SI,89 ARLINGTON AVENUE,01,B3,"ABIODUN-ADELOKIKI, TITILOLA",1,2,-1
19634,5012900260,SI,446A WOODCLIFF AVENUE,06,E1,"FOREST MANAGEMENT, LL",0,1,-1
19635,1007860051,MN,498 7 AVENUE,05,O4,498 SEVENTH LLC,1,2,-1
19636,1007870040,MN,500 7 AVENUE,05,O6,500 SEVENTH AVENUE,1,2,-1
19637,4153760888,QN, CROSS BAY BOULEVARD,11,V0,NATIONAL PARK SERVICE,0,1,-1
19638,3026540028,BK,205 NASSAU AVENUE,04,S5,NASSAU 205 LLC,1,2,-1
19639,1008960030,MN,238 EAST 15TH STREET,08,M4,SYNAMON GLOBAL LLC,1,2,-1
19640,4072130020,QN,75-46 197 STREET,01,B1,"MOY, PETER",1,2,-1
19641,4072140018,QN,75-28 198 STREET,01,B1,"LAM, KEVIN",1,2,-1
19642,5014780166,SI,142 WILLOWBROOK ROAD,01,A5,"ANDES, CATALINO A JR.",1,2,-1
19643,5015080097,SI,26 TREMONT AVENUE,01,A2,"VIERA, RICARDO",1,2,-1
19644,4017860011,QN,112-24 39 AVENUE,02,C0,112-28 39TH AVENUE LLC,2,3,-1
19645,1019690006,MN,487 WEST 129 STREET,11,V1,UNAVAILABLE OWNER,0,1,-1
19646,5066660083,SI,22 NAVIGATOR COURT,01,A5,FEDERAL NATIONAL MORTGAGE ASSOCIATION,1,2,-1
19647,5016580117,SI,203 ADA DRIVE,01,B2,"STRUG, KAZIMIERZ",1,2,-1
19648,2023570040,BX,651 RIVER AVENUE,07,G9,BTM MANAGEMENT CO,3,4,-1
19649,5016850121,SI,14 AMITY PLACE,01,B2,"HERNANDEZ, JUAN",1,2,-1
19650,3034690047,BK,59 DE SALES PLACE,07,G2,"HERNANDEZ, LESLIE VICTORIA",0,1,-1
19651,3070710231,BK,WEST 23 STREET,09,Q1,NYC DEPARTMENT OF CITYWIDE ADMINISTRATIVE SERVICES,0,1,-1
19652,4075280035,QN,221-54 58 AVENUE,01,B2,"HUNG, FAI",1,2,-1
19653,5020000152,SI,42 PERSIMMON LANE,01,A5,"LEE, KENNY",1,2,-1
19654,4023180034,QN,47-08 58 LANE,01,A1,"SMITH, JOAN C",1,2,-1
19655,3055010059,BK,2137 58 STREET,01,B1,"DEUTSCH, SAUL",1,2,-1
19656,3079320279,BK, PRESTON COURT,,Z9,1011 EAST 46TH STREET CORP.,0,1,-1
19657,4079990002,QN,93-16 240 STREET,01,A1,"PIERRE,   KARL",1,2,-1
19658,5021510020,SI,167 DAWSON CIRCLE,01,B2,"CENOBAFTO, ILMI",1,2,-1
19659,2033300044,BX,411 EAST 202 STREET,02,C0,"SARKISSIAN, MAURICE M",1,2,-1
19660,5005400118,SI,73 GORDON STREET,01,B9,"SHAO, YUN DUAN",0,1,-1
19661,4081110112,QN, DOUGLASTON PARKWAY,10,G0,ZION EPISCOPAL CHURCH,0,1,-1
19662,4081220025,QN,248-08 41 AVENUE,01,A1,"SCHLESINGER, ALICIAL",1,2,-1
19663,4081290157,QN,43-20 CORNELL LANE,10,G0,THE LIVING TRUST OF IRENE F SINKINSON,0,1,-1
19664,3046140066,BK,123 EAST 95 STREET,02,C3,"FORD, PAMELA",1,2,-1
19665,3072120103,BK, DANK COURT,11,V0,BEACH HAVEN GROUP LLC,0,1,-1
19666,3052300019,BK,561 EAST 28 STREET,01,A1,"ROBINSON, CUTHBERT L",2,3,-1
19667,1019390030,MN,2262 ADAM C POWELL BLVD,02,C4,WESTON HOUSE HSNG/DVLP/F,2,3,-1
19668,5069790308,SI,161 EL CAMINO LOOP,01,B9,FENG LIN,1,2,-1
19669,5069070037,SI,182 FOSTER ROAD,01,B2,THE PHYLLIS MINACAPILLI IRREVOCABLE TRUS T,0,1,-1
19670,2039790007,BX, ZEREGA AVENUE,10,G0,BACLIG VISITACION,0,1,-1
19671,5002850016,SI, PELTON AVENUE,07,U2,BROOKLYN UNION,0,1,-1
19672,3073150071,BK,2343 CONEY ISLAND AVE,04,S2,2341-2343 CONEY ISLAND AVE. LLC,1,2,-1
19673,2040530032,BX,1864 WALLACE AVENUE,02,C1,"KINAJ, LULASH",2,3,-1
19674,4083060057,QN,245-61 63 AVENUE,01,A0,"SONIGO, JEAN-LUC",2,3,-1
19675,2042640024,BX, MULINER AVENUE,10,G0,"DEL VALLE, JOSEPH CARL",0,1,-1
19676,1012370033,MN,618 AMSTERDAM AVENUE,04,D6,"HITCHCOCK PLAZA, INC.",1,2,-1
19677,3073360154,BK, HARING STREET,11,V1,HARING LLC,0,1,-1
19678,5003320179,SI,159 DRAKE AVENUE,01,A1,"MARKOVICS, DIANE",2,3,-1
19679,4036000092,QN,74-23 65 STREET,01,B1,"HELMER, IRENA",1,2,-1
19680,5003460099,SI,114 FAIRVIEW AVENUE,01,A1,EDWARD MAYROSE,1,2,-1
19681,2046890021,BX,EAST 218 STREET,10,G0,THE SARAH BURNEY FAMILY TRUST,0,1,-1
19682,5064310100,SI, DISCALA LANE,,Z7,UNAVAILABLE OWNER,0,1,-1
19683,4159050230,QN,149 OCEAN LANE,01,B2,"HUTCHINSON, SCOTT",1,2,-1
19684,2047620010,BX,3077 FENTON AVENUE,01,B3,"MCKOY, GARVEL",1,2,-1
19685,4074940010,QN, HORATIO PARKWAY,09,Q2,NYC DEPARTMENT OF PARKS AND RECREATION,0,1,-1
19686,2048990037,BX,1211 EAST 224 STREET,01,B1,MAITLAND JOYCE,1,2,-1
19687,3032750003,BK,307 EVERGREEN AVENUE,,Z9,"VOLQUEZ, MANUEL",0,1,-1
19688,2049630039,BX,2202 STRANG AVENUE,02,C0,MARVALYN D WALTERS,1,2,-1
19689,2049690038,BX, SECOR AVENUE,01,Z0,"OSUJI, ROSE C",0,1,-1
19690,4090320031,QN,95-15 92 STREET,01,B9,"CHEN, YUN PING",1,2,-1
19691,5028990137,SI,121 MOSEL AVENUE,01,A5,VELEZ FRANK A,1,2,-1
19692,2050670012,BX,4426 CARPENTER AVENUE,01,A1,"GUZMAN, CRISTINA",1,2,-1
19693,3029430025,BK, METROPOLITAN AVENUE,07,U1,NYS DEPARTMENT OF TRANSPORTATION,0,1,-1
19694,2052500017,BX,3329 PROVOST AVENUE,11,V1,G.B. RUSSO CORP.,0,1,-1
19695,4038050038,QN,77-20 80 STREET,06,E1,"71-20 80TH STREET, L.L.C.",1,2,-1
19696,5029060033,SI,733 TARGEE STREET,01,B2,733 TARGEE LLC,1,2,-1
19697,5029880044,SI,40 FLETCHER STREET,01,B2,"GIORDANO, JOHN",2,3,-1
19698,2054130114,BX, MIDDLETOWN ROAD,11,V0,ARMANDO TELLEZ,0,1,-1
19699,4039590008,QN,6-11 129 STREET,01,B3,"ROSE, WAYNE R",1,2,-1
19700,4160340055,QN,BEACH 67 STREET,11,V0,NAOMI HARTLEY,0,1,-1
19701,4136600115,QN, CRAFT AVENUE,11,V0,NYC DEPARTMENT OF CITYWIDE ADMINISTRATIVE SERVICES,0,1,-1
19702,3077430001,BK,3923 AVENUE I,01,A9,NOBLE FREDERICK,1,2,-1
19703,5030730161,SI, WADSWORTH AVENUE,10,G0,MICHAEL GIORDANO,0,1,-1
19704,5031020107,SI,62 SAVO LANE,01,A5,LIXIA LI,1,2,-1
19705,2056070049,BX, ROBINSON AVENUE,10,G0,"TANG, CHENG",0,1,-1
19706,3013430038,BK,1790A PACIFIC STREET,10,G7,"ATLANTIC PROPERTIES I, LLC",0,1,-1
19707,3078630002,BK,3921 QUENTIN ROAD,01,A9,"CALANGI, ESTELA",1,2,-1
19708,4094200011,QN,101-15 102 STREET,01,B2,RAMUDIT  KUMAR,1,2,-1
19709,5008240066,SI,454 BRADLEY AVENUE,,Z9,"MATHAI, VARUGHESE",0,1,-1
19710,2056540251,BX,3476 EASTCHESTER PLACE,10,G0,CHIRICO ROSA,0,1,-1
19711,5031230019,SI,93 ALEX CIRCLE,01,A5,JOZEF KADZIELAWSKI,1,2,-1
19712,5008530039,SI, OVERLOOK AVENUE,10,G0,"CORRALES, NICOLE A",0,1,-1
19713,2059260297,BX, PALISADE AVENUE,01,Z0,ARIELA SCHILLER,0,1,-1
19714,3001990001,BK,42 FURMAN STREET,11,V1,NYC DEPARTMENT OF SMALL BUSINESS SERVICES,0,1,-1
19715,4094680019,QN,97-30 126 STREET,01,A1,"PERSAUD, VASHA",1,2,-1
19716,3003840051,BK,61 WYCKOFF STREET,01,A9,"SMITH, SARAH C",1,2,-1
19717,5036160029,SI,255 BANCROFT AVENUE,01,A2,"MACK , LUCILLE",1,2,-1
19718,5036660029,SI,257 JEFFERSON AVENUE,05,K1,RALPH HOLG LLC,1,2,-1
19719,4095040004,QN,100-12 103 AVENUE,02,C1,100TH STREET 103RD AVENUE INC,3,4,-1
19720,4136270062,QN,142-33 HOOK CREEK BOULEVARD,01,B3,EXPLORERS CONTRACTING LLC,1,2,-1
19721,3025500008,BK,176 FRANKLIN STREET,04,S2,"DZIEDZIK, ANDRZEJ",1,2,-1
19722,3087530091,BK,165 JAFFRAY STREET,01,A1,"USPENSKY, ARTHUR",1,2,-1
19723,4051490043,QN,137-63A KALMIA AVENUE,10,G0,"MARGHOOB, AMNA D",1,2,-1
19724,4051750038,QN,148 STREET,10,G0,"LIN, WEN",0,1,-1
19725,4000310010,QN,5-39 49 AVENUE,01,B3,"ROGERS, BRIAN J",1,2,-1
19726,4052510014,QN,33-55 166 STREET,01,A1,"LI, JINGYU",1,2,-1
19727,5063240138,SI,258 DOWNES AVENUE,01,A3,JOSEPH DELDUCA,1,2,-1
19728,3049950001,BK,586 EAST 32 STREET,11,V0,3121 FARRAGUT LLC,1,2,-1
19729,5037400006,SI,497 LINCOLN AVENUE,01,A5,"CHEN, WEI",0,1,-1
19730,4007590051,QN,22-38 48 STREET,02,C0,LUIGI VOZZO,1,2,-1
19731,3022450062,BK,45 WALTON STREET,11,V1,WALTON PARTNERS LLC,0,1,-1
19732,4054400083,QN,161-07 46 AVENUE,02,C0,UNAVAILABLE OWNER,0,1,-1
19733,4054600039,QN,46-12 162 STREET,01,B2,4616 MANAGEMENT LLC,1,2,-1
19734,4008740145,QN,21-21 24 DRIVE,01,A5,"MILLER, RICHARD",1,2,-1
19735,3017700048,BK,76 HART STREET,02,C2,UNAVAILABLE OWNER,0,1,-1
19736,3023360014,BK,174 NORTH 6 STREET,02,C2,174 N6 TREASURE LLC,1,2,-1
19737,3017657501,BK,442 WILLOUGHBY AVENUE,02,R6,UNAVAILABLE OWNER,1,2,-1
19738,3083690403,BK,1361 EAST 69 STREET,01,B2,"FEYNBERG, ALEKSANDR",1,2,-1
19739,4081290065,QN,252-11 NORTHERN BOULEVARD,05,K1,NORTHERN LOTS LLC,1,2,-1
19740,4101120063,QN,150 STREET,11,V1,ELMHURST DAIRY HOLDINGS LLC,0,1,-1
19741,4011070035,QN,96-11 25 AVENUE,01,B1,PETRA COX,1,2,-1
19742,3017587501,BK,56 VERNON AVENUE,02,R1,UNAVAILABLE OWNER,0,1,-1
19743,4082110001,QN,52-03 OVERBROOK STREET,01,A1,RUSSO ANGELO,1,2,-1
19744,5003650148,SI,32 MAINE AVENUE,01,A1,ALVAN M. VANGER,1,2,-1
19745,3005870012,BK,97 DIKEMAN STREET,04,S1,JUAN BOSCO SODI AMBROSI,0,1,-1
19746,4082330434,QN,50-11 MORENCI LANE,01,A2,"RAH, BYUNG HO",2,3,-1
19747,5040370180,SI,177 TITUS AVENUE,01,A5,CHIN HUN CHONG,0,1,-1
19748,5005790072,SI,182 WARD AVENUE,01,B9,"PARKER , STEPHEN",1,2,-1
19749,5041920018,SI,24 2 STREET,01,B2,ZHANG PROPERTY S.I. LLC,0,1,-1
19750,4088010056,QN,85-50 259 STREET,01,A0,"CHRENC, CAROL A",1,2,-1
19751,5011700020,SI,283 GRANITE AVENUE,01,B2,"YE, XUE LING",0,1,-1
19752,3000860011,BK,175 ADAMS STREET,03,D4,CONCORD VILLAGE OWNERS INC,7,8,-1
19753,5010080049,SI, JEWETT AVENUE,11,V1,MASSIMILIANO MANNINO,0,1,-1
19754,4019940018,QN,50-12 108 STREET,10,G7,FEDERICI ANTHONY,0,1,-1
19755,4104740312,QN,199-09 JAMAICA AVENUE,05,K1,ZEIS REALTY LLC,2,3,-1
19756,3004327501,BK,543 UNION STREET,06,RW,UNAVAILABLE OWNER,1,2,-1
19757,4022180021,QN,108-32 68 DRIVE,08,W1,NYC DEPARTMENT OF EDUCATION,1,2,-1
19758,5004620072,SI,4 BRADLEY AVENUE,01,B2,DOREEN PERERA,1,2,-1
19759,5050920036,SI,261 DURANT AVENUE,01,A5,"ZHU, GUORONG",0,1,-1
19760,2056260232,BX,67 PELL PLACE,01,B3,CAREY EDWARD J,1,2,-1
19761,4105830045,QN,88-35 208 STREET,01,A5,"RAMDEO, RAJKUMARI",2,3,-1
19762,5052120016,SI,20 ACKERMAN STREET,01,B2,"DONG, SHI XIONG",0,1,-1
19763,4046510024,QN,17-36 149 STREET,01,B2,EUROLENDING INC.,1,2,-1
19764,5062200040,SI,30 LORRAINE AVENUE,01,A5,HE YING XIN,1,2,-1
19765,3000540001,BK,87 JAY STREET,04,D6,"85 JAY STREET BROOKLYN, LLC",0,1,-1
19766,4108160041,QN,188-21 WOODHULL AVENUE,02,C0,"SHIH, WEI HAI",0,1,-1
19767,4026390014,QN,54-21 METROPOLITAN AVENUE,10,G1,5426 ARNOLD AVENUE LLC,1,2,-1
19768,5005690006,SI,96 ST PAULS AVENUE,01,A1,"PRICE, CYNTHIA",1,2,-1
19769,2057530130,BX, PALISADE AVENUE,07,U6,MTA - METRO NORTH,0,1,-1
19770,4026500005,QN,2-96 58 STREET,,Z9,"METROPOLITAN OVAL FOUNDATION, INC",1,2,-1
19771,4135940029,QN,141-09 250 STREET,01,B1,"JEAN-LOUIS, ROCHEL",1,2,-1
19772,4092790116,QN,86-03 125 STREET,02,C0,"LAL, MANOHAR",1,2,-1
19773,4026990006,QN,58-61 59 STREET,01,B3,DAVID ZAFFUTO,1,2,-1
19774,4027130010,QN, GRAND AVENUE,,Z9,"RUSSO, ANTONIO",0,1,-1
19775,5005750008,SI,55 WILLIS AVENUE,01,A5,"YOUNG, SIMON",1,2,-1
19776,5058030030,SI,1788 ARTHUR KILL ROAD,01,B9,NAVEEN I. GOBBA,1,2,-1
19777,4117210054,QN,115 STREET,10,G0,"RAMNAUTH, YOLANDE ZADICA",0,1,-1
19778,4090880001,QN,86-02 102 AVENUE,02,C0,"KHAN, MAHBUBUR R",1,2,-1
19779,4091350112,QN,80 STREET,11,V0,MICHELE BENEVENTI,0,1,-1
19780,4028440001,QN,59-01 74 STREET,01,B1,"LICATA, ANTONINO",1,2,-1
19781,5011170059,SI,130 NICHOLAS AVENUE,01,B2,DOROTHY D. NELSON,1,2,-1
19782,3050190005,BK,4403 GLENWOOD ROAD,07,G2,RUSS-DAUR PROPERTIES,1,2,-1
19783,3089320722,BK, EBONY COURT,10,G0,RASMUSSEN EDWARD,0,1,-1
19784,5062660013,SI, SHELDON AVENUE,11,V0,JOHN S RYAN,0,1,-1
19785,4033060029,QN, BEECHKNOLL AVENUE,10,G0,"SCHECHTER, JOANNE",0,1,-1
19786,4033370149,QN, AUSTIN STREET,10,G0,MASAMI HOSHINO,0,1,-1
19787,4033390026,QN,75 ROAD,10,G0,"111-02 75TH ROAD, LLC",0,1,-1
19788,4093010090,QN,111-01 91 AVENUE,01,B3,"THAKOORDYAL, BINA",1,2,-1
19789,4033920070,QN,19-09 LINDEN STREET,10,G0,JONEL MARINA,0,1,-1
19790,5065290053,SI, SHORE AVENUE,11,V0,GEORGE F FINGER,0,1,-1
19791,4035700003,QN, CYPRESS AVENUE,,Z9,CYPRESS MOTORS OF RIDGEWOOD INC,0,1,-1
19792,4035910031,QN,60-53 75 AVENUE,01,B2,PERRY PHYLLIS,1,2,-1
19793,3055000025,BK,57 STREET,01,B2,UNAVAILABLE OWNER,0,1,-1
19794,5065520017,SI, LOUISE STREET,11,V0,NYC DEPARTMENT OF ENVIRONMENTAL PROTECTION,0,1,-1
19795,5011710014,SI,49 RONALD AVENUE,01,B2,"DUGGAN, MICHAEL",1,2,-1
19796,2056530314,BX, FLINT AVENUE,11,V0,"WALCOTT, VERONICA S",0,1,-1
19797,3055917507,BK,1020 41 STREET,02,R1,UNAVAILABLE OWNER,1,2,-1
19798,4036620031,QN,71 STREET,10,G0,"CIUPINSKI, CZESLAW F",0,1,-1
19799,3086360043,BK,2309 EAST 64 STREET,01,A1,"HANNA, RAOUF RAMSIS",1,2,-1
19800,4037090051,QN,73-46 71 PLACE,01,A1,"ISLER, JORGE",1,2,-1
19801,4094460034,QN,94-14 131 STREET,01,A1,"RAGBIR, CAMILLE",1,2,-1
19802,5005360054,SI,26 GORDON STREET,01,B2,MATTHEW E CINTULA,1,2,-1
19803,4095900043,QN,105-66 131 STREET,01,A1,BASANT MOONASSAR,1,2,-1
19804,4117470001,QN, SUTTER AVENUE,11,V0,"RODRIGUEZ MENDOZA, LUIS ANTONIO",0,1,-1
19805,5069680047,SI,1090 SHELDON AVENUE,01,A5,"PAULIK, CAROL",1,2,-1
19806,4038410019,QN,77-24 86 STREET,01,A5,"MAZUREK, JOZEF",2,3,-1
19807,4038430054,QN,78-22 85 STREET,01,A9,"CORIBELLO, CYNTHIA",1,2,-1
19808,5069790312,SI,155 EL CAMINO LOOP,01,B9,"AGUGLIARO, MICHELANGELO",1,2,-1
19809,4096760049,QN,89-43 146 STREET,01,B3,JUAN & VICTORIA RODRIGUEZ,1,2,-1
19810,5070930050,SI,696 BLOOMINGDALE ROAD,01,B9,"DASARO, SEAN",1,2,-1
19811,4097080054,QN,139-63 87 AVENUE,01,A1,THERESE PARET,1,2,-1
19812,3061270013,BK, MARINE AVENUE,10,G0,JOSEPH KING YING HO,0,1,-1
19813,4097280015,QN,151-06 85 DRIVE,01,B2,"PANAGIOS, KONSTANTINA",1,2,-1
19814,5055230036,SI,305 GENESEE AVENUE,01,A2,ARTHUR AND JEANETTE S,1,2,-1
19815,5071050559,SI,29 PLUMTREE LANE,01,A5,"CAMPOSANO, VINCENZA",1,2,-1
19816,4099050064,QN,184-04 90 AVENUE,01,A1,"MARINO, ELVA",1,2,-1
19817,4099890090,QN,146 STREET,07,U7,LIRR,0,1,-1
19818,5071050565,SI,15 PLUMTREE LANE,01,B2,"VERGANELIS, NICOLE",1,2,-1
19819,3063940060,BK,BAY 10 STREET,11,V0,"YU, KWOK W",0,1,-1
19820,3063960002,BK,1569 BATH AVENUE,10,G0,CARMELO RE,0,1,-1
19821,4046300029,QN,145-50 19 AVENUE,01,B2,"DOURAKIS, FANI",1,2,-1
19822,5073170023,SI,22 MANDY COURT,01,B9,MICARA THERESA,1,2,-1
19823,4048930041,QN,29-12 163 STREET,01,A5,KELLY JAMES M,2,3,-1
19824,2055210169,BX,130 REYNOLDS AVENUE,09,Q8,NYC DEPARTMENT OF PARKS AND RECREATION,1,2,-1
19825,4050150048,QN,144-89 38 AVENUE,04,D6,38 AVENUE DEVELOPMENT REALTY LLC,1,2,-1
19826,4051750032,QN,148 STREET,10,G0,H WAHRBURG,0,1,-1
19827,4052510010,QN,33-65 166 STREET,01,A1,"NELIGAN, DIANE",1,2,-1
19828,4101610053,QN, GUY R BREWER BLVD,11,V2,VILLAGE PLAZA HOMES INC.,0,1,-1
19829,5075340157,SI,24 STATION AVENUE,01,A1,"BREDER, JOSEPH",1,2,-1
19830,4123300051,QN,114-38 167 STREET,01,A1,"KHANDAKER, GOLAM MOSTAFA",0,1,-1
19831,4123350201,QN,165-15 FOCH BOULEVARD,01,B1,HARVEY TAYLOR,1,2,-1
19832,4118760041,QN,135-10 134 PLACE,01,B3,"PAGAN, THELMA AILENE",1,2,-1
19833,5067430036,SI, EVERETT AVENUE,10,G0,"RUSSO, RONALD THOMAS",0,1,-1
19834,5013180215,SI,160 HOLLAND AVENUE,01,A5,"VAN EXEL, TERRANCE C",1,2,-1
19835,3067460005,BK,1710 AVENUE M,04,S2,"LARRY HOROWITZ, CO-TRUSTEE",1,2,-1
19836,5079400069,SI, CRAIG AVENUE,11,V0,"CORIO, CHRISTOPHER",0,1,-1
19837,5008580003,SI, RIDGE AVENUE,11,V0,"CONTI, MARY",0,1,-1
19838,4133460056,QN,146-09 181 STREET,01,B3,GEOHAGAN MITZIE D,1,2,-1
19839,3053470013,BK,38 STREET,10,G7,BZOB 39 LLC,0,1,-1
19840,5014670012,SI,247 WILLOWBROOK ROAD,01,A2,SCHWEIBINZ WILLIAM,1,2,-1
19841,2055310135,BX,942 REVERE AVENUE,01,A1,"TAVAREZ, LUZ M",2,3,-1
19842,4099020103,QN,91-28 183 STREET,01,B2,JODHA  MANIRAM,1,2,-1
19843,5014940050,SI,360 WILLOW ROAD WEST,02,C1,WILLOWBROOK APARTMENTS CORP,24,25,-1
19844,4100450010,QN,144-22 106 AVENUE,01,B2,"ISLAM, MOHAMMED SAHIDUL",0,1,-1
19845,4100690140,QN, LAKEWOOD AVENUE,11,V0,CMJ QUEENS LLC,0,1,-1
19846,3071660029,BK,2344 BOYNTON PLACE,02,C0,"SHI, ZHONG FA",0,1,-1
19847,5015040066,SI,36 FRANCINE LANE,01,A5,"LEONG, KAI LAP",1,2,-1
19848,3072080037,BK, AVENUE X,07,U7,NYC TRANSIT AUTHORITY,0,1,-1
19849,4101660017,QN,107-27 GUY R BREWER BLVD,01,B2,EMPBANQUE CAPITAL CORP,1,2,-1
19850,5010440062,SI,387 HEBERTON AVENUE,01,A1,"DANNECKER, PETER",1,2,-1
19851,4142280222,QN, BAYVIEW AVENUE,01,Z0,EDMUND KLIMCZAK,0,1,-1
19852,5053220050,SI,90 OCEANIC AVENUE,10,G0,J&M TOMPKINS PROPERTIES LLC,0,1,-1
19853,4142280762,QN, BROADWAY,11,V0,"GOUNDEN, SONA",0,1,-1
19854,4081160114,QN,42-62 247 STREET,01,A5,WILLIAM P MULHALL,1,2,-1
19855,4110830089,QN,215-20 HEMPSTEAD AVENUE,05,GU,216-02 HEMPSTEAD AVENUE CORP,0,1,-1
19856,4142340584,QN,102 STREET,11,V0,PROJECT REBUILD INC,0,1,-1
19857,1006910033,MN,161 10 AVENUE,10,G6,"204 LAFAYETTE ST PROPERTIES,",0,1,-1
19858,4153120020,QN,811 CROSS BAY BOULEVARD,01,A1,"STACY CANNING-SPATARO,  AS TRUSTEE",1,2,-1
19859,1007907504,MN,135 WEST 14 STREET,04,RM,UNAVAILABLE OWNER,1,2,-1
19860,4051050002,QN, LAWRENCE STREET,07,U9,HOMECOMINGS FINANCIAL,0,1,-1
19861,5053030150,SI,305B WIMAN AVENUE,09,Q8,PORT REGALLE YACHT CLUB LTD,0,1,-1
19862,4088430009,QN,86-21 79 STREET,01,A1,"KAVANAGH, SUZY A",1,2,-1
19863,4116490020,QN,114-27 122 STREET,01,B3,"SHIVPRASAD, DEVANAND",1,2,-1
19864,3045520001,BK,852 WORTMAN AVENUE,08,Z3,U S POSTAL SERVICE,1,2,-1
19865,3053817501,BK,542 DAHILL ROAD,02,R2,FEDERAL HOME LOAN MORTGAGE CORP,1,2,-1
19866,4131850015,QN,139-43 230 STREET,10,G0,GAETAN G BEAUZILE,0,1,-1
19867,3083690392,BK,1362 EAST 70 STREET,01,B2,"KOSTIKOVA, ALLA",1,2,-1
19868,4092990011,QN,87-70 110 STREET,01,B3,"WELLINGTON, ARMANDOR",1,2,-1
19869,5021130011,SI,123 GARY PLACE,01,B2,AUGUSTO SALARIS,1,2,-1
19870,3086160135,BK, EAST MILL BASIN,11,V0,"ZIKIY, SVETLANA TRUS",0,1,-1
19871,5011940083,SI,220 SIMONSON AVENUE,01,A1,"RUIZ, ROXANA",1,2,-1
19872,4157140185,QN,2 HOLLYWOOD COURT,01,A1,"MINTO-SEOW, JOAN D",2,3,-1
19873,3087470157,BK,19 HASTINGS STREET,01,A5,"KHANUKOV, ELINA",2,3,-1
19874,4093380001,QN,130 STREET,07,U7,LIRR,0,1,-1
19875,4094810024,QN,133-05 101 AVENUE,01,B2,WAHID HOOSEIN,1,2,-1
19876,4159050227,QN,155 OCEAN LANE,01,B2,"ANCHUNDIA, CARLOS V",1,2,-1
19877,4160920084,QN,180 SCHOONER STREET,01,B2,"YANG, XIU NIAN",1,2,-1
19878,4102650126,QN,174 STREET,11,V0,"QUASHIE, CLYDE O",0,1,-1
19879,2055140122,BX,134B EDGEWATER PARK,01,A8,EDGEWATER PK OWNERS COOPERATIV,48,49,-1
19880,5070930079,SI,111 HARRIS LANE,01,A5,FERNANO D. BURGOS,1,2,-1
19881,4038790015,QN,81-57 INTERBOROUGH PARKWAY,02,C2,"SIEWERS, HENRY",1,2,-1
19882,4051320054,QN,56-40 138 STREET,02,C0,"BIANCANIELLO, ANTONIO",1,2,-1
19883,1022430300,MN,537 WEST 217 STREET,01,B1,"THOM, DAVID G",2,3,-1
19884,5012370046,SI,41 ANDROS AVENUE,01,A1,"COX-SMALLS, ZENJA",1,2,-1
19885,4097360104,QN,84-69 DANIELS STREET,01,B3,YOUNG ISRAEL OF BRIARWOOD INC,1,2,-1
19886,5000390053,SI,133 BENZIGER AVENUE,01,B2,"LIN, WEI",0,1,-1
19887,3044520170,BK,700 VANDALIA AVENUE,09,Q9,GATEWAY CANTER PROPER,0,1,-1
19888,4129490020,QN,241-11 132 AVENUE,01,A2,"BACCHUS, BIBI FARIDA",1,2,-1
19889,5054470026,SI, ELVERTON AVENUE,07,U2,THOMAS TPDARO,0,1,-1
19890,4006900059,QN,43 STREET,10,G0,"NACINOVIC, SILVIO",0,1,-1
19891,4130850020,QN,219-25 NORTH CONDUIT AVENUE,05,K1,UNAVAILABLE OWNER,1,2,-1
19892,4131470024,QN,223-06 139 AVENUE,01,A1,"FIGUEROA, MARGARITA",1,2,-1
19893,4108030006,QN,222-12 100 AVENUE,01,A1,VERNON MC FARLANE,1,2,-1
19894,3014700039,BK,510 HOWARD AVENUE,02,C0,NYC HOUSING AUTHORITY,1,2,-1
19895,4101420054,QN,154 STREET,10,G0,"RAYKHARAM, SOMAR",0,1,-1
19896,4008200035,QN,35 STREET,07,U8,NATIONAL RAILROAD PASSENGER CORP,0,1,-1
19897,5028420050,SI, WILLOW AVENUE,07,U2,BROOKLYN UNION GAS COMPANY,0,1,-1
19898,2053070019,BX,2724 GIFFORD AVENUE,01,A1,"PANAGIOUSOULIS, PANOREA",1,2,-1
19899,4102190034,QN,172-34 93 AVENUE,01,A1,CHITKUMARIE BUDRAM,1,2,-1
19900,3006460064,BK,201 23 STREET,03,D1,201 23RD STREET LLC,1,2,-1
19901,4009260190,QN, DITMARS BOULEVARD,07,T1,NYC DEPARTMENT OF SMALL BUSINESS SERVICES,1,2,-1
19902,2027660260,BX, DRAKE STREET,,Z9,POINT H. REALTY CORP.,0,1,-1
19903,2050270024,BX,4125 MONTICELLO AVENUE,11,V0,JACKSON BESSIE M,0,1,-1
19904,2050220004,BX,4112A WILDER AVENUE,10,G0,FELICITA HUMPHRIES BROWN,0,1,-1
19905,5028420122,SI,35C LANGERE PLACE,01,B9,LANGERE PLACE ASS,1,2,-1
19906,4012820046,QN,37 ROAD,11,V0,"L&K NYC, INC.",0,1,-1
19907,5028460078,SI,38A CHESTNUT AVENUE,10,G0,"ALNITZ SAULONG FAMILY TRUST, DTD MARCH 3 0, 2016",0,1,-1
19908,4013420024,QN,42-54 65 PLACE,10,G0,JANKOWSKI JADWIGA,0,1,-1
19909,4124520033,QN,180-06 BAISLEY BOULEVARD,01,B1,"BENNETT, ARCHIBALD",1,2,-1
19910,4139120170,QN,155-46 BAYVIEW AVENUE,01,A2,LIVE OAK INC,1,2,-1
19911,2047400033,BX,3210 FISH AVENUE,01,B3,PEARL DANVILLE,2,3,-1
19912,4142471316,QN,102-03 JAMES COURT,01,B1,"CALDONE , JOHN",0,1,-1
19913,4150040001,QN,154-10 SOUTH CONDUIT AVENUE,05,H4,ROYAL YORK EQUITIESCORP,1,2,-1
19914,4109250013,QN,109-33 FARMERS BOULEVARD,04,K4,5 STANLEY LANE CORP,1,2,-1
19915,4122510028,QN,160-44 121 AVENUE,01,B3,"GRANT, KENFORD D",2,3,-1
19916,4016020069,QN,94-39 46 AVENUE,01,A1,KET DJIE LIAU,2,3,-1
19917,4016090002,QN,100-04 ROOSEVELT AVENUE,05,K1,100 ROOSEVELT AVENUEENTERPRISE INC,0,1,-1
19918,4155470041,QN, VIRGINIA STREET,11,V0,MOUSSA REYH,0,1,-1
19919,5043940023,SI,307 RIEDEL AVENUE,01,B2,"CASCARDO, RUSSELL",0,1,-1
19920,5002250022,SI,272 MYRTLE AVENUE,01,A1,BALSECA FELIPE,1,2,-1
19921,4155710133,QN,7-87 CORNAGA AVENUE,01,B3,MOLINSKY SAMSON,1,2,-1
19922,4111200023,QN,109-15 217 STREET,01,A1,"FARHANA, NAHID",1,2,-1
19923,2038130073,BX,2123 ELLIS AVENUE,01,A1,EMMA RODRIGUEZ,2,3,-1
19924,5029300043,SI,17 LEEWOOD LOOP,01,A5,CHIN WAI CHAN,1,2,-1
19925,2043800015,BX, BOUCK AVENUE,10,G0,DROSOPOULOS KONSTANTINA,0,1,-1
19926,5030630006,SI,30 LAKEVIEW TERRACE,01,A1,"QUINTAVALLE, JOSEPH MICHAEL",1,2,-1
19927,4159050022,QN,64-01 OCEAN AVENUE SOUTH,01,B2,"ONG, EMMA",1,2,-1
19928,4159050126,QN,163 SEA GRASS LANE,01,B2,"WANG, ZHAN",1,2,-1
19929,4159050247,QN,65-07 OCEAN AVENUE SOUTH,01,B2,"LEWCZUK, MONIKA",1,2,-1
19930,4024720137,QN,51-11 MANILLA STREET,01,B2,NORMA AGUIRRE,1,2,-1
19931,4025500375,QN,44-07 56 ROAD,07,G2,UNAVAILABLE OWNER,0,1,-1
19932,5013180213,SI,156 HOLLAND AVENUE,01,A5,"DARBY, CELESTE",1,2,-1
19933,4026360004,QN, FLUSHING AVENUE,10,G0,ZOILITA RIVERA,0,1,-1
19934,5002540193,SI,48 PARK COURT,01,A1,"DIAMOND, SUSAN",1,2,-1
19935,5014400077,SI,58 BRYSON AVENUE,01,A2,ANGELINA LAWRENCE,1,2,-1
19936,4104670006,QN,89 ROAD,11,V0,JEAN & GABRIELLE PREVILLON,0,1,-1
19937,4000540145,QN,11-12 45 ROAD,01,B1,GDC LIC OWNER LLC,1,2,-1
19938,5003530014,SI, MUNDY AVENUE,10,G0,VINCENT E ZAKRZEWSKI,0,1,-1
19939,4122140123,QN,119-52 155 STREET,11,V0,URBAN ADVANCEMENT VI LLC,0,1,-1
19940,5003650042,SI,21 CONSTANT AVENUE,01,A1,"ARCARO, ENRICO",2,3,-1
19941,5033370045,SI, ALTER AVENUE,10,G0,ANTHONY  ORIENTE,0,1,-1
19942,5000020001,SI,1 RICHMOND TERRACE,07,T9,NYS DEPARTMENT OF TRANSPORTATION,4,5,-1
19943,5000020010,SI, BOROUGH PLACE,07,U6,MTA - STATEN ISLAND RAILWAY,0,1,-1
19944,2054190133,BX, EDISON AVENUE,11,V0,MISCIAGNA JOHN,0,1,-1
19945,4032950059,QN, KESSEL STREET,10,G0,"YANG, CORINNE CHIN",0,1,-1
19946,4033390107,QN,75 ROAD,10,G0,LAWRENCE TSAO,0,1,-1
19947,5000410056,SI,45 TAFT AVENUE,01,B2,45 TAFT AVENUE LLC,1,2,-1
19948,5000450043,SI,137 HENDRICKS AVENUE,01,A1,SI HENDRICKS LLC,0,1,-1
19949,5001380109,SI,126 BARD AVENUE,01,B2,Y&H HOMELAND INC.,0,1,-1
19950,2040250022,BX, WHITE PLAINS ROAD,11,V0,LYVERE GARDENS LLC,0,1,-1
19951,5062690043,SI, JEFFERSON BOULEVARD,11,V0,"ZUMMO, MARY",0,1,-1
19952,5027700043,SI, GLEN STREET,11,V0,ELAINE SPENCER,0,1,-1
19953,5005770040,SI,14 BAYVIEW PLACE,01,B2,JULIE M UCIECHOWSKI,1,2,-1
19954,4038170006,QN,77-29 79 PLACE,01,A9,"MITCHELL, ADAM",1,2,-1
19955,4126170014,QN,117-14 197 STREET,01,B2,"SAPPLETON, JUNIOR H",0,1,-1
19956,4126230050,QN,118-35 198 STREET,01,B3,ZA HOMES INC,1,2,-1
19957,4038340074,QN,78-67 83 STREET,01,B2,"FERRARA, DEBORAH",1,2,-1
19958,5005810031,SI, WARD AVENUE,11,V0,THOMAS J WROBLESKI,0,1,-1
19959,5002380199,SI,130 LLEWELLYN PLACE,01,B2,"BILALI, RAMAZAN",2,3,-1
19960,5002610050,SI,36 CITY BOULEVARD,01,A1,"ANDERSON, CHRISTOPHER M",1,2,-1
19961,4130320015,QN,218 STREET,11,V0,JERMAINE WILLIAMS,0,1,-1
19962,5036440022,SI,273 OTIS AVENUE,01,A1,JOHN C JANICKI,1,2,-1
19963,4047030001,QN,17-01 MURRAY STREET,01,A1,HONG FIONA HAN,1,2,-1
19964,4047050061,QN,151-24 18 AVENUE,02,C0,J TOTINO,1,2,-1
19965,4130570077,QN,141-22 SPRINGFIELD BLVD,01,B3,"CESAR, WILSON",1,2,-1
19966,5003100119,SI,69 PURCELL STREET,01,B2,"SULLIVAN, JOHN F",1,2,-1
19967,5003550300,SI,250 EGBERT AVENUE,01,A5,"GONZALEZ, JULIO",1,2,-1
19968,4117460061,QN,125 STREET,11,V0,GLORIA JENKINS,0,1,-1
19969,4051750030,QN,148 STREET,10,G0,ALDO GHIRARDI,0,1,-1
19970,4051750034,QN,148 STREET,10,G0,"GHAI, DARSHAN",0,1,-1
19971,4051750036,QN,148 STREET,10,G0,"SFIROUDIS, DEAN",0,1,-1
19972,5008420018,SI, SPRING STREET,10,G0,"COLAMARIA, DEREK",0,1,-1
19973,5004060007,SI,113 DICKIE AVENUE,01,A1,TERENCE M. O'CONNOR,1,2,-1
19974,5009480009,SI,3055 RICHMOND ROAD,04,O8,ROBERT MORRI,1,2,-1
19975,5036510015,SI, BUEL AVENUE,11,V0,1602 HYLAN LLC,0,1,-1
19976,4058630060,QN,15-04 212 STREET,02,C6,"BAY TERRACE COOPERATIVE SECTION III, INC .",53,54,-1
19977,4062000002,QN,204-09 39 AVENUE,01,A1,"SZE, YUK YIU",1,2,-1
19978,4142010109,QN,163-50 95 STREET,01,B3,"DIAZ, ALAN",1,2,-1
19979,4142501463,QN,164 AVENUE,11,V0,"TRUST ACCARDI,SALVATORE",0,1,-1
19980,4142531526,QN,164 ROAD,11,V0,WILLIAM FOGARTY,0,1,-1
19981,4142541646,QN,164 ROAD,11,V0,"MARCEL, PAUL",0,1,-1
19982,4063270021,QN,221-10 43 AVENUE,01,B3,"ZHENG, WENZHUI",2,3,-1
19983,2035570073,BX,615 BEACH AVENUE,10,G0,EDWIN RUIZ,1,2,-1
19984,2042420109,BX,2846 EAST 196 STREET,01,B2,"BERISHA, BESNIK",0,1,-1
19985,4068950043,QN,61-12 168 STREET,01,B1,"JIANG, CHONG XIN",1,2,-1
19986,4051750028,QN,148 STREET,10,G0,NVG BOOTH LLC,0,1,-1
19987,4158510045,QN,BEACH 42 STREET,07,U7,MIDTOWN DEVELOPMENTCORP,0,1,-1
19988,4070047501,QN,77-36 169 STREET,04,RM,UNAVAILABLE OWNER,1,2,-1
19989,4070720024,QN,61-36 184 STREET,01,B3,"HUANG, XIANG BAO",2,3,-1
19990,4159050061,QN,166 SEA GRASS LANE,01,B2,"HU, NELSON",1,2,-1
19991,4072140061,QN,75-43 197 STREET,01,B1,"MAGNAYE-BANZON, ZENAIDA",1,2,-1
19992,4159390105,QN, BEACH FRONT ROAD,11,V1,UNAVAILABLE OWNER,0,1,-1
19993,4072570064,QN,80 DRIVE,11,V0,"GURINO, TRUSTEE, CYNTHIA",0,1,-1
19994,5029200025,SI, CLOVE ROAD,11,V2,ANTOINETTE WOJTACKI,0,1,-1
19995,4161250080,QN,3-27 BEACH 91 STREET,01,A5,"MCNEIL, EMILY DUNN",1,2,-1
19996,4081380068,QN,43-10 MORGAN STREET,01,A1,"QIU, HE",1,2,-1
19997,5006090015,SI,46 ALPINE AVENUE,01,A1,LAURA BILOTTI,1,2,-1
19998,5062290023,SI, IONIA AVENUE,11,V0,CARL R VON DER OSTEN,0,1,-1
19999,4083060098,QN,246-12 63 AVENUE,01,A0,STEPHEN & DOROTHY LAMERE,1,2,-1
20000,5029670037,SI,45 SHAUGHNESSY LANE,01,A1,"DOLAN, HELENA MARCONDES",1,2,-1
20001,2024960064,BX, RIVER AVENUE,10,G6,1185 RIVER AVENUE LLC,0,1,-1
20002,2023430032,BX,500 GRAND CONCOURSE,08,W6,DASNY,1,2,-1
20003,4088900010,QN, WOODHAVEN BOULEVARD,11,V0,2683-91 WOODHAVEN BLVD. LLC,0,1,-1
20004,5000250027,SI,357 WESTERVELT AVENUE,02,C3,"357 WESTERVELT, LLC",1,2,-1
20005,5007060050,SI, SCHMIDTS LANE,09,Q1,NYC DEPARTMENT OF PARKS AND RECREATION,0,1,-1
20006,2046670037,BX,725 EAST 219 STREET,02,C0,"REYES, MIGUEL F",0,1,-1
20007,5015080183,SI,13 TREMONT AVENUE,01,B2,NICHOLAS J. LAMONICA,1,2,-1
20008,5015080210,SI,58 CAMBRIDGE AVENUE,01,A2,"FATTINGER, JO-ANN",1,2,-1
20009,5001380110,SI,118 BARD AVENUE,01,B2,"DECICCO, JOSEPH",0,1,-1
20010,5001520099,SI,231 OAKLAND AVENUE,01,A1,DANIEL J DONOVAN,1,2,-1
20011,5001740027,SI,34 WAYNE STREET,01,A5,"TAN, TIANBAO",0,1,-1
20012,5001850172,SI,1681 RICHMOND TERRACE,06,E1,98 S & S LLC,1,2,-1
20013,5008490145,SI,50 DELLWOOD ROAD,01,A1,LINDA COSTELLO,1,2,-1
20014,5002770048,SI,115 LAWRENCE AVENUE,01,A2,MICHAEL E. DAVIS TRUSTEE,2,3,-1
20015,5003040022,SI,32 COUGHLAN AVENUE,01,A3,"BROGNA, BRANDON",0,1,-1
20016,5015600053,SI,1587 RICHMOND AVENUE,01,B2,STEPHEN B PERRIGO,1,2,-1
20017,4104240036,QN,187-33 ILION AVENUE,01,A2,KECIA L. GIBSON,1,2,-1
20018,5004920016,SI,23 WATER STREET,07,U6,MTA - STATEN ISLAND RAILWAY,0,1,-1
20019,5005260008,SI,81 BROAD STREET,11,V1,81 BROAD STREET LLC,0,1,-1
20020,5005290045,SI,21 TOMPKINS STREET,01,A1,DOREEN RAINEY,1,2,-1
20021,5009390156,SI,151 GELDNER AVENUE,01,A1,ALLISON HOLDINGS LLC,1,2,-1
20022,2046860059,BX,EAST 216 STREET,10,G0,ELSIE V HILL,0,1,-1
20023,5021100103,SI,873 TRAVIS AVENUE,01,A5,"SCARSO, CHRISTINE",1,2,-1
20024,5005810064,SI,140A CEBRA AVENUE,10,G0,KIM LORETTA,0,1,-1
20025,4097010016,QN,87-22 144 STREET,01,B3,"KHANUM, FARRUKH",1,2,-1
20026,5021490044,SI,522 ARLENE STREET,01,B2,FRANK MENECHINO,1,2,-1
20027,1012220017,MN,117 WEST 91 STREET,08,W2,TRINITY HOUSING CO INC.,2,3,-1
20028,5006090022,SI,106 GRAND AVENUE,01,A1,"DUDLEY, JENNIFER B",1,2,-1
20029,5040790052,SI, NEPTUNE STREET,11,V0,ANTOINETTE K. SANDERS,0,1,-1
20030,1010370015,MN,327 WEST 46 STREET,10,G6,333 W 46 ST CORP,0,1,-1
20031,5006220034,SI,61 WANDEL AVENUE,01,A1,"JASTRZAB, MARIA",1,2,-1
20032,2050640001,BX, BULLARD AVENUE,07,U1,NYC-HIGHWAYS DEPT,0,1,-1
20033,5006950004,SI,33 TODT HILL ROAD,01,A2,MATTHEW GUILIANO,1,2,-1
20034,4121270079,QN,152-50 ROCKAWAY BOULEVARD,05,O5,"RW HALL GENERAL CONTRACTORS, INC",1,2,-1
20035,5026250136,SI, BURKE AVENUE,01,A1,NATHAN HOLDINGS LLC,1,2,-1
20036,5007240035,SI,46 WHEELER AVENUE,01,B2,"ROMANO, MICHAEL",1,2,-1
20037,5007250032,SI,103 PERRY AVENUE,01,A1,JOSEPH BEDELL,1,2,-1
20038,5043020077,SI, RICHMOND ROAD,10,G0,"MORRI, JAMES",0,1,-1
20039,4107180026,QN,91 AVENUE,07,U9,NYC DEPARTMENT OF ENVIRONMENTAL PROTECTION,0,1,-1
20040,5007420041,SI,531 WOOLLEY AVENUE,01,A2,MARCELA STENKO,1,2,-1
20041,4105550032,QN,211-66 93 AVENUE,01,A1,"BEDASEE, DORIS",1,2,-1
20042,5031510007,SI,820 RICHMOND ROAD,02,C2,CULOTTA JOHN,2,3,-1
20043,5038490004,SI, SIOUX STREET,10,G0,IZZAT ABDEL MARTINEZ,0,1,-1
20044,5010170037,SI,85 BOND STREET,01,A1,"JONES, ALISON",1,2,-1
20045,2049220136,BX,3601 PRATT AVENUE,02,C0,"SANTIAGO, MICHELLE",1,2,-1
20046,5032290038,SI, RADCLIFF ROAD,11,V0,GILBERT SCHWEIGER,0,1,-1
20047,5011200036,SI,218 NICHOLAS AVENUE,01,B3,JOYCE GHIGLIOTTI,1,2,-1
20048,5030500051,SI,494 STEUBEN STREET,01,A2,PATEL AMIL,1,2,-1
20049,4110910001,QN,216 STREET,07,U9,NYC DEPARTMENT OF ENVIRONMENTAL PROTECTION,0,1,-1
20050,1009040024,MN,225 EAST 23 STREET,08,W1,NYC ECF,1,2,-1
20051,4111540018,QN,219 STREET,07,U9,NYC DEPARTMENT OF ENVIRONMENTAL PROTECTION,0,1,-1
20052,4113440038,QN,132-35 81 STREET,01,A5,"MATIN, NURUL M",1,2,-1
20053,5031760078,SI,31 COBBLERS LANE,01,A5,"RUDERMAN, ELENA",1,2,-1
20054,5032470066,SI, JEROME AVENUE,11,V0,UNAVAILABLE OWNER,0,1,-1
20055,2050130029,BX,1845 BUSSING AVENUE,01,A1,"SEAMCHARAN, ANJANI",1,2,-1
20056,5016000025,SI, PYRAMID COURT,11,V0,UNAVAILABLE OWNER,0,1,-1
20057,5013180139,SI,108 HOLLAND AVENUE,01,A1,"RODRIGUEZ, ROSA",1,2,-1
20058,5013180200,SI, HOLLAND AVENUE,11,V0,NYC DEPARTMENT OF PARKS AND RECREATION,0,1,-1
20059,2050300041,BX,4230 HILL AVENUE,01,B3,"CHARLTON, RICHARD C",1,2,-1
20060,5014420004,SI,333 LATHROP AVENUE,01,A2,BYRNES PAUL F,1,2,-1
20061,5032530021,SI,276 LAMPORT BOULEVARD,01,A2,"BURNEY, THERESA",1,2,-1
20062,2049620029,BX, AMUNDSON AVENUE,10,G0,"VALENTIN, CARMEN",0,1,-1
20063,5049850019,SI,160 HOPKINS AVENUE,01,A5,"SUN, EN BIN",0,1,-1
20064,5020910072,SI,51 HALL AVENUE,01,A5,"GOTTLIEB, SHALOM H",1,2,-1
20065,4121030067,QN,148-19 SUTTER AVENUE,01,A1,CHRISTINA MOORE TRUST,1,2,-1
20066,5021100101,SI,867 TRAVIS AVENUE,01,A5,"QI HONG CHEN, AS TRUSTEE",1,2,-1
20067,2052860040,BX,3512 HEATHCOTE AVENUE,,Z9,PEARTREE AUTO WRECKERS INC,0,1,-1
20068,5028290016,SI,68A CLIFTON AVENUE,11,V1,"WANG, JIE",0,1,-1
20069,5033760039,SI,372 ALTER AVENUE,01,A2,PAUL FARHA & ZAHID,1,2,-1
20070,5026290085,SI,144 WILD AVENUE,01,A1,"EIDHAMMER, RUSSELL",1,2,-1
20071,5032680033,SI,17 HICKORY AVENUE,02,C3,"PAPA NANA, LLC",1,2,-1
20072,2045550060,BX, HONE AVENUE,10,G0,"LYONS, JOHN",0,1,-1
20073,5035000013,SI, FR CAPODANNO BLVD,11,V0,NYS DEPARTMENT OF ENVIRONMENTAL CONSERVATION,0,1,-1
20074,5028980006,SI,334 MOSEL AVENUE,01,B2,"HUANG, MAY MEI YI",1,2,-1
20075,5028540038,SI, MARYLAND AVENUE,11,V0,"BELLANTONI, PETER JR",0,1,-1
20076,4125290255,QN,127-18 172 STREET,02,C0,"MCKOY, MARTIN",1,2,-1
20077,5035800024,SI,86 MIDLAND AVENUE,01,B2,UNAVAILABLE OWNER,2,3,-1
20078,4116950043,QN, LINCOLN STREET,11,V0,DISCOUNT BUYING GROUP INC,0,1,-1
20079,5028990140,SI,111 MOSEL AVENUE,01,A5,SUSAN MATTHEWS,1,2,-1
20080,5031000111,SI,159 MC CLEAN AVENUE,01,A5,"CHRISTIAN, SUMITRA",1,2,-1
20081,2053730044,BX, CODDINGTON AVENUE,11,V0,ROBERT KALANZ JR.,0,1,-1
20082,5001120013,SI, TRUMBULL PLACE,11,V0,275 GELN AVE VENTURES LLC,0,1,-1
20083,5031180001,SI,27 RAILROAD AVENUE,01,A5,TANDEK KRYSTYNA,1,2,-1
20084,5033530062,SI,25 RUTH PLACE,01,B2,"CUCUZZA, ANTHONY",1,2,-1
20085,4128250215,QN,121-24 FRANCIS LEWIS BLVD,01,A0,"LEVANT, VICTOR M",1,2,-1
20086,5035300103,SI,689 NORTH RAILROAD AVE,01,A2,"MC GUIRE, CATHY",1,2,-1
20087,4131290055,QN,137-48 224 STREET,11,V0,"HABIBULLA, NAZEEM",0,1,-1
20088,4131300020,QN,224 STREET,10,G0,72 BEN DAVID CORP.,0,1,-1
20089,4131380055,QN,225 STREET,10,G0,"BUCKNOR, CARRION A",0,1,-1
20090,5035920055,SI,88 LINCOLN AVENUE,01,B3,PETER V DOCKTER,1,2,-1
20091,5035920088,SI,81 FREMONT AVENUE,01,A1,WYNNE DENISE,1,2,-1
20092,5036060048,SI,138 PRESCOTT AVENUE,01,A1,"MCGARRY, MARIAN",1,2,-1
20093,5036200085,SI,15 LOCUST AVENUE,01,A1,CONNELLY KICHAEL,1,2,-1
20094,4141820114,QN,4 COLEMAN SQUARE,04,S1,5 COLEMAN SQUARE LLC,1,2,-1
20095,5051900024,SI,22 FAIRLAWN LOOP,01,A5,BORIS LIVITS,1,2,-1
20096,1008320043,MN,290 5 AVENUE,05,O5,MARCOLVA NV,1,2,-1
20097,4142340580,QN,102 STREET,11,V0,PROJECT REBUILD INC,0,1,-1
20098,5037450022,SI,302 POULTNEY STREET,01,A1,"MORIELLO, JOAN",1,2,-1
20099,5038170030,SI,243 MORELAND STREET,01,A5,"BLOCK 3159, LLC",1,2,-1
20100,5038440001,SI, CHEROKEE STREET,11,V0,HOUSING TRUST FUND CORPORATION,0,1,-1
20101,5038860052,SI,381 FREEBORN STREET,01,A2,"FEISS, JOHN",1,2,-1
20102,3051860050,BK,455 EAST 22 STREET,01,Z0,EAST 22ND EQUITIES LLC,0,1,-1
20103,5042380052,SI,5 RENO AVENUE,01,A1,"TUTONE, JOHN A",1,2,-1
20104,5033280122,SI, EVERGREEN AVENUE,11,V0,AHMAD SADIGH,0,1,-1
20105,2041380001,BX, WATERS AVENUE,07,U7,NYC TRANSIT AUTHORITY,0,1,-1
20106,5043350112,SI,50 BISHOP STREET,01,A1,"IEZZA, MICHAEL",1,2,-1
20107,4162420045,QN,130-08 CRONSTON AVENUE,01,B2,JOSEPH MASTEY,1,2,-1
20108,5035830033,SI, BEDFORD AVENUE,10,G0,"ZHU, BENSHU",0,1,-1
20109,5051390025,SI,19 OCEAN ROAD,01,A3,"KHABINSKI, GARY",1,2,-1
20110,5053550032,SI,7 ROSS LANE,01,A5,"SCOTTO, JOSEPH",1,2,-1
20111,4163200027,QN,157 BEACH 146 STREET,01,A1,"JACKSON, JERRY",1,2,-1
20112,5051900028,SI,16 FAIRLAWN LOOP,01,A5,"SEMENOV, SERGEY",1,2,-1
20113,5054970254,SI,3839 RICHMOND AVENUE,07,U6,MTA - STATEN ISLAND RAILWAY,0,1,-1
20114,5000870069,SI,143 ALDEN PLACE,01,A2,"BARONE, MICHAEL",1,2,-1
20115,5030400051,SI,20 POUCH TERRACE,01,B1,"FLAGIELLO, CAMILLE",1,2,-1
20116,5001390039,SI,268 BARD AVENUE,01,A3,"LAKA, CHRISTOPHER",0,1,-1
20117,5053030030,SI,235 WIMAN AVENUE,01,A1,"MAZZEO, TRUSTEE, LORI",1,2,-1
20118,5054050015,SI,88 LENZIE STREET,01,B2,"ALISHAHI, TARANEH",1,2,-1
20119,5001500420,SI,10 ELIZABETH AVENUE,01,A5,"GAMBALE, JOHN",1,2,-1
20120,5079290067,SI, ASPINWALL STREET,10,G0,"CANFIELD, EDWARD",0,1,-1
20121,5057350370,SI,219 PRESENTATION CIRCLE,01,A5,"FARINA, NICHOLAS",1,2,-1
20122,5002380149,SI, FOREST AVENUE,11,V0,SUTKI BILALI,0,1,-1
20123,5060440005,SI,6D DELMAR AVENUE,01,A5,"CALRONE, MARIE",1,2,-1
20124,5054070027,SI,165 BATHGATE STREET,01,B2,63 SYLVIA CORP.,0,1,-1
20125,5054330005,SI,20 - 26 GIFFORDS LANE,04,S9,GIFFORDS LANE LLC,1,2,-1
20126,5078860020,SI,494 YETMAN AVENUE,01,A1,"RAHN , GERARD",1,2,-1
20127,5056440001,SI,59 READING AVENUE,01,A1,JOHN BARRETT,1,2,-1
20128,5003980001,SI, WARDWELL AVENUE,10,G0,LAMBERTI JOSEPHINE,0,1,-1
20129,5042020012,SI,4 STREET,10,G0,"GOUGH, DEBRA A",0,1,-1
20130,5062120022,SI,84 JEANNETTE AVENUE,01,A1,J J PERRY,1,2,-1
20131,5056940069,SI,596 ANNADALE ROAD,01,B2,MAHLER RICHARD,1,2,-1
20132,5044370056,SI, RICHMOND ROAD,01,A3,"WOODHILL FUNDING, LLC",1,2,-1
20133,5034100079,SI,41 ANDREWS STREET,01,B2,"LIU, YONG FU",0,1,-1
20134,5060280001,SI, CODY PLACE,09,Q3,HUGUENOT HOA,0,1,-1
20135,5061460020,SI,787 ROSSVILLE AVENUE,01,B9,FILOMENA LIQUORI,1,2,-1
20136,5063010058,SI,471 RENSSELAER AVENUE,01,A1,"THAQI, LYRA",0,1,-1
20137,5061640014,SI,12 KNESEL STREET,01,A1,JUDE KNESEL,1,2,-1
20138,5063240023,SI,5303 AMBOY ROAD,01,B2,"CHEN, BIN",1,2,-1
20139,5052660018,SI,230 PACIFIC AVENUE,01,B2,AZER ROSY,2,3,-1
20140,5007740124,SI,1207 WILLOWBROOK ROAD,01,A1,CHRISTIAN TREMBONE,2,3,-1
20141,5009500245,SI, ENFIELD PLACE,01,A3,FREIDA E. SULSONA AS TRUSTEE,0,1,-1
20142,5010060024,SI, CHURCH STREET,07,U2,S I EDISON CP,0,1,-1
20143,5010430116,SI, LEXINGTON AVENUE,10,G0,"TERICO, JOSEPH C",1,2,-1
20144,2056250032,BX,45 CITY ISLAND AVENUE,05,K1,"SAMMY'S FISHBOX REALTY CO., L.L.C.",1,2,-1
20145,2056270001,BX,20 SCHOFIELD STREET,01,B3,ARTHUR KLEIN REVOCABLE TRUST U/A 6-22-20 10,1,2,-1
20146,5011920018,SI,129 VAN PELT AVENUE,01,A1,"FONSECA, LUIS O",1,2,-1
20147,5067590019,SI,15 MANEE AVENUE,01,A1,"THREE EIGHTS REALTY, LLC",1,2,-1
20148,5012360139,SI,97 LOCKMAN AVENUE,01,A1,"FALL, MAFATIME",1,2,-1
20149,5014640055,SI,249 CRYSTAL AVENUE,01,A2,"MELCHIORRI, ANTHONY",1,2,-1
20150,5015080105,SI,44 TREMONT AVENUE,01,A2,ROSE EMMA CELARDO,1,2,-1
20151,5016000001,SI,146 ELSON STREET,01,A5,ROSA BUTTITTA,1,2,-1
20152,5017800015,SI, CHELSEA ROAD,11,V1,MAGGIES RUN LLC,0,1,-1
20153,5054200096,SI, MAYBERRY PROMENADE,01,B2,JULIA 136 LLC,0,1,-1
20154,5019910028,SI,45 CONRAD AVENUE,01,A5,"GOLEV, VLADIMIR",1,2,-1
20155,5069250009,SI,442 FOSTER ROAD,01,A2,LOUISE OCONNOR,1,2,-1
20156,5027050064,SI,453 WILD AVENUE,01,A1,JAMES E BRAHN,1,2,-1
20157,5035570060,SI,231 HUSSON STREET,01,A1,"SEZAIRI, KIMETE",1,2,-1
20158,5028400033,SI,114 TOWNSEND AVENUE,01,B3,ANTHONY AFASANO,1,2,-1
20159,5055070109,SI, GETZ AVENUE,11,V0,CAMILLO MAZZELLA,0,1,-1
20160,5028990128,SI,139 MOSEL AVENUE,01,A5,MARJORIE RESTO,1,2,-1
20161,5029080024,SI,433 BRITTON AVENUE,01,A5,"WU, YU SHUN",1,2,-1
20162,5070930048,SI,702 BLOOMINGDALE ROAD,01,B9,"FISCH, ELLEN",1,2,-1
20163,5029170024,SI,1981 CLOVE ROAD,01,A5,"LIN, QIN",0,1,-1
20164,5072070280,SI, JOHNSON STREET,10,G7,11 JOHNSON ST LLC,0,1,-1
20165,5077550007,SI,168 CAMDEN AVENUE,01,A5,"GAO, ZHEN",1,2,-1
20166,5035630014,SI,55 HUNTER AVENUE,01,A2,DIAMOND C PAPPAGALLO,1,2,-1
20167,5031110084,SI, MILLS AVENUE,11,V0,JOSE LUIS DICIANNI,0,1,-1
20168,5037470001,SI, LIBERTY AVENUE,11,V0,O.L.M. REALTY CORP,0,1,-1
20169,5061060194,SI,40 WYCLIFF LANE,01,B9,RICHARD A. ACCA,1,2,-1
20170,5032690081,SI,44 HICKORY AVENUE,01,A2,"RAMIREZ, NIVIA",1,2,-1
20171,5061060047,SI,47 WYCLIFF LANE,01,B9,THOMAS MINUTILLO,1,2,-1
20172,1000520030,MN,112 TRINITY PLACE,04,K4,111 CEDAR ST CO,1,2,-1
20173,1000960013,MN, FRONT STREET,07,U7,NYC HOUSING PRESERVATION AND DEVELOPMENT,0,1,-1
20174,5033950086,SI,20 APPLEBY AVENUE,01,B1,"GERESSY, VINCENT",1,2,-1
20175,5067510032,SI, EXCELSIOR AVENUE,11,V0,EDWIN T MALLIEN,0,1,-1
20176,4139900044,QN,158-35 91 STREET,01,A2,"AINAHMANESH, JOANNE",1,2,-1
20177,4121080054,QN,150 STREET,11,V0,UNAVAILABLE OWNER,0,1,-1
20178,5037430034,SI,1251 MASON AVENUE,01,B2,"LIN, YIQIN",0,1,-1
20179,5069680055,SI,1072 SHELDON AVENUE,01,A5,"PUGLIA, KEITH",1,2,-1
20180,5038730073,SI,1109 FATHER CAPODANNO BL,01,A5,BILLY A. RUMZI,1,2,-1
20181,5069330006,SI,598 FOSTER ROAD,01,B2,"SPINA, JOHN JR",0,1,-1
20182,5040700060,SI, HETT AVENUE,10,G0,"LIN & LIN STATEN ISLAND INVESTMENT, LLC",0,1,-1
20183,5040920017,SI, NEUTRAL AVENUE,10,G0,UNAVAILABLE OWNER,0,1,-1
20184,5041080034,SI, ROMA AVENUE,11,V0,EDWARD J PISCINA,0,1,-1
20185,5070930041,SI,19 HARRIS LANE,01,A5,PHILIP NASISI,1,2,-1
20186,5042320020,SI,30 ALLISON AVENUE,01,A2,"ZAWISTOWSKI, ANDREW",1,2,-1
20187,5044380018,SI,53 ST PATRICKS PLACE,01,A1,RC CHUR ST PATRICK,1,2,-1
20188,5046090038,SI,67 NAHANT STREET,01,A2,MELISSA DI BENEDETTO,1,2,-1
20189,5071520010,SI,2365 ARTHUR KILL ROAD,01,A1,"DONJON MARINE CO., INC.",1,2,-1
20190,2041920005,BX,1820 MAYFLOWER AVENUE,01,B2,THERESA CARON,1,2,-1
20191,5046450086,SI,395 TIMBER RIDGE DRIVE,01,B9,"LIBERCHUK, VLADIMIR",1,2,-1
20192,5047050160,SI,144 ADELAIDE AVENUE,01,A1,YOUSIF ABDEL-JAWAD,1,2,-1
20193,5049850020,SI,164 HOPKINS AVENUE,01,A5,"SELLITTI, JOHN J",0,1,-1
20194,5073090008,SI,83 NIELSEN AVENUE,01,A1,NYS DIV OF LANDS AND FORESTS,1,2,-1
20195,5074060045,SI, ANDROVETTE STREET,10,G7,"35 ANDROVETTE REALTY, LLC",0,1,-1
20196,5052820009,SI,132 WILLIAM AVENUE,01,B2,"RODRIGUEZ, SANDRA I",1,2,-1
20197,5069750113,SI,26 MAGUIRE AVENUE,01,A1,EDWARD DELAHUNT,1,2,-1
20198,5069790232,SI,36 SANTA MONICA LANE,01,B9,85 MANILA CORPORATION,1,2,-1
20199,4114570070,QN,155-29 77 STREET,01,B2,DOBARTP;P SALVATORE,1,2,-1
20200,5055070071,SI, GETZ AVENUE,11,V0,"KHALIL, GIRGIS",0,1,-1
20201,4105260115,QN,86-27 MARENGO STREET,01,A7,"SINGH, SUKHJINDER",0,1,-1
20202,5072670294,SI,23 JADE COURT,01,A5,"PARK, YOONJIN",1,2,-1
20203,4105260006,QN,198-16 EPSOM COURSE,01,A1,"MORTAZAVI, M.D., ABDOLKARIM",1,2,-1
20204,5057350409,SI,71 PRESENTATION CIRCLE,01,A5,"LOMBARDI, MICHAEL R",1,2,-1
20205,5060140072,SI, CANTON AVENUE,01,B2,"CHENG, QIU MING",0,1,-1
20206,5062170036,SI, FABIAN STREET,10,G0,VINCENT DE SANTIS,0,1,-1
20207,5063350005,SI,671 HUGUENOT AVENUE,01,A1,WILFREDO TORRES,1,2,-1
20208,5074980048,SI,85A GAYNOR STREET,10,G0,"ADAMO, VIRGINIA",0,1,-1
20209,1016910003,MN,1880 1 AVENUE,10,G6,NYC HEALTH AND HOSPITALS CORPORATION,0,1,-1
20210,5069000043,SI,357 ALBOURNE AVENUE,01,B1,"HLINKA, JAROSLAV",0,1,-1
20211,5075500145,SI, WEST SHORE PARKWAY,11,V0,NYC DEPARTMENT OF ENVIRONMENTAL PROTECTION,0,1,-1
20212,5069680058,SI,1066 SHELDON AVENUE,01,A5,CHRISTOPHER LOMBARDO,1,2,-1
20213,5070930015,SI,80 HARRIS LANE,01,A5,"SCARPATI, FRANK",1,2,-1
20214,5070940047,SI,102 BERKSHIRE LANE,01,B9,"ZARZUELA, LUIS",1,2,-1
20215,5070940052,SI,64 BERKSHIRE LANE,01,A5,"MAZZELLA, WAYNE JR",1,2,-1
20216,5072060081,SI, INDUSTRIAL LOOP,10,G7,NAME NOT ON FILE,0,1,-1
20217,5075720087,SI,51 MADSEN AVENUE,01,A1,R L STAUFF,1,2,-1
20218,5078600066,SI,410 SPRAGUE AVENUE,01,A5,"SALAZAR, GABRIELA",1,2,-1
20219,5080200086,SI, ARTHUR KILL ROAD,,Z7,NYS DEPARTMENT OF TRANSPORTATION,0,1,-1
20220,5075960182,SI,21 PILOT LANE,01,A5,"SGARLATO, ROSEMARIE",1,2,-1
20221,5029780010,SI,290A HYLAN BOULEVARD,10,G0,LUONGO ALBERT,0,1,-1
20222,5069750121,SI,6 MAGUIRE AVENUE,01,A5,"ADZEMOVIC, NAIL",1,2,-1
20223,5065860011,SI,15 ANDROVETTE AVENUE,01,B2,TWOCP LLC,0,1,-1
20224,5028650016,SI,23 EGBERT PLACE,01,A2,NELSON PEREZ,1,2,-1
20225,3001870020,BK,110 SMITH STREET,04,S5,110 SMITH ST REALTYCORP,1,2,-1
20226,5063950023,SI,3 COURT,11,V0,LEONARD TALLO,0,1,-1
20227,1008300003,MN,818 AVENUE OF THE AMER,05,O5,818 820 EQUITY INC,1,2,-1
20228,1010790029,MN,737 10 AVENUE,08,W1,NYC ECF,2,3,-1
20229,5080080074,SI,245 PAGE AVENUE,05,K5,"MURRAY PAGE, LLC",0,1,-1
20230,4125210097,QN,125 AVENUE,01,Z0,"TEMPLE, ELEANOR",0,1,-1
20231,3000420043,BK,231 FRONT STREET,10,G7,"MEIR MOORE, INC.",0,1,-1
20232,5080380016,SI,1 NASHVILLE STREET,10,G0,"MESSINA, ROGER P",0,1,-1
20233,1012800154,MN,416 LEXINGTON AVENUE,07,U7,UNAVAILABLE OWNER,0,1,-1
20234,5062600018,SI, EDGEGROVE AVENUE,11,V0,MARY ZALOT,0,1,-1
20235,1015577502,MN,301 EAST 94 STREET,05,RC,THE MARMARA INC,2,3,-1
20236,2029400036,BX,1810 CROTONA PARK EAST,03,D1,1810 CROTONA PARK LLC,0,1,-1
20237,5038200051,SI,311 MORELAND STREET,01,A5,"JIANG, XIN",0,1,-1
20238,5078890016,SI,428 SLEIGHT AVENUE,01,A3,"OTTRANDO, DOROTHEA",0,1,-1
20239,4155790123,QN,819 CAFFREY AVENUE,01,A1,GREENBAUM SHARON,1,2,-1
20240,2025300068,BX,191 WEST 168 STREET,01,A2,"SEYEED, FATIMA Z.",1,2,-1
20241,2025990295,BX,,07,U1,NYS DEPARTMENT OF TRANSPORTATION,0,1,-1
20242,2026040270,BX,1025 EAST 149 STREET,06,E9,"BAMMS REALTY III, LLC",1,2,-1
20243,1004910003,MN,114 VARICK STREET,10,G6,TRINITY CHURCH CORP,0,1,-1
20244,2032520320,BX,103 VAN CORTLANDT AVE W,04,S2,103 CORTLANDT LLC,1,2,-1
20245,2039790021,BX,2428 ST RAYMOND AVENUE,01,B2,AMBROSIO JOSEPHINE,1,2,-1
20246,5079000055,SI,130 BRIGHTON STREET,01,B2,VINCENT GILBERTI,1,2,-1
20247,2032660023,BX,5530 BROADWAY,05,K2,"KIMBERLY ASSOCIATES,",0,1,-1
20248,2027710074,BX, TIFFANY STREET,,Z9,1381 MYRTLE REALTY CORP.,0,1,-1
20249,2028810100,BX, CEDAR AVENUE,09,Q2,NYC DEPARTMENT OF PARKS AND RECREATION,0,1,-1
20250,2059330100,BX,,07,U6,NYC DEPARTMENT OF ENVIRONMENTAL PROTECTION,0,1,-1
20251,2033220017,BX, JEROME AVENUE,10,G7,QB NY PROPERTIES LLC,0,1,-1
20252,5080080070,SI, MURRAY STREET,,Z9,UNAVAILABLE OWNER,0,1,-1
20253,2033570300,BX, BRONX BOULEVARD,09,Q1,NYC DEPARTMENT OF PARKS AND RECREATION,0,1,-1
20254,5080400056,SI,126 CRAIG AVENUE,01,A2,GREG DIMESA,1,2,-1
20255,2039430209,BX,2040 EAST TREMONT AVENUE,10,G1,"PPC COMMERCIAL, LLC",1,2,-1
20256,5064690001,SI, COMMUNITY LANE,11,V1,NYC DEPARTMENT OF PARKS AND RECREATION,0,1,-1
20257,2039520007,BX,1894 EAST TREMONT AVENUE,11,V1,ZP REALTY LLC,0,1,-1
20258,4157110042,QN,22-51 MOTT AVENUE,02,C0,2251-53 MOTT AVENUE LLC,0,1,-1
20259,5065670029,SI,72 COLON STREET,01,B2,VA ASSET HOLDINGS LLC,0,1,-1
20260,1005120017,MN,589 BROADWAY,05,O5,589 ASSOCIATES LLC,1,2,-1
20261,2041060027,BX, TOMLINSON AVENUE,10,G0,DELLECESE LORRAINE,0,1,-1
20262,2039750027,BX, ROWLAND STREET,10,G0,ROBERT BIMONTE,0,1,-1
20263,5038160002,SI,627 LINCOLN AVENUE,01,A5,"OUYANG, BIXIA",0,1,-1
20264,2042660041,BX,1947 RADCLIFF AVENUE,01,B2,1947 RADCLIFF REALTY CORP,1,2,-1
20265,5056830040,SI,55 KENMORE STREET,01,A1,NAGY BEKHIT,1,2,-1
20266,2044110300,BX,1770 STILLWELL AVENUE,08,N2,UNITED CEREBRAL PALSY/NEW YORK CITY INC,8,9,-1
20267,2040240048,BX,1616 TAYLOR AVENUE,05,K9,ASHK FAMILY LIMITED PARTNERSHIP,1,2,-1
20268,2040490007,BX, VICTOR STREET,11,V1,ASTORIA LLC,0,1,-1
20269,5072060176,SI,523 INDUSTRIAL LOOP,06,E2,LOOP INDUSTRIAL HOLDINGS LLC,1,2,-1
20270,4104450044,QN,189-03 JAMAICA AVENUE,04,S9,UNAVAILABLE OWNER,1,2,-1
20271,2042430036,BX,2105 CONTINENTAL AVENUE,02,C0,RENZO RAPACIOLI,1,2,-1
20272,2036990005,BX,910 HAVEMEYER AVENUE,10,G0,ANIBAL MALDONADO,0,1,-1
20273,2043350002,BX, BRUCKNER BOULEVARD,,Z9,NYC DEPARTMENT OF PARKS AND RECREATION,1,2,-1
20274,2033710012,BX,110 EAST 237 STREET,01,A1,SORNATALE CATHERINE,1,2,-1
20275,4159050084,QN,173 BEACH 62 STREET,01,B2,"THOMPSON, HARRIET",1,2,-1
20276,3009647507,BK,18 GARFIELD PLACE,02,R1,ONE GARFIELD LLC,1,2,-1
20277,4108630016,QN,100-22 197 STREET,01,B3,ANTHONY MCDONALD,1,2,-1
20278,2049710050,BX, ROMBOUTS AVENUE,11,V0,IMPAL REALTY CORP,0,1,-1
20279,2028970062,BX,428 EAST 173 STREET,06,E1,IRVING BAUER,1,2,-1
20280,1010350052,MN,344 WEST 45 STREET,10,G6,344 W 45TH LLC,0,1,-1
20281,1010500001,MN,538 10 AVENUE,08,I5,CH HOUSING DEVELOPMENT FUND CORPORATION,2,3,-1
20282,2053930010,BX,2926 ZULETTE AVENUE,01,A1,"REGINA, FRANK  R",1,2,-1
20283,4160890047,QN,216 BEACH BREEZE PLACE,01,B2,"BAYERSDORFER, GEORGE A",1,2,-1
20284,2053310035,BX,1235 PURITAN AVENUE,10,G0,"WOOD, KENNETH P",0,1,-1
20285,2054430091,BX, SAMPSON AVENUE,10,G0,ANA CANTON RAMIREZ,0,1,-1
20286,2054750054,BX,752 THROGS NECK EXPWY SR,10,G0,"CHIEM, HANH",0,1,-1
20287,2055290548,BX,3092 FERN PLACE,10,G0,"CHAUCA, SERGIO",0,1,-1
20288,4160910023,QN,7610 AQUATIC DRIVE,01,B2,"BLOUNT, KAMAU",1,2,-1
20289,5037000045,SI,11 MAPLEWOOD PLACE,05,K1,ABUPLUS LLC,0,1,-1
20290,4160920083,QN,161 COMMODORE CIRCLE W,01,B2,"PING, JEFF",1,2,-1
20291,5035920076,SI,95 FREMONT AVENUE,01,B2,"CHEN, JOHNNY",0,1,-1
20292,2055450112,BX,713 CALHOUN AVENUE,01,B1,"ORTIZ, MAXIMO",1,2,-1
20293,2056290122,BX, HAWKINS STREET,11,V0,VIRGINIA CONTE,0,1,-1
20294,2055900150,BX,182 CALHOUN AVENUE,01,A5,"PHAM, LAN THI NGOC",1,2,-1
20295,4160920097,QN,174 BEACH 73 STREET,01,B2,"CHAN, KWONG CHUNG",1,2,-1
20296,5035610010,SI,215 ADAMS AVENUE,01,A2,THE TINA RUOCCO A/K/A SALVATRICE RUOCCO  IRREVOCABL,1,2,-1
20297,3002960115,BK,355 HENRY STREET,01,A5,WJ HOUSE LLC,0,1,-1
20298,2058192238,BX, LIVINGSTON AVENUE,11,V0,KAHN SANDRA,0,1,-1
20299,3005190017,BK,7 COMMERCE STREET,06,E1,21 COMMERCE STREET,2,3,-1
20300,2032070027,BX,61 WEST 181 STREET,02,C3,"CRUZ, JOSE",1,2,-1
20301,4100980001,QN, DENTON STREET,07,U7,LIRR,0,1,-1
20302,2037020049,BX, LAFAYETTE AVENUE,07,U9,NYC DEPARTMENT OF ENVIRONMENTAL PROTECTION,0,1,-1
20303,5027050090,SI, WILD AVENUE,,Z7,HL LAND MANAGEMENT LLC,0,1,-1
20304,5033060029,SI,52 SEAVIEW AVENUE,01,B3,"TAFURI, LUISA",1,2,-1
20305,4100450008,QN,144-16 106 AVENUE,01,B2,"ROY, NIRMAL CHANDRA",0,1,-1
20306,3005760024,BK,71 WOLCOTT STREET,02,C6,RED HOOK HOMES APARTMENT CORPORATION,6,7,-1
20307,1019570050,MN, ST NICHOLAS AVENUE,11,V5,DORMITORY AUTHORITY,0,1,-1
20308,4097910039,QN,161-05 84 DRIVE,01,A1,JOSEPH T MCAVOY,1,2,-1
20309,5053290039,SI,28 BERKLEY STREET,01,A2,M PANARO,1,2,-1
20310,5070930006,SI,98 HARRIS LANE,01,A5,"CUCUZZA, ANTHONY",1,2,-1
20311,3010150003,BK,489 3 AVENUE,04,D6,THIRD AVE HOLDINGS 489 LLC,1,2,-1
20312,2040370017,BX,1659 HUNT AVENUE,02,C0,DFW 19 INC.,2,3,-1
20313,2047890022,BX, WICKHAM AVENUE,10,G0,"MILLER, ELORENE",0,1,-1
20314,5032840086,SI,240 SAND LANE,04,S5,"HYSENAGOLLI, NAIM",1,2,-1
20315,3014600063,BK, EASTERN PARKWAY,,Z9,"EASTERN PARKWAY PLAZA, INC.",0,1,-1
20316,4163500350,QN, ROCKAWAY POINT BLVD,11,V0,NYC DEPARTMENT OF CITYWIDE ADMINISTRATIVE SERVICES,0,1,-1
20317,3015720039,BK,2365 ATLANTIC AVENUE,02,C1,YBK 2365 LLC,0,1,-1
20318,5020910070,SI,45 HALL AVENUE,01,A5,"LIPSCHITZ, SHIMON",1,2,-1
20319,5032540054,SI,267 LAMPORT BOULEVARD,01,B2,RANDI VOY LATONA,1,2,-1
20320,5046590039,SI,82 ACORN STREET,01,A1,"BABIY, MARINA",1,2,-1
20321,5032320090,SI,95 RADCLIFF ROAD,01,A1,"SCOTTO, MICHAEL",0,1,-1
20322,3014700060,BK,1677 ST JOHNS PLACE,04,C7,ST. JOHNS USA LLC,1,2,-1
20323,3014270001,BK,445 TROY AVENUE,09,P6,MEI CHAYA MUSHKA MIKVAH INC,0,1,-1
20324,3018080049,BK,336 QUINCY STREET,02,C2,BROOKLYN 1001 LLC,0,1,-1
20325,5019910043,SI,126 ASHWORTH AVENUE,01,A5,"HOCK, JASON",1,2,-1
20326,3018150005,BK, TOMPKINS AVENUE,11,V1,"JOHNSON, CYNTHIA",0,1,-1
20327,2041110043,BX,1604 WILLIAMSBRIDGE ROAD,11,V1,1604 RAFFEALLA LLC,0,1,-1
20328,2045720027,BX,700 BURKE AVENUE,05,K1,UNAVAILABLE OWNER,0,1,-1
20329,3018870086,BK,140 CLINTON AVENUE,01,B9,"STUART, GREGORY",0,1,-1
20330,2042660009,BX, BOGART AVENUE,10,G0,NETTIE ZULLO IRREVOCABLE TRUST,0,1,-1
20331,5044260037,SI,3580 RICHMOND ROAD,01,A1,KENNETH E GOEHL,1,2,-1
20332,5047540040,SI,461 PROMENADE AVENUE,11,V0,HOUSING TRUST FUND CORPORATION,1,2,-1
20333,2044880168,BX, TIEMANN AVENUE,11,V0,SALVADOR L RONO,0,1,-1
20334,2045390018,BX,1670 EAST GUN HILL ROAD,04,S2,1668 EAST GUN HILL REALTY LLC,0,1,-1
20335,5031660021,SI,36 GRASMERE AVENUE,01,A5,"HUANG, LIQING",1,2,-1
20336,5031220094,SI,26 DOTY AVENUE,01,B9,"LI, CAROLYN MIRANDA",1,2,-1
20337,5076640350,SI,6450 AMBOY ROAD,01,A2,RANDY C PERROTH,2,3,-1
20338,2029040032,BX,1611 WASHINGTON AVENUE,10,G7,"RANKING ONE, LLC",0,1,-1
20339,4093750036,QN,121 STREET,11,V2,NAUTH ANGELA,0,1,-1
20340,3038150030,BK, LIVONIA AVENUE,07,U6,LIRR,0,1,-1
20341,2031280121,BX,944 EAST 181 STREET,02,C0,"SOSA, JOSE LUIS",2,3,-1
20342,5031020115,SI,78 SAVO LANE,01,A5,"DIGIOIA, LINA",1,2,-1
20343,5012680209,SI,270 SOUTH AVENUE,11,V1,SONNY'S PIER LLC,0,1,-1
20344,5077920316,SI,214 CHEEVERS LANE,01,A3,"RAO, DOMINICK",0,1,-1
20345,3039580008,BK,201 SHEPHERD AVENUE,01,B1,LAURIES GROUP INC,2,3,-1
20346,3031360020,BK,30 BELVIDERE STREET,02,C1,30 BELVEDERE DEVELOPMENT LLC,0,1,-1
20347,2032600048,BX,2877 HEATH AVENUE,01,B1,"LIN, LI MING",1,2,-1
20348,4093750025,QN,91-09 121 STREET,01,A9,VIJAY ARORA,1,2,-1
20349,4092810003,QN, HILLSIDE AVENUE,07,U7,LIRR,0,1,-1
20350,5080200123,SI, ELLIS STREET,11,V9,"BECK, THOMAS JR",0,1,-1
20351,3044520924,BK,554 SCHROEDERS AVENUE,01,A5,"THOMAS , CATHERINE",1,2,-1
20352,2048670070,BX,964 EAST 232 STREET,01,B1,"REID, DORRIT",1,2,-1
20353,5001000001,SI, BRIGHTON AVENUE,09,Q2,NYC DEPARTMENT OF PARKS AND RECREATION,0,1,-1
20354,3045700112,BK,1119 GRANT AVENUE,01,B1,GRNT LLC,1,2,-1
20355,5026250124,SI,127 BURKE AVENUE,01,B3,"DEL PINO, LORA A",1,2,-1
20356,5011510044,SI, GRANITE AVENUE,,Z9,VSDM DEVELOPMENT CORP.,0,1,-1
20357,2033590100,BX, NEWELL STREET,09,Q0,NYC DEPARTMENT OF PARKS AND RECREATION,0,1,-1
20358,5024450024,SI,47 LOTT LANE,01,A5,ROBERT T. ALESSI,1,2,-1
20359,5053100034,SI,50 GLOVER STREET,01,A2,ERASMO FERNANDEZ,1,2,-1
20360,2034300054,BX,624 HARDING PARK,01,A1,"VASQUEZ, FRANCISCO",0,1,-1
20361,2049050002,BX,1870 SCHIEFFELIN PLACE,08,N3,NYC ADMINISTRATION FOR CHILDRENS SERVICES,5,6,-1
20362,2050640010,BX, BULLARD AVENUE,07,U1,NYS DEPARTMENT OF TRANSPORTATION,0,1,-1
20363,3048990008,BK,428 EAST 46 STREET,04,D7,428 EAST 46 STREET LLC,1,2,-1
20364,3040780043,BK,656 WARWICK STREET,01,B1,"656 WARWICK REALTY, LLC",0,1,-1
20365,5080440062,SI,224 WOOD AVENUE,01,A1,CHARLES W EMANUEL,1,2,-1
20366,3081470060,BK,944 EAST 98 STREET,01,A1,"OYOLA, MAY L.",2,3,-1
20367,2027920024,BX,299 EAST MT EDEN AVENUE,10,G6,BRONX FOUR LOTS PARTNERSHIP,0,1,-1
20368,2037520151,BX,1159B ST LAWRENCE AVENUE,02,C0,"AHMED, IFJAL",1,2,-1
20369,3051040103,BK,852 ROGERS AVENUE,04,S9,854 ROGERS LLC,3,4,-1
20370,5004940024,SI, FRONT STREET,,Z9,CROWN ATLANTIC COMPANY LLC,0,1,-1
20371,2038450021,BX, BUTLER PLACE,11,V0,DEOCHAND MANGRU,0,1,-1
20372,4129650008,QN,133-16 227 STREET,01,A3,"MCMILLAN, HAZEL",1,2,-1
20373,3053660056,BK,1547 39 STREET,01,B1,LEOPOLD HALPERT,1,2,-1
20374,2054770045,BX, WILCOX AVENUE,11,V1,RALPH ABBATE,0,1,-1
20375,1006650006,MN, MARGINAL STREET,07,T9,NYS DEPARTMENT OF TRANSPORTATION,1,2,-1
20376,5001790009,SI,56 SOUTH STREET,01,B2,"CARBUCCIA, MARIO L",1,2,-1
20377,5010880050,SI,124 TREADWELL AVENUE,01,B2,"STERN, SHLOME",1,2,-1
20378,2055920134,BX,2817 SCHURZ AVENUE,01,B1,FLORENCE D BENVENUTO,1,2,-1
20379,4110830141,QN,213-19 99 AVENUE,06,E1,213 99 AVE REALTY CORP,1,2,-1
20380,2042670058,BX,1911 COLDEN AVENUE,02,C0,KENNETH LANGAN,1,2,-1
20381,3055080027,BK,2148 58 STREET,01,B3,"SCHWARTZ, CHAIM",1,2,-1
20382,5046450097,SI,64 WILLOW LANE,01,B9,"GENIN, KONSTANTIN",1,2,-1
20383,4090790003,QN,101-06 80 STREET,01,B2,"UDDIN, MOHAMMED A",1,2,-1
20384,5022880111,SI,393 EDINBORO ROAD,01,A3,LGL REALTY LLC,1,2,-1
20385,5057350351,SI,200 PRESENTATION CIRCLE,01,A5,"RUGGIERO, GREG",1,2,-1
20386,3056460027,BK,5018 FT HAMILTON PARKWAY,04,S2,REALTY 442 LLC,1,2,-1
20387,4114570021,QN,155-24 SAPPHIRE STREET,01,B2,"BAJWA, ZINDA M.",1,2,-1
20388,3036000037,BK,440 BRISTOL STREET,01,B1,"ALCIDE , RAYMOND",0,1,-1
20389,5002520099,SI,315A SHARON AVENUE,01,B2,SANTUCCI KATHLEEN,1,2,-1
20390,5002980065,SI,11 STARR AVENUE,01,A3,"KONSTANTINIDIS, APOSTOLOS",1,2,-1
20391,5062260045,SI, ANNADALE ROAD,10,G0,THOMAS G KANE,0,1,-1
20392,5021650200,SI, SOUTH AVENUE,11,V7,PORT AUTHORITY OF NY AND NJ,0,1,-1
20393,3055520044,BK,6502 17 AVENUE,01,B3,HONG YI ZENG,1,2,-1
20394,3058100044,BK,6 AVENUE,07,U7,LIRR,0,1,-1
20395,3005620001,BK,623 CLINTON STREET,10,G7,RED HOOK EQUITES LLC,0,1,-1
20396,3005870017,BK,87 DIKEMAN STREET,01,B9,"FLYNN, JENNIFER",0,1,-1
20397,4134190027,QN, ROCKAWAY BOULEVARD,10,G7,"MASTRONARDI BROTHERS, INC",0,1,-1
20398,3064130058,BK,124 BAY 29 STREET,01,B3,"PETITO, FERDINANDO",2,3,-1
20399,3040140039,BK,385 JEROME STREET,01,B2,"KHEMLAL, KOOLDIP",1,2,-1
20400,5003350037,SI,169 POTTER AVENUE,01,A1,"SANDERS, HERBERT",1,2,-1
20401,5003560246,SI,90 BENEDICT AVENUE,01,A1,LINDA A RUPERT,1,2,-1
20402,3009340016,BK, ST MARKS PLACE,11,V0,84 ST. MARKS VENTURES LLC,0,1,-1
20403,3009647501,BK,28 GARFIELD PLACE,03,R4,UNAVAILABLE OWNER,1,2,-1
20404,2047180012,BX, OAKLEY STREET,10,G0,DAVID & MERLE WHITE,0,1,-1
20405,2027280022,BX, SOUTHERN BOULEVARD,11,V1,LION STATE MANAGEMENT LLC,0,1,-1
20406,2048970053,BX,1220 EAST 223 STREET,01,A2,EARL & ERMA CLINTON,1,2,-1
20407,2049220010,BX,3665 MAROLLA PLACE,02,C0,"BARZEY, THOMAS B",1,2,-1
20408,4117150053,QN,122 PLACE,10,G7,SHABAD INTERNATIONALINC,0,1,-1
20409,5004340005,SI, WILLARD AVENUE,10,G0,KEVIN VINCENT FISHER,0,1,-1
20410,5004470043,SI, DEMOREST AVENUE,11,V0,JOSEPH J KIRSHY,0,1,-1
20411,2050580050,BX,4371A WILDER AVENUE,10,G0,GARTH COLE,0,1,-1
20412,5005230002,SI, WATER STREET,09,Q1,NYC DEPARTMENT OF PARKS AND RECREATION,0,1,-1
20413,3044520811,BK,580 EGAN STREET,01,A5,NEHEMIAH HDFC,1,2,-1
20414,2054410006,BX,502 LOGAN AVENUE,02,C0,"RODRIGUEZ, DAVID",1,2,-1
20415,1021700110,MN, HILLSIDE AVENUE,10,G6,21 HILLSIDE AVENUE,0,1,-1
20416,2055970027,BX,260 BUTTRICK AVENUE,01,B1,2787 MILES LLC,0,1,-1
20417,4090190028,QN,94-29 85 STREET,01,A1,J&B FONTANA PROTECTIVE TRUST DATED 08/14 /18,1,2,-1
20418,3016870069,BK,199 CHAUNCEY STREET,02,C2,UNAVAILABLE OWNER,1,2,-1
20419,1022150080,MN,1 TERRACE VIEW AVENUE,,Z9,NYC DEPARTMENT OF EDUCATION,2,3,-1
20420,1022370018,MN,12 CUMMING STREET,08,M1,THE BOARD OF MANAGERS OF THE DIOCESAN MI SSIONARY A,1,2,-1
20421,2056340008,BX,485 CITY ISLAND AVENUE,,Z9,AHT REALTY CORP,1,2,-1
20422,2027360070,BX,1162 GRINNELL PLACE,06,E9,STI REALTY LLC,2,3,-1
20423,5007630107,SI,296 GANSEVOORT BOULEVARD,01,A0,"NKA SANDRA L. SCAMARDELLA, SANDRA LORRAI NE SCAMARDELLA",2,3,-1
20424,3021320021,BK,178 BROADWAY,04,K4,P LUGER,2,3,-1
20425,2057490695,BX,681 WEST 231 STREET,01,A3,LEHMAN COLLEGE,1,2,-1
20426,3024567501,BK,113 SOUTH 6 STREET,04,RM,UNAVAILABLE OWNER,1,2,-1
20427,2058512074,BX, POST ROAD,10,G0,"LEE, KYUNG",0,1,-1
20428,5057350307,SI,169 PRESENTATION CIRCLE,01,A5,"MEDIATE, JASON",1,2,-1
20429,2059290001,BX, PALISADE AVENUE,09,Q1,NYC DEPARTMENT OF PARKS AND RECREATION,0,1,-1
20430,3033700006,BK, WILSON AVENUE,02,C1,WILSON REALTY USA LLC,0,1,-1
20431,4116950030,QN, LINCOLN STREET,11,V0,SHANNON GOKOOL,0,1,-1
20432,2024090059,BX,EAST 162 STREET,07,U6,MTA - METRO NORTH,0,1,-1
20433,3034340016,BK,1130 DECATUR STREET,01,B2,"LEE, CHRIS CHURL MIN",0,1,-1
20434,3069630002,BK, BAY VIEW AVENUE,10,G7,OCEANGATE LAND HOLDINGS LP,0,1,-1
20435,3069920028,BK, CONEY ISLAND AVENUE,11,V9,NYC DEPARTMENT OF CITYWIDE ADMINISTRATIVE SERVICES,0,1,-1
20436,3034720053,BK,23 STEWART STREET,07,G9,50 N.CLINTON AVE RLTY CP,0,1,-1
20437,5007420039,SI,535 WOOLLEY AVENUE,01,A2,"BERG-SCHULZ, LINDA S",1,2,-1
20438,5007740078,SI,627A WESTWOOD AVENUE,01,A5,"YESHIN, DMITRIY",1,2,-1
20439,3070830077,BK,1935 WEST 6 STREET,02,C0,"DUNN, MICHAEL",1,2,-1
20440,5007450051,SI,605 WOOLLEY AVENUE,01,A2,RAYMOND BLAIZE,1,2,-1
20441,5002350020,SI, DELAFIELD AVENUE,10,G0,FEASTER DOROTHY,0,1,-1
20442,5073170278,SI,129 PEMBROOK LOOP,01,A5,"KRISULAS, ARISTOMENO",1,2,-1
20443,2049530113,BX,4153 BOSTON ROAD,,Z9,THERESA MARCANTONIO/CO-TRUSTEE,0,2,-2
20444,4020180350,QN, HORACE HARDING EXPWY,07,U7,NYC TRANSIT AUTHORITY,0,2,-2
20445,5062200045,SI,10 ENDVIEW STREET,01,A5,"STEVENS, ANGELA",1,3,-2
20446,3074000005,BK,1511 AVENUE X,07,U7,NYC TRANSIT AUTHORITY,0,2,-2
20447,3030080010,BK,48 GRATTAN STREET,06,E1,TETRA MANAGEMENT INC.,1,3,-2
20448,5020910075,SI,59 HALL AVENUE,01,A5,"LIU, VICKY DONGQI",1,3,-2
20449,3072070011,BK,2571 WEST 13 STREET,11,V9,NYC TRANSIT AUTHORITY,0,2,-2
20450,4020180500,QN,6 OLMSTED DRIVE,07,T9,NYC DEPARTMENT OF PARKS AND RECREATION,8,10,-2
20451,5072060140,SI, INDUSTRIAL LOOP,,Z9,E GARY CLEMENTE,0,2,-2
20452,5070670117,SI,275 VETERANS ROAD WEST,06,E7,PATRIOT SELF STORAGE LLC,2,4,-2
20453,4008480032,QN,29-10 20 AVENUE,06,E9,LICO HOLDING COMPANY,1,3,-2
20454,4037300031,QN,57 STREET,11,V0,BERNABE FIGUEROA,0,2,-2
20455,5069790100,SI,152 EL CAMINO LOOP,01,B9,"TANG , CHENG ZONG",1,3,-2
20456,3011750039,BK, STERLING PLACE,07,U7,NYC TRANSIT AUTHORITY,0,2,-2
20457,5002380269,SI,331 JEWETT AVENUE,01,B2,"BARRIOS, YESENIA",1,3,-2
20458,4088210031,QN,263 STREET,11,V0,"PHILIP, ROBIN",0,2,-2
20459,5071050485,SI, ARTHUR KILL ROAD,11,V8,N Y STATE(PARKS),0,2,-2
20460,2024430080,BX,780 CONCOURSE VILLAGE W,06,F5,770 CONCOURSE VILLAGE WEST LLC,1,3,-2
20461,3072080012,BK,74 AVENUE X,09,Q6,NYC DEPARTMENT OF CITYWIDE ADMINISTRATIVE SERVICES,1,3,-2
20462,4142310769,QN,153 HAWTREE BASIN,11,V0,"DANY FAYZAK, LLC",2,4,-2
20463,4083100225,QN,244-78 61 AVENUE,09,Q5,NYC DEPARTMENT OF PARKS AND RECREATION,1,3,-2
20464,5003560191,SI, BENEDICT AVENUE,11,V0,UNAVAILABLE OWNER,0,2,-2
20465,5073110019,SI, STORER AVENUE,11,V1,ANNA SVEINSDOTTIR,0,2,-2
20466,4049770067,QN,136-93 37 AVENUE,05,K2,FIRST JUNE REALTY COR,1,3,-2
20467,3085910200,BK, FLATBUSH AVENUE,07,Y7,TOYSRUS-DELAWARE INC.,0,2,-2
20468,4115190071,QN, CENTREVILLE STREET,10,G7,"TECHNICAL AUTO & TRUCK REPAIRS, INC",0,2,-2
20469,4127130015,QN,123-23 NELLIS STREET,01,A2,"JUDE, CARLTON",1,3,-2
20470,2045510021,BX, MATTHEWS AVENUE,10,G0,ALLERTON DVLPMNT CORP,0,2,-2
20471,5033437501,SI,230 SEAVIEW AVENUE,02,R3,UNAVAILABLE OWNER,2,4,-2
20472,4065170050,QN,65-32 KISSENA BOULEVARD,08,W6,QUEENS COLLEGE,1,3,-2
20473,2024430072,BX, SHERIDAN AVENUE,07,U8,MTA - METRO NORTH,0,2,-2
20474,4153010250,QN,2 ROAD,11,V0,BROAD CHANNEL ATHLETIC CLUB,0,2,-2
20475,2025990200,BX,,07,U6,NATL RR PASSENGER COR,0,2,-2
20476,5077860093,SI,10 PAGE AVENUE,09,Q6,NYC DEPARTMENT OF YOUTH AND COMMUNITY DEVELOPMENT,0,2,-2
20477,2026777501,BX,819 EAST 161 STREET,02,R3,UNAVAILABLE OWNER,48,50,-2
20478,4136800118,QN, CRAFT AVENUE,11,V0,NYC DEPARTMENT OF CITYWIDE ADMINISTRATIVE SERVICES,0,2,-2
20479,2055160001,BX,8C EDGEWATER PARK,01,A8,EDGEWATER PARK OWNRSETC,38,40,-2
20480,4043910013,QN,122 STREET,,Z9,COLLEGE POINT ASSOCIATES LLC,0,2,-2
20481,5046780041,SI, GUYON AVENUE,01,A1,GUYON ESTATES LLC,0,2,-2
20482,4140050100,QN,160 AVENUE,07,U2,CON EDISON CO,0,2,-2
20483,3014530025,BK,1978 BERGEN STREET,02,C0,"BOYD, RASHARD",2,4,-2
20484,2050870001,BX,748 EAST 241ST STREET,11,V1,ENCLAVE ON 241 STREET LLC,1,3,-2
20485,5035000140,SI,453 FATHER CAPODANNO BL,01,A5,"RIZK, SAMUEL",1,3,-2
20486,2033990001,BX,,07,U9,NYC WATER RESOURCES,0,2,-2
20487,4036850082,QN,69 PLACE,10,G0,DOLPHIN JOHN,0,2,-2
20488,5044750350,SI, AMBOY ROAD,09,Z8,OCEAN VIEW CEMETERY,0,2,-2
20489,4151000460,QN,159 STREET,09,Q1,NATIONAL PARK SERVICE,1,3,-2
20490,5069010299,SI,5941 AMBOY ROAD,01,B9,UNAVAILABLE OWNER,0,2,-2
20491,5033770098,SI, DEA COURT,11,V0,"CARONE, NATALIE A",0,2,-2
20492,3025717501,BK,84 OAK STREET,02,R3,UNAVAILABLE OWNER,1,3,-2
20493,2030060017,BX,1040 HOME STREET,07,G9,NYC ECONOMIC DEVELOPMENT CORPORATION,0,2,-2
20494,3017610042,BK,707 WILLOUGHBY AVENUE,03,D1,THE WILLART LLC,1,3,-2
20495,4008140028,QN, STEINWAY STREET,07,U0,UNAVAILABLE OWNER,0,2,-2
20496,2056240002,BX,86 ROCHELLE STREET,01,A9,"MAZZELLA, SILVERIO",1,3,-2
20497,2054080143,BX, RAWLINS AVENUE,11,V0,"COLON, ANA M",0,2,-2
20498,5026540045,SI,266 WEST SERVICE ROAD,05,G8,"VALENCIA DEVELOPERS, INC",3,5,-2
20499,4005090047,QN, BLACKWELLS LANE,10,G7,LITO PROPERTIES LLC,0,2,-2
20500,2056290127,BX,52 HAWKINS STREET,01,A2,"BLANKS, JANIE M",0,2,-2
20501,4159050215,QN,150 BEACH 67 STREET,01,B2,"JOSEPH, RICHARD",1,3,-2
20502,5011830017,SI, FOREST AVENUE,07,U2,CON EDISON,0,2,-2
20503,4010160450,QN,49-02 ASTORIA BOULEVARD SOUTH,09,Z8,ST. MICHAELS PROTESTANTS EPISCOPAL,10,12,-2
20504,4016010057,QN,44 AVENUE,11,V0,MONICA CARCAMO,0,2,-2
20505,5013180204,SI,138 HOLLAND AVENUE,02,C2,"GALANTE, ANTHONY",1,3,-2
20506,4005707505,QN,23-28 30 DRIVE,04,RM,UNAVAILABLE OWNER,1,3,-2
20507,5012900070,SI,90 NORTHFIELD AVENUE,,Z9,BIAGGIO SEVERINO,0,2,-2
20508,3010870010,BK,588 8 AVENUE,08,M9,"ST. SAVIOUR'S ROMAN CATHOLIC CHURCH, BRO OKLYN, NY",1,3,-2
20509,5001780089,SI, CASTLETON AVENUE,10,G7,FOYER SUNG,0,2,-2
20510,4015440029,QN,83-04 BROADWAY,05,O5,XIAOPING FAN,1,3,-2
20511,1004930030,MN, SPRING STREET,09,Q9,NYC DEPARTMENT OF CITYWIDE ADMINISTRATIVE SERVICES,0,2,-2
20512,5063680003,SI,253 HOLDRIDGE AVENUE,01,Z0,PETER DEFILIPPO,0,2,-2
20513,3058040091,BK, SHORE ROAD,07,U0,UNAVAILABLE OWNER,0,2,-2
20514,4038860038,QN, WOODHAVEN BOULEVARD,07,U7,NYC DEPARTMENT OF CITYWIDE ADMINISTRATIVE SERVICES,0,2,-2
20515,4038860138,QN,78 AVENUE,07,U7,"BACK GLEN ASSOCIATES, LLC",0,2,-2
20516,4088100083,QN,265 STREET,11,V0,"NG, DANNY W",0,2,-2
20517,3020880030,BK,147 ASHLAND PLACE,10,G1,ASHLAND PLACE HOUSES INC,1,3,-2
20518,3049490031,BK,1270 NEW YORK AVENUE,03,D1,1270 NY AVE. LLC,1,3,-2
20519,1011090100,MN, PIER,07,T9,NYS DEPT  OF ENVIR CONSV,1,3,-2
20520,2056500002,BX,3 PELHAM BAY PARK,09,Q1,NYC DEPARTMENT OF PARKS AND RECREATION,1,3,-2
20521,4027900001,QN,67-29 METROPOLITAN AVENUE,09,Z8,LUTHERAN CEMETERY,14,16,-2
20522,4080990227,QN,235 STREET,09,Q1,NYC DEPARTMENT OF PARKS AND RECREATION,0,2,-2
20523,3072790124,BK,WEST 8 STREET,07,U7,NYC TRANSIT AUTHORITY,0,2,-2
20524,4159050241,QN,66-03 SURF AVENUE,01,B2,"FARINA, MICHAEL",1,3,-2
20525,2040080003,BX, BRONX PARK AVENUE,11,V1,MANUEL RODRIGUEZ,0,2,-2
20526,3028130050,BK, CHERRY STREET,,Z9,UNAVAILABLE OWNER,0,2,-2
20527,2027980050,BX,1751 TOPPING AVENUE,02,C1,MERCEDES JIMENEZ,1,3,-2
20528,1009880075,MN, AVENUE C,07,T2,NYC DEPARTMENT OF SMALL BUSINESS SERVICES,0,2,-2
20529,2030170006,BX, WESTCHESTER AVENUE,07,U6,CITY OF NEW YORK,0,2,-2
20530,1004080028,MN,324 GRAND STREET,04,D6,EMPIRE 326 GRAND LLC,1,3,-2
20531,5060120054,SI, RUXTON AVENUE,11,V0,DAVY L ROBBINS,0,2,-2
20532,5001840142,SI, RICHMOND TERRACE,07,T2,CADDELL DRYDOCK REPAIR CO INC,0,2,-2
20533,5038680001,SI, FATHER CAPODANNO BL,09,Q1,NYC DEPARTMENT OF PARKS AND RECREATION,1,3,-2
20534,3004770001,BK, SMITH STREET,07,U9,NYC TRANSIT AUTHORITY,0,2,-2
20535,4112140042,QN,216-25 113 AVENUE,01,A1,VERDAN E TUITT,1,3,-2
20536,2054850009,BX,620 WILCOX AVENUE,10,G0,"TENGA, LISA",0,2,-2
20537,5001840360,SI,2945 RICHMOND TERRACE,06,F5,CADDELL DRY DOCK & REPAIR CO  INC,2,4,-2
20538,4027370076,QN,60 LANE,10,G7,TWO G CORP,0,2,-2
20539,5001980007,SI,159 TAYLOR STREET,11,V0,"CEE JAY REAL ESTATE DEVELOPMENT CORP,",0,2,-2
20540,1009950001,MN,1475 BROADWAY,04,K4,"JAMESTOWN OTS, L.P.",1,3,-2
20541,5005930725,SI,225 ARLO ROAD,01,A5,JOHN RADEMAKER,1,3,-2
20542,1021350060,MN,158-18 RIVERSIDE DRIVE WEST,03,D4,RIVER ARTS COOPEARTIVE,1,3,-2
20543,1000540030,MN, LIBERTY STREET,09,Q1,PORT AUTHORITY OF NY AND NJ,0,2,-2
20544,4082670039,QN, CONCORD STREET,11,V0,"GLENIS, FREDERIKI",0,2,-2
20545,4081890019,QN,244 STREET,11,V0,"RAYMOND LEBLOND, AS TRUSTEE",0,2,-2
20546,5080440079,SI,254 WOOD AVENUE,01,B2,GARY GRANDSTAFF,0,2,-2
20547,5031130067,SI, CEDAR AVENUE,10,G0,LEI ZHANG,0,2,-2
20548,5075290026,SI, WANIER AVENUE,11,V9,NYC DEPARTMENT OF CITYWIDE ADMINISTRATIVE SERVICES,0,2,-2
20549,4028080126,QN,73 STREET,11,V0,R E KELLY,0,2,-2
20550,3056990056,BK,1441 58 STREET,01,B2,1441 58 ST EQUITY PARTNERS LLC,0,2,-2
20551,3080550001,BK, AVENUE L,07,U2,CON EDISON,0,2,-2
20552,4098870051,QN, MAYFIELD ROAD,11,V0,"KANJANINTORN, NIYOM",0,2,-2
20553,4003240014,QN,34-29 9 STREET,02,C0,DOUBLE MC LLC,0,2,-2
20554,3023120023,BK,187 NORTH 8 STREET,11,V1,DRIGGS PARTNERS LLC,0,2,-2
20555,5011520115,SI, MORNINGSTAR ROAD,,Z9,LINDA AUBREY,0,2,-2
20556,4005720001,QN,23-43 30 ROAD,08,M1,R C CHURCH OF REDEEME,1,3,-2
20557,2056060136,BX, GRAFF AVENUE,10,G0,FRANK LEONE,0,2,-2
20558,4085350002,QN,75-44 263 STREET,02,C6,GLEN OAKS VILLAGE OWNERS INC,100,102,-2
20559,4154000999,QN, CROSS BAY BOULEVARD,11,V0,NATIONAL PARK SERVICE,0,2,-2
20560,4000180005,QN,5 STREET,09,Q9,QUEENS WEST DEVELOPME,0,2,-2
20561,4062900009,QN, BELL BOULEVARD,07,U7,LIRR,0,2,-2
20562,5036230010,SI,104 OTIS AVENUE,01,B2,"ANDERSON, DONNA E",0,2,-2
20563,5017250600,SI, WEST SHORE EXPWY,11,V9,BLOOMFIELD CONSERVANC,0,2,-2
20564,3019200001,BK,255 RYERSON STREET,08,W9,PRATT INSTITUTE,6,8,-2
20565,5012480001,SI, MERSEREAU AVENUE,07,U9,UNAVAILABLE OWNER,0,2,-2
20566,5028990318,SI, GEO COURT,11,V0,MOSEL-2 LLC,0,2,-2
20567,4102440012,QN,169-06 107 AVENUE,01,B2,"CHURAMAN, VICTOR",0,2,-2
20568,4032050008,QN,68-20 BURNS STREET,03,D4,BURNS ST OWNERS CORP,1,3,-2
20569,4088100090,QN,276 85 AVENUE,10,G0,"DHARIA, RAJESHREE",0,2,-2
20570,5073100006,SI, MURIEL STREET,11,V1,ML SHARROTTS REALTY LLC,0,2,-2
20571,5011600084,SI,48 LAKE AVENUE,01,B2,48 LAKE AVENUE LLC,0,2,-2
20572,4060180011,QN,28-29 215 PLACE,11,V0,"PERICIC, TONKO",0,2,-2
20573,4041580001,QN,144 STREET,11,V1,NAME NOT ON FILE,0,2,-2
20574,3039830013,BK,333 WARWICK STREET,01,B1,LIBERTY WARWICK LLC,1,3,-2
20575,2041390014,BX, HALPERIN AVENUE,07,U7,NYC TRANSIT AUTHORITY,0,2,-2
20576,2048190013,BX,3923 CARPENTER AVENUE,02,C0,3921 CARPENTER LLC,2,4,-2
20577,2057860195,BX, JOHNSON AVENUE,02,C0,UNAVAILABLE OWNER,0,2,-2
20578,1018010100,MN,EAST 124 STREET,11,V1,NYC HOUSING AUTHORITY,0,2,-2
20579,4008420008,QN,23-35 29 STREET,09,Q2,NYC DEPARTMENT OF EDUCATION,1,3,-2
20580,2052710060,BX, ROMBOUTS AVENUE,11,V1,3446 ROMBOUTS AVENUE,0,2,-2
20581,5034120093,SI, PEARSALL STREET,11,V0,VIRGINIA ROJACK,0,2,-2
20582,3003307506,BK,139 SACKETT STREET,02,R1,135 - 139 SACKETT STREET LLC,1,3,-2
20583,3001990130,BK,258 FURMAN STREET,07,U7,NYC TRANSIT AUTHORITY,0,2,-2
20584,4088090081,QN,134 265 STREET,10,G0,"KAISER, GUENTHER",0,2,-2
20585,3055810046,BK,9 AVENUE,07,U7,NYC TRANSIT AUTHORITY,0,2,-2
20586,4088280081,QN,87 AVENUE,11,V0,"JAINARINE, MICHAEL",0,2,-2
20587,5009280001,SI, KESSELMAN AVENUE,11,V0,BOY SCOUTS OF AMERICA,0,2,-2
20588,5026280010,SI, BURKE AVENUE,11,V0,"PETE ROCK, INC.",0,2,-2
20589,4036190110,QN, MADISON STREET,07,U7,NYC TRANSIT AUTHORITY,0,2,-2
20590,3042710060,BK, LINCOLN AVENUE,07,U7,NYC TRANSIT AUTHORITY,0,2,-2
20591,4011550035,QN,53-09 BROADWAY,05,K1,UNAVAILABLE OWNER,1,3,-2
20592,5028470180,SI, VIRGINIA AVENUE,11,V0,105 TILSON PLACE LLC,0,2,-2
20593,2055160093,BX,18 ALDEN PARK,01,A8,EDGEWATER PARK OWNRSETC,3,5,-2
20594,5009020001,SI, TODT HILL ROAD,09,Q5,NYS DEPARTMENT OF ENVIRONMENTAL CONSERVATION,1,3,-2
20595,4018330001,QN, ROOSEVELT AVENUE,07,U7,LIRR,2,4,-2
20596,4012940001,QN, WOODSIDE AVENUE,07,U7,LIRR,0,2,-2
20597,4089750066,QN,93-12 89 AVENUE,01,B2,CHIU MO FERRARINI,2,4,-2
20598,2032450012,BX,WEST 192 STREET,07,U6,MTA - METRO NORTH,0,2,-2
20599,5019930014,SI,1055 ROCKLAND AVENUE,01,Z0,UNAVAILABLE OWNER,0,2,-2
20600,4038110058,QN,73-38 COOPER AVENUE,07,G4,73-38 COOPER AVE LLC,2,4,-2
20601,4101330034,QN,154-14 107 AVENUE,02,C0,"SINGH, MANJIT",2,4,-2
20602,5027830048,SI,3939 VICTORY BOULEVARD,01,A1,HOMES ON VICTORY LLC,1,3,-2
20603,1018970019,MN, HENRY HUDSON PARKWAY,07,Y7,NYC DEPARTMENT OF PARKS AND RECREATION,2,4,-2
20604,2026880165,BX, LONGWOOD AVENUE,11,V0,"LONGWOOD III HOMEOWNERS ASSOCIATION, INC .",0,2,-2
20605,3069120016,BK,BAY 44 STREET,11,V0,UNAVAILABLE OWNER,0,2,-2
20606,4108120086,QN,225 STREET,07,U7,LIRR,0,2,-2
20607,3072167501,BK,2536 EAST 1 STREET,02,R3,UNAVAILABLE OWNER,1,3,-2
20608,4003130101,QN, VERNON BOULEVARD,10,G7,NYC DEPARTMENT OF PARKS AND RECREATION,0,2,-2
20609,4126580018,QN,119-26 202 STREET,01,B2,"JOSEPH, LEOVANE",1,3,-2
20610,4091090018,QN,89-19 LIBERTY AVENUE,11,V1,"89-19 LIBERTY AVENUE, LLC",0,2,-2
20611,2055170001,BX,36A EDGEWATER PARK,01,A8,EDGEWATER PK OWNERS COOPERATIV,46,48,-2
20612,4118200034,QN,119-16 149 AVENUE,01,B2,"SOOKHOO, BIBI",1,3,-2
20613,3072070016,BK,WEST 11 STREET,11,V9,NYC TRANSIT AUTHORITY,0,2,-2
20614,4121620032,QN, BRINKERHOFF AVENUE,07,U7,LIRR,0,2,-2
20615,2042860040,BX, MARAN PLACE,11,V1,MARAN PLACE LLC,0,2,-2
20616,2054960001,BX,26E EDGEWATER PARK,01,A8,EDGEWATER PARK OWNER CO,14,16,-2
20617,3078020019,BK,1265 EAST 54 STREET,02,C0,KCR LLC,1,3,-2
20618,3057050050,BK,5815 NEW UTRECHT AVENUE,02,C0,VOIE FERREE LLC,1,3,-2
20619,4102590001,QN,109 AVENUE,07,U9,"SUSANKAR, SEEBINDRANATH",0,2,-2
20620,4163500076,QN,BEACH 193 STREET,11,V1,UNITED STATES OF AMERICA,0,2,-2
20621,3056867504,BK,869 57TH STREET,04,RM,869 CENTRAL LLC,1,3,-2
20622,4097740166,QN,161-79 86 AVENUE,01,B3,"QUIROZ, MANUEL",0,2,-2
20623,4125170063,QN,126 AVENUE,10,G0,CREST HOLDING CORP.,1,3,-2
20624,2057420136,BX,3128 HENRY HUDSON PKWY E,04,D7,3128 LLC,1,3,-2
20625,5009550170,SI,150 BRIELLE AVENUE,08,I9,NYC HEALTH AND HOSPITALS CORPORATION,1,3,-2
20626,4039160108,QN, POWELLS COVE BLVD,11,V3,POWELL COVE ESTATES HOME OWNER,0,2,-2
20627,4020181500,QN,120-20 ROOSEVELT AVENUE,10,G6,NYC DEPARTMENT OF PARKS AND RECREATION,1,3,-2
20628,3075600013,BK,773 EAST 32 STREET,02,C2,771 EAST 32 LLC,0,2,-2
20629,2042590127,BX,1927A HOLLAND AVENUE,11,V0,JOAQUIN VERGARA,0,2,-2
20630,1012540001,MN, RIVERSIDE DRIVE,09,Q1,NYC DEPARTMENT OF PARKS AND RECREATION,1,3,-2
20631,3047800107,BK,1252 UTICA AVENUE,05,K1,212 FIFTH AVENUE LLC,1,3,-2
20632,3036310021,BK, OSBORN STREET,11,V0,LINROC NURSING HOMEINC,0,2,-2
20633,2030060049,BX, FREEMAN STREET,05,GW,1301 WESTCHESTER AVEASC,0,2,-2
20634,3049850025,BK,703 EAST 38 STREET,02,C2,"ESTERVIL, ODNAY",1,3,-2
20635,5072070283,SI, JOHNSON STREET,11,V1,BLUE PRINT METALS INC,0,2,-2
20636,5024507512,SI,82 BELMAR DRIVE WEST,02,R3,OAKS AT LATOURETTE CONDO,92,94,-2
20637,4043780001,QN,31 ROAD,11,V1,COLLEGE POINT ASSOCIATES LLC,0,2,-2
20638,3063280065,BK,84 STREET,02,C0,1929 84TH STREET LLC,0,2,-2
20639,3011340067,BK, DEAN STREET,10,G7,TC SON CORP,0,2,-2
20640,5038680060,SI, FR CAPODANNO BLVD,09,Q4,NYC DEPARTMENT OF PARKS AND RECREATION,0,2,-2
20641,2041400011,BX,1425 ST RAYMOND AVENUE,07,U7,NYC TRANSIT AUTHORITY,0,2,-2
20642,4007900071,QN,18-66 45 STREET,10,G7,"THREE BROS.ESTATES,INC.",0,2,-2
20643,4011830017,QN,33-22 61 STREET,01,B3,UNAVAILABLE OWNER,1,3,-2
20644,3070710016,BK,WEST 22 STREET,11,V0,WEST 16-22 ST REALTYINC,0,2,-2
20645,2040250018,BX,644 BAKER AVENUE,11,V0,"BLANCAS, JOSE E",0,2,-2
20646,4112130037,QN,217-13 112 ROAD,01,B1,SILVERLINE HOMES INC.,1,3,-2
20647,4093520041,QN,120-01 ATLANTIC AVENUE,04,K4,121 ATLANTIC AVENUE LLC,1,3,-2
20648,2032100001,BX, WEST BURNSIDE AVENUE,11,V1,NYC DEPARTMENT OF PARKS AND RECREATION,0,2,-2
20649,5012900350,SI,46 DOLSON PLACE,06,E9,"DOLSON EQUITIES, LLC",1,3,-2
20650,5001450009,SI, DE KAY STREET,11,V0,J & PAN'S ENTERPEISE LLC,0,2,-2
20651,1004947501,MN,41 SPRING STREET,02,R1,NAME NOT ON FILE,2,4,-2
20652,3020110001,BK,547 CLINTON AVENUE,07,U6,VERIZON NEW YORK INC,1,3,-2
20653,2050070031,BX, GUNTHER AVENUE,11,V0,CITY OF NEW YORK,0,2,-2
20654,4078800200,QN,80-09 WINCHESTER BOULEVARD,08,I5,LIFELINE CNTR CHILDDEV,2,4,-2
20655,5010500018,SI, CORNELL STREET,01,Z0,DANIEL T SULLIVAN,0,2,-2
20656,4015360085,QN, QUEENS BOULEVARD,07,U7,LIRR,0,2,-2
20657,4033790044,QN,406 GRANDVIEW AVENUE,10,G0,"KONOPKA, KERSTIN",0,2,-2
20658,4122100032,QN,119-12 153 STREET,01,B2,"BAWA, PRITHPAL",2,4,-2
20659,2039520023,BX,1597 UNIONPORT ROAD,11,V1,ZP REALTY LLC,0,2,-2
20660,4036670775,QN,65 PLACE,07,U7,LIRR,0,2,-2
20661,5044780400,SI, CORONA AVENUE,,Z7,UNAVAILABLE OWNER,0,2,-2
20662,5072070060,SI, ARTHUR KILL ROAD,11,V1,KINDER MORGAN LIQUIDS TERMINALS LLC,0,2,-2
20663,4024830106,QN,72 PLACE,10,G0,GALLO PAOLO,0,2,-2
20664,4121780082,QN,159-17 MEYER AVENUE,07,G2,"BRANCATO, VINCENT",1,3,-2
20665,5073170249,SI, BLOOMINGDALE ROAD,01,Z0,SHARROTTS ESTATES,1,3,-2
20666,3075630058,BK,1626 BROOKLYN AVENUE,02,C1,1630 BROOKLYN AVE LLC,0,2,-2
20667,3007450017,BK,230 45 STREET,,Z9,"PRONAR REALTY, LLC",0,2,-2
20668,5024500601,SI,10 PIERPONT PLACE,09,Q9,THE OAKS H O A,1,3,-2
20669,2049400022,BX, PRATT AVENUE,11,V0,PETER LOUIS CAIOLA,0,2,-2
20670,3068050050,BK,2205 AVENUE R,08,W2,2201 AVENUE R LLC,2,4,-2
20671,2050350034,BX,4377 BRONX BOULEVARD,05,O2,4377 BRONX BLVD REALTY LLC,1,3,-2
20672,4159050142,QN,174 SALTAIRE LANE,01,B2,"EGEREONU, FRANK O",1,3,-2
20673,5002080018,SI,55 CAROLINE STREET,01,A1,"HOBAN, DENNIS",1,3,-2
20674,2055300001,BX, FT SCHUYLER PARK,08,Y4,NEW YORK STATE HOUSING FINANCE,1,3,-2
20675,5076640360,SI,361 SHARROTT AVENUE,09,Z8,TR-ST PATRICKS CATHEDRAL,2,4,-2
20676,3072470125,BK, NEPTUNE AVENUE,11,V1,NYC DEPARTMENT OF SMALL BUSINESS SERVICES,0,2,-2
20677,2027880001,BX, EAST MT EDEN AVENUE,09,Q1,NYC DEPARTMENT OF PARKS AND RECREATION,4,7,-3
20678,5018010075,SI,360 INDUSTRY ROAD,06,F2,VANBRO CORPORATION,10,13,-3
20679,5014680032,SI,292 WOOLLEY AVENUE,10,G0,"MARINO, HANNA",0,3,-3
20680,3069430427,BK, HUNTER AVENUE,11,V1,1900 ACQUISITION LLC,0,3,-3
20681,5000850047,SI, BRIGHTON AVENUE,10,G7,ROBERT BRIGGS,0,3,-3
20682,2055140062,BX,6D EDGEWATER PARK,01,A8,EDGEWATER PARK OWNRSETC,61,64,-3
20683,2055170101,BX,1A EDGEWATER PARK,01,A8,EDGEWATER PARK OWNER CO,40,43,-3
20684,4031020046,QN,63 AVENUE,07,U7,LIRR,0,3,-3
20685,4011140001,QN,31 AVENUE,07,U6,NEW YORK CENTRAL LINES,0,3,-3
20686,4159050156,QN,169 WHITE SANDS WAY,01,B2,"LOUIS, RACHELLE",1,4,-3
20687,5013970001,SI, FOREST AVENUE,11,V7,PORT AUTHORITY OF NY AND NJ,0,3,-3
20688,2032510450,BX, PAUL AVENUE,07,U7,NYC TRANSIT AUTHORITY,0,3,-3
20689,3087207507,BK,45 OCEANA DRIVE EAST,03,R4,UNAVAILABLE OWNER,1,4,-3
20690,5021650090,SI, SOUTH AVENUE,11,V7,PORT AUTHORITY OF NY AND NJ,0,3,-3
20691,3071430005,BK, AVENUE V,07,U7,NYC TRANSIT AUTHORITY,0,3,-3
20692,2054170050,BX, OUTLOOK AVENUE,11,V1,NYS OFFICE OF GENERAL SERVICES,0,3,-3
20693,5077300092,SI, PAGE AVENUE,11,V0,NYC DEPARTMENT OF CITYWIDE ADMINISTRATIVE SERVICES,0,3,-3
20694,4125290012,QN, FARMERS BOULEVARD,07,U7,LIRR,0,3,-3
20695,2049440022,BX, SECOR AVENUE,07,U7,NYC TRANSIT AUTHORITY,0,3,-3
20696,5027740068,SI, VICTORY BOULEVARD,11,V0,FRANCESCO COLUCCIO,0,3,-3
20697,2025830002,BX,EAST 132 STREET,07,U6,CONSOLIDATED RAIL CORPORATION,0,3,-3
20698,4078800550,QN,239-30 UNION TURNPIKE,08,I1,"AYER RE DEVELOPMENT, LLC",0,3,-3
20699,4032340048,QN, BURNS STREET,07,U7,LIRR,0,3,-3
20700,5055590260,SI, ARTHUR KILL ROAD,07,Y6,NYC DEPARTMENT OF ENVIRONMENTAL PROTECTION,0,3,-3
20701,4113890001,QN, LINDEN BOULEVARD,11,V0,NYC DEPARTMENT OF PARKS AND RECREATION,0,3,-3
20702,4092450061,QN,125 STREET,07,U7,LIRR,0,3,-3
20703,4108170067,QN,99 AVENUE,07,U7,LIRR,0,3,-3
20704,3002957503,BK,78 AMITY STREET,04,RM,"VEGA 12, LLC",1,4,-3
20705,5045830275,SI, ARTHUR KILL ROAD,11,V0,NYC DEPARTMENT OF CITYWIDE ADMINISTRATIVE SERVICES,0,3,-3
20706,4038100350,QN,80-00 COOPER AVENUE,05,K6,"WMAP, L.L.C.",11,14,-3
20707,2055990041,BX,2626 MILES AVENUE,01,B2,"LIZ-RAMIREZ, MATTHEW",2,5,-3
20708,4007660036,QN,19 AVENUE,11,V9,NYC DEPARTMENT OF SMALL BUSINESS SERVICES,0,3,-3
20709,4160920001,QN,BEACH 73 STREET,11,V0,HARBOUR POINTE AT ARVERNE BY THE,3,6,-3
20710,3044520002,BK, SHORE PARKWAY,09,Q1,NATIONAL PARK SERVICE,1,4,-3
20711,5031970040,SI, PARKINSON AVENUE,07,U6,MTA - STATEN ISLAND RAILWAY,0,3,-3
20712,5009340250,SI, RICHMOND ROAD,09,Z8,UNITED BRETHRENS CHURCH,1,4,-3
20713,4063160001,QN,41 AVENUE,07,U7,LIRR,0,3,-3
20714,4000650001,QN,11 STREET,11,V9,NYS DEPARTMENT OF TRANSPORTATION,0,3,-3
20715,2051350100,BX, BOLLER AVENUE,07,U6,PENN CENTRAL COMPANY,0,3,-3
20716,4102190078,QN, DOUGLAS AVENUE,07,U7,LIRR,0,3,-3
20717,2039630001,BX,2211 WESTCHESTER AVENUE,11,V0,WESTCAST DEVELOPMENT LLC,0,3,-3
20718,4040330015,QN,12 AVENUE,10,G7,"STEEL POINT, LLC",0,3,-3
20719,5008990001,SI,2051A RICHMOND ROAD,05,K1,"C-SAW, LLC",1,4,-3
20720,4098430015,QN, HIGHLAND AVENUE,07,U9,NYC DEPARTMENT OF ENVIRONMENTAL PROTECTION,0,3,-3
20721,3070440025,BK, ATLANTIC AVENUE,09,Q7,SEA GATE ASSN,0,3,-3
20722,4159050041,QN,138 COMPASS PLACE,01,B2,"ZHENG, DI FAN",1,4,-3
20723,3058060088,BK,2 AVENUE,07,T9,NYC DEPARTMENT OF SMALL BUSINESS SERVICES,0,3,-3
20724,5006470027,SI,317 HILLSIDE AVENUE,01,A1,"WILLIAMS, CLARENCE KIRK",0,3,-3
20725,5009290001,SI, MAYER AVENUE,11,V0,BOY SCOUTS OF AMERICA,0,3,-3
20726,1011870003,MN, RIVERSIDE PARK,09,Q8,NYC DEPARTMENT OF PARKS AND RECREATION,0,4,-4
20727,4155290004,QN, MOTT AVENUE,07,U7,LIRR,0,4,-4
20728,4041590001,QN,144 STREET,11,V1,NAME NOT ON FILE,0,4,-4
20729,5018010095,SI, CHELSEA ROAD,07,U1,CITY OF NEW YORK,0,4,-4
20730,3070310001,BK, MERMAID AVENUE,11,V3,SEAGATE ASSN,0,4,-4
20731,4058570002,QN,13-04 BELL BOULEVARD,02,C6,"BAY TERRACE COOPERATIVE SECTION I, INC.",64,68,-4
20732,3009770003,BK,2 2 AVENUE,11,V1,NYC DEPARTMENT OF SANITATION,0,4,-4
20733,2055290399,BX, TIERNEY PLACE,11,V0,NY STATE PUBLIC WORKS,0,4,-4
20734,2041340014,BX, BLONDELL AVENUE,07,U7,NYC TRANSIT AUTHORITY,0,4,-4
20735,4160960050,QN,BEACH 73 STREET,11,V0,UNAVAILABLE OWNER,0,4,-4
20736,5012080026,SI,3245 RICHMOND TERRACE,07,T9,EGRET REALTY CORP,1,5,-4
20737,1009017501,MN,200 EAST 21ST STREET,04,RM,LONGER HILLS II LLC,1,5,-4
20738,3009030254,BK,8 AVENUE,07,U0,UNAVAILABLE OWNER,0,4,-4
20739,5071670070,SI, ARTHUR KILL ROAD,09,Q9,KOLLEL BETH YIECHEL MICHEL,1,5,-4
20740,3011200001,BK,676 ATLANTIC AVENUE,07,U7,LIRR,0,4,-4
20741,4032340034,QN,71 AVENUE,07,U7,LIRR,0,4,-4
20742,4161890090,QN,BEACH 116 STREET,09,Q1,NYC DEPARTMENT OF PARKS AND RECREATION,0,5,-5
20743,4161610053,QN, BEACH CHANNEL DRIVE,07,U9,NYC DEPARTMENT OF ENVIRONMENTAL PROTECTION,0,5,-5
20744,4107590001,QN,98 AVENUE,07,U7,LIRR,0,5,-5
20745,3070980005,BK, AVENUE T,07,U7,NYC TRANSIT AUTHORITY,2,7,-5
20746,2055100001,BX, SILVER BEACH,01,A8,SILVER BEACH GARDENS CORPORATION,29,34,-5
20747,4161210136,QN,BEACH 87 STREET,06,E7,"BEACH 116TH STREET, LLC",1,6,-5
20748,1013730001,MN,40 RIVER ROAD,03,D4,ROOSEVELT ISLAND OPERATING CORPORATION,39,44,-5
20749,5020350001,SI, SENECA LOOP,11,V0,SENECA LOOP HOME OWNERS ASSOCIATION,0,5,-5
20750,4000720200,QN,21 STREET,07,U6,AMTRAK,0,5,-5
20751,2025390506,BX, MAJ WM DEEGAN BLVD,07,U6,CONRAIL,0,5,-5
20752,5080200006,SI, ARTHUR KILL ROAD,,Z7,NYS DEPARTMENT OF TRANSPORTATION,0,6,-6
20753,1020010005,MN,625 WEST 133 STREET,08,W1,NYC ECF,1,7,-6
20754,2041460001,BX, WATERS PLACE,07,U7,NYC TRANSIT AUTHORITY,0,6,-6
20755,2022600062,BX,EAST 132 STREET,,Z7,CON EDISON,0,6,-6
20756,2032460001,BX, GOULDEN AVENUE,07,Y9,NYC DEPARTMENT OF PARKS AND RECREATION,1,7,-6
20757,4008140001,QN,1 STEINWAY PLACE,06,F9,"STEINWAY, INC.",18,24,-6
20758,1020160001,MN, HARLEM RIVER DRIVE,07,U7,NYC TRANSIT AUTHORITY,0,7,-7
20759,5009060001,SI, KOREAN WAR VETS PKWY,09,Q9,BOY SCOUTS OF AMERICA,1,8,-7
20760,2050850100,BX, BYRON AVENUE,07,U7,NYC TRANSIT AUTHORITY,0,7,-7
20761,4103430005,QN, LIBERTY AVENUE,07,U7,LIRR,0,8,-8
20762,2055400001,BX, LAFAYETTE AVENUE,09,Z8,SAINT JOSEPHS SCHOOL FOR THE DEAF,1,9,-8
20763,5071050574,SI, TURNER STREET,11,V0,ORCHARD ESTATES HOMEOWNERS ASSOC INC.,0,8,-8
20764,1000010101,MN,1 LIBERTY ISLAND,08,P7,U S GOVT LAND & BLDGS,1,10,-9
20765,3085911500,BK, FLATBUSH AVENUE,08,Y4,NATIONAL PARK SERVICE,1,10,-9
20766,5030810055,SI, LILY POND AVENUE,11,V0,MTA B&T,0,10,-10
20767,5069790001,SI,10 EL CAMINO LOOP,08,P5,MAGUIRE AVENUE REALTY CORP,1,11,-10
20768,2040110001,BX, MORRIS PARK AVENUE,07,U7,NYC TRANSIT AUTHORITY,0,10,-10
20769,4093750200,QN, ATLANTIC AVENUE,07,U7,LIRR,0,10,-10
20770,4163500002,QN, ROCKAWAY POINT BLVD,,Z9,NATIONAL PARK SERVICE,1,11,-10
20771,5014100250,SI,300 WESTERN AVENUE,07,T1,NYC DEPARTMENT OF SMALL BUSINESS SERVICES,7,18,-11
20772,3042710001,BK, LINCOLN AVENUE,07,U7,LINDEN PLAZA HOUSING CO. INC.,1,13,-12
20773,1000010201,MN,1 ELLIS ISLAND,,Z9,U S GOVT LAND & BLDGS,1,13,-12
20774,5019550225,SI,475 ROCKLAND AVENUE,08,I7,NYC DEPARTMENT OF CITYWIDE ADMINISTRATIVE SERVICES,8,20,-12
20775,5026850001,SI, WEST SHORE EXPWY,07,Y6,NYC DEPARTMENT OF SANITATION,1,13,-12
20776,2055090001,BX,44 POPLAR AVENUE,01,A8,SILVER BEACH GARDENS CORP,33,45,-12
20777,4156700300,QN, MOTT AVENUE,07,U0,UNAVAILABLE OWNER,0,13,-13
20778,2055300050,BX, FT SCHUYLER PARK,08,W6,NYS MARITIME COLLEGE,26,39,-13
20779,4022802300,QN, GRAND CENTRL PARKWAY,07,U7,NYC TRANSIT AUTHORITY,0,14,-14
20780,3081700001,BK, GLENWOOD ROAD,07,U7,NYC TRANSIT AUTHORITY,0,16,-16
20781,4002140001,QN, SKILLMAN AVENUE,07,U6,LIRR,44,61,-17
20782,5004877501,SI, NAVY PIER COURT,04,RM,UNAVAILABLE OWNER,2,20,-18
20783,4008500200,QN,,07,U2,CON EDISON,0,22,-22
20784,4008500100,QN,20 AVENUE,07,U2,POWER AUTHORITY OF THE STATE OF NEW YORK,0,24,-24
20785,5075960001,SI, ARTHUR KILL ROAD,,Z7,"THE TIDES AT CHARLESTON HOA,INC.",0,26,-26
20786,5024507503,SI,600 RICHMOND HILL ROAD,02,R3,NAME NOT ON FILE,61,87,-26
20787,5015250100,SI, WILLOW ROAD EAST,11,V0,CASWELL HOMEOWNERS ASSOC,0,33,-33
20788,5009550100,SI,50 BRIELLE AVENUE,08,W1,NYC DEPARTMENT OF EDUCATION,17,50,-33
20789,5014897501,SI,36 VEDDER AVENUE,02,R3,PIONT WEST CONDO,3,40,-37
20790,4078800001,QN,78-70 WINCHESTER BOULEVARD,08,I1,CREEDMOOR STATE HOSPITAL,9,47,-38
20791,4076217501,QN,220-50 64 AVENUE,02,R3,LI-HSIANG LEE LIN,58,107,-49
20792,2056500001,BX, PELHAM BAY PARK,09,Q1,NYC DEPARTMENT OF PARKS AND RECREATION,38,101,-63
20793,5031737502,SI, STONEGATE DRIVE,02,R3,STONEGATE AT GRASMERE ASSOCIATES,70,145,-75
20794,4159050401,QN, ROCKAWAY BEACH BLVD,11,V0,"HARBOUR POINTE AT ARVERNE BY THE SEA HOA  V, INC.",0,99,-99
20795,2031200020,BX,2300 SOUTHERN BOULEVARD,09,Q1,NYC DEPARTMENT OF PARKS AND RECREATION,41,142,-101
20796,5030247501,SI, NARROWS ROAD SOUTH,02,R3,JOHANNA MARINO,70,197,-127
